Year,Postal_Code,Town,Province,Age,Unmarried_Men,Married_Men,Divorced_Men,Widowed_Men,Total_#_Of_Males,Unmarried_Women,Married_Women,Divorced_Women,Widowed_Women,Total_#_Of_Females
2020,45001,Aulla,MS,0,32,0,0,0,32,30,0,0,0,30
2020,45001,Aulla,MS,1,30,0,0,0,30,34,0,0,0,34
2020,45001,Aulla,MS,2,43,0,0,0,43,39,0,0,0,39
2020,45001,Aulla,MS,3,50,0,0,0,50,35,0,0,0,35
2020,45001,Aulla,MS,4,38,0,0,0,38,29,0,0,0,29
2020,45001,Aulla,MS,5,42,0,0,0,42,27,0,0,0,27
2020,45001,Aulla,MS,6,44,0,0,0,44,41,0,0,0,41
2020,45001,Aulla,MS,7,57,0,0,0,57,51,0,0,0,51
2020,45001,Aulla,MS,8,46,0,0,0,46,43,0,0,0,43
2020,45001,Aulla,MS,9,45,0,0,0,45,67,0,0,0,67
2020,45001,Aulla,MS,10,42,0,0,0,42,39,0,0,0,39
2020,45001,Aulla,MS,11,52,0,0,0,52,49,0,0,0,49
2020,45001,Aulla,MS,12,40,0,0,0,40,54,0,0,0,54
2020,45001,Aulla,MS,13,54,0,0,0,54,39,0,0,0,39
2020,45001,Aulla,MS,14,47,0,0,0,47,43,0,0,0,43
2020,45001,Aulla,MS,15,50,0,0,0,50,42,0,0,0,42
2020,45001,Aulla,MS,16,49,0,0,0,49,55,0,0,0,55
2020,45001,Aulla,MS,17,34,0,0,0,34,39,0,0,0,39
2020,45001,Aulla,MS,18,47,0,0,0,47,41,0,0,0,41
2020,45001,Aulla,MS,19,47,0,0,0,47,46,1,0,0,47
2020,45001,Aulla,MS,20,47,0,0,0,47,41,0,0,0,41
2020,45001,Aulla,MS,21,38,0,0,0,38,39,1,0,0,40
2020,45001,Aulla,MS,22,41,0,0,0,41,41,2,0,0,43
2020,45001,Aulla,MS,23,46,0,0,0,46,36,3,0,0,39
2020,45001,Aulla,MS,24,46,0,0,0,46,42,3,0,0,45
2020,45001,Aulla,MS,25,55,0,0,0,55,37,2,0,0,39
2020,45001,Aulla,MS,26,52,0,0,0,52,39,5,0,0,44
2020,45001,Aulla,MS,27,50,2,0,0,52,38,8,0,0,46
2020,45001,Aulla,MS,28,47,6,0,0,53,40,19,0,0,59
2020,45001,Aulla,MS,29,38,6,0,0,44,30,16,1,0,47
2020,45001,Aulla,MS,30,40,7,0,0,47,52,11,2,0,65
2020,45001,Aulla,MS,31,31,12,1,0,44,34,22,0,0,56
2020,45001,Aulla,MS,32,46,17,0,0,63,43,28,1,0,72
2020,45001,Aulla,MS,33,40,12,0,0,52,33,26,0,0,59
2020,45001,Aulla,MS,34,43,10,1,0,54,20,24,0,0,44
2020,45001,Aulla,MS,35,28,16,0,0,44,26,30,0,0,56
2020,45001,Aulla,MS,36,27,29,0,0,56,25,44,0,0,69
2020,45001,Aulla,MS,37,30,24,1,0,55,14,39,3,0,56
2020,45001,Aulla,MS,38,19,44,0,0,63,12,50,3,0,65
2020,45001,Aulla,MS,39,32,28,1,1,62,18,43,3,0,64
2020,45001,Aulla,MS,40,27,41,3,0,71,29,29,0,0,58
2020,45001,Aulla,MS,41,33,28,6,0,67,16,40,5,0,61
2020,45001,Aulla,MS,42,30,51,3,0,84,13,46,8,0,67
2020,45001,Aulla,MS,43,37,59,3,0,99,32,57,6,2,97
2020,45001,Aulla,MS,44,49,44,5,0,98,25,52,4,0,81
2020,45001,Aulla,MS,45,28,47,6,0,81,16,53,7,0,76
2020,45001,Aulla,MS,46,30,45,5,0,80,22,60,9,1,92
2020,45001,Aulla,MS,47,31,53,7,0,91,13,63,10,0,86
2020,45001,Aulla,MS,48,27,58,6,0,91,19,60,7,2,88
2020,45001,Aulla,MS,49,27,58,4,0,89,16,51,6,1,74
2020,45001,Aulla,MS,50,31,56,2,0,89,13,59,4,3,79
2020,45001,Aulla,MS,51,24,62,9,1,96,6,65,12,4,87
2020,45001,Aulla,MS,52,13,57,9,1,80,11,67,9,6,93
2020,45001,Aulla,MS,53,23,55,8,0,86,12,58,11,2,83
2020,45001,Aulla,MS,54,23,62,8,2,95,14,51,10,1,76
2020,45001,Aulla,MS,55,19,77,3,2,101,6,62,14,5,87
2020,45001,Aulla,MS,56,16,73,6,0,95,9,76,12,4,101
2020,45001,Aulla,MS,57,12,87,8,1,108,8,79,22,2,111
2020,45001,Aulla,MS,58,7,59,8,3,77,13,66,9,4,92
2020,45001,Aulla,MS,59,10,68,7,4,89,13,81,5,6,105
2020,45001,Aulla,MS,60,12,53,8,1,74,7,69,8,6,90
2020,45001,Aulla,MS,61,8,64,9,0,81,4,60,8,4,76
2020,45001,Aulla,MS,62,14,55,1,2,72,0,74,5,10,89
2020,45001,Aulla,MS,63,7,60,5,3,75,5,58,6,8,77
2020,45001,Aulla,MS,64,8,55,2,2,67,4,47,2,8,61
2020,45001,Aulla,MS,65,8,73,9,3,93,3,80,4,5,92
2020,45001,Aulla,MS,66,6,57,2,1,66,2,54,4,6,66
2020,45001,Aulla,MS,67,6,38,2,3,49,3,44,2,7,56
2020,45001,Aulla,MS,68,3,50,1,3,57,1,58,4,15,78
2020,45001,Aulla,MS,69,7,49,1,3,60,2,43,2,9,56
2020,45001,Aulla,MS,70,4,51,1,2,58,3,35,5,14,57
2020,45001,Aulla,MS,71,2,61,1,1,65,2,36,4,12,54
2020,45001,Aulla,MS,72,5,45,2,4,56,1,51,4,21,77
2020,45001,Aulla,MS,73,3,53,3,4,63,1,32,3,22,58
2020,45001,Aulla,MS,74,5,49,2,5,61,0,51,4,22,77
2020,45001,Aulla,MS,75,5,37,2,5,49,3,27,1,21,52
2020,45001,Aulla,MS,76,5,36,1,7,49,1,36,1,32,70
2020,45001,Aulla,MS,77,4,35,0,4,43,2,30,0,26,58
2020,45001,Aulla,MS,78,1,44,2,7,54,1,18,2,22,43
2020,45001,Aulla,MS,79,3,33,1,1,38,1,32,1,24,58
2020,45001,Aulla,MS,80,4,33,3,9,49,3,23,2,42,70
2020,45001,Aulla,MS,81,3,30,1,6,40,1,20,2,29,52
2020,45001,Aulla,MS,82,7,19,0,10,36,2,11,0,34,47
2020,45001,Aulla,MS,83,2,35,1,7,45,0,23,1,29,53
2020,45001,Aulla,MS,84,5,17,0,4,26,0,16,1,31,48
2020,45001,Aulla,MS,85,0,15,1,6,22,0,12,0,33,45
2020,45001,Aulla,MS,86,0,17,0,2,19,5,11,0,32,48
2020,45001,Aulla,MS,87,1,16,0,6,23,1,8,0,28,37
2020,45001,Aulla,MS,88,0,16,0,6,22,1,5,1,20,27
2020,45001,Aulla,MS,89,0,7,0,2,9,3,9,0,31,43
2020,45001,Aulla,MS,90,0,8,0,3,11,2,2,0,23,27
2020,45001,Aulla,MS,91,0,8,0,4,12,1,2,0,24,27
2020,45001,Aulla,MS,92,1,2,0,4,7,1,0,0,21,22
2020,45001,Aulla,MS,93,1,6,0,1,8,1,0,0,10,11
2020,45001,Aulla,MS,94,0,4,0,3,7,0,1,0,11,12
2020,45001,Aulla,MS,95,1,0,0,2,3,1,0,0,10,11
2020,45001,Aulla,MS,96,1,0,0,1,2,0,0,0,7,7
2020,45001,Aulla,MS,97,0,0,0,0,0,2,0,0,9,11
2020,45001,Aulla,MS,98,0,0,0,1,1,0,0,0,2,2
2020,45001,Aulla,MS,99,0,0,0,1,1,1,0,0,3,4
2020,45001,Aulla,MS,100 e più,0,0,0,0,0,0,0,0,2,2
2020,45002,Bagnone,MS,0,4,0,0,0,4,3,0,0,0,3
2020,45002,Bagnone,MS,1,4,0,0,0,4,3,0,0,0,3
2020,45002,Bagnone,MS,2,4,0,0,0,4,2,0,0,0,2
2020,45002,Bagnone,MS,3,3,0,0,0,3,5,0,0,0,5
2020,45002,Bagnone,MS,4,3,0,0,0,3,4,0,0,0,4
2020,45002,Bagnone,MS,5,4,0,0,0,4,4,0,0,0,4
2020,45002,Bagnone,MS,6,5,0,0,0,5,8,0,0,0,8
2020,45002,Bagnone,MS,7,3,0,0,0,3,0,0,0,0,0
2020,45002,Bagnone,MS,8,6,0,0,0,6,4,0,0,0,4
2020,45002,Bagnone,MS,9,9,0,0,0,9,3,0,0,0,3
2020,45002,Bagnone,MS,10,4,0,0,0,4,4,0,0,0,4
2020,45002,Bagnone,MS,11,3,0,0,0,3,8,0,0,0,8
2020,45002,Bagnone,MS,12,9,0,0,0,9,11,0,0,0,11
2020,45002,Bagnone,MS,13,4,0,0,0,4,4,0,0,0,4
2020,45002,Bagnone,MS,14,15,0,0,0,15,10,0,0,0,10
2020,45002,Bagnone,MS,15,6,0,0,0,6,7,0,0,0,7
2020,45002,Bagnone,MS,16,5,0,0,0,5,3,0,0,0,3
2020,45002,Bagnone,MS,17,5,0,0,0,5,5,0,0,0,5
2020,45002,Bagnone,MS,18,5,0,0,0,5,8,0,0,0,8
2020,45002,Bagnone,MS,19,8,0,0,0,8,6,0,0,0,6
2020,45002,Bagnone,MS,20,7,0,0,0,7,4,0,0,0,4
2020,45002,Bagnone,MS,21,10,0,0,0,10,8,0,0,0,8
2020,45002,Bagnone,MS,22,7,0,0,0,7,8,0,0,0,8
2020,45002,Bagnone,MS,23,4,0,0,0,4,8,0,0,0,8
2020,45002,Bagnone,MS,24,7,0,0,0,7,7,0,0,0,7
2020,45002,Bagnone,MS,25,10,0,0,0,10,4,0,0,0,4
2020,45002,Bagnone,MS,26,8,0,0,0,8,4,0,1,0,5
2020,45002,Bagnone,MS,27,6,0,0,0,6,4,0,0,0,4
2020,45002,Bagnone,MS,28,1,0,0,0,1,5,1,0,0,6
2020,45002,Bagnone,MS,29,5,4,0,0,9,7,0,0,0,7
2020,45002,Bagnone,MS,30,7,0,0,0,7,2,2,0,0,4
2020,45002,Bagnone,MS,31,9,0,0,0,9,4,2,0,0,6
2020,45002,Bagnone,MS,32,4,1,0,0,5,3,2,0,0,5
2020,45002,Bagnone,MS,33,5,0,0,0,5,4,3,0,0,7
2020,45002,Bagnone,MS,34,6,3,0,0,9,7,3,1,0,11
2020,45002,Bagnone,MS,35,8,2,1,0,11,2,2,0,0,4
2020,45002,Bagnone,MS,36,4,1,0,0,5,3,5,0,0,8
2020,45002,Bagnone,MS,37,2,0,0,0,2,1,6,0,0,7
2020,45002,Bagnone,MS,38,2,4,0,0,6,5,3,0,0,8
2020,45002,Bagnone,MS,39,9,3,0,0,12,3,2,0,0,5
2020,45002,Bagnone,MS,40,6,2,0,0,8,6,3,0,0,9
2020,45002,Bagnone,MS,41,5,3,0,0,8,3,2,0,0,5
2020,45002,Bagnone,MS,42,4,2,0,0,6,2,5,0,0,7
2020,45002,Bagnone,MS,43,4,9,0,0,13,2,3,1,0,6
2020,45002,Bagnone,MS,44,6,5,0,0,11,2,4,0,0,6
2020,45002,Bagnone,MS,45,5,2,0,0,7,3,4,1,0,8
2020,45002,Bagnone,MS,46,4,6,0,0,10,2,10,0,0,12
2020,45002,Bagnone,MS,47,4,6,0,0,10,1,10,1,0,12
2020,45002,Bagnone,MS,48,2,6,0,0,8,5,16,0,0,21
2020,45002,Bagnone,MS,49,4,6,0,0,10,3,8,1,0,12
2020,45002,Bagnone,MS,50,2,6,1,0,9,1,10,1,0,12
2020,45002,Bagnone,MS,51,3,15,0,0,18,2,7,1,0,10
2020,45002,Bagnone,MS,52,2,12,0,2,16,1,10,1,0,12
2020,45002,Bagnone,MS,53,5,5,0,0,10,1,6,0,0,7
2020,45002,Bagnone,MS,54,3,12,1,0,16,0,9,2,1,12
2020,45002,Bagnone,MS,55,5,8,1,1,15,3,7,0,0,10
2020,45002,Bagnone,MS,56,2,12,2,0,16,1,12,1,0,14
2020,45002,Bagnone,MS,57,2,10,1,0,13,3,15,0,0,18
2020,45002,Bagnone,MS,58,2,9,0,0,11,4,10,2,0,16
2020,45002,Bagnone,MS,59,2,6,2,0,10,2,6,0,2,10
2020,45002,Bagnone,MS,60,2,8,0,0,10,1,11,0,1,13
2020,45002,Bagnone,MS,61,3,12,1,1,17,1,13,1,2,17
2020,45002,Bagnone,MS,62,5,6,1,0,12,0,7,0,0,7
2020,45002,Bagnone,MS,63,7,8,0,0,15,0,11,0,0,11
2020,45002,Bagnone,MS,64,1,16,2,0,19,0,13,0,2,15
2020,45002,Bagnone,MS,65,3,13,0,0,16,1,10,0,1,12
2020,45002,Bagnone,MS,66,2,9,1,1,13,0,13,0,4,17
2020,45002,Bagnone,MS,67,4,11,0,1,16,0,7,1,0,8
2020,45002,Bagnone,MS,68,2,8,0,1,11,0,10,1,0,11
2020,45002,Bagnone,MS,69,2,17,2,0,21,0,11,0,2,13
2020,45002,Bagnone,MS,70,2,15,1,1,19,0,8,0,2,10
2020,45002,Bagnone,MS,71,6,13,1,3,23,2,15,0,1,18
2020,45002,Bagnone,MS,72,2,13,0,0,15,1,7,0,2,10
2020,45002,Bagnone,MS,73,1,12,0,0,13,0,14,1,3,18
2020,45002,Bagnone,MS,74,3,11,0,0,14,0,10,1,4,15
2020,45002,Bagnone,MS,75,2,5,3,0,10,0,5,0,2,7
2020,45002,Bagnone,MS,76,3,11,1,0,15,0,11,0,4,15
2020,45002,Bagnone,MS,77,4,7,0,1,12,0,8,1,5,14
2020,45002,Bagnone,MS,78,0,5,0,0,5,0,6,0,4,10
2020,45002,Bagnone,MS,79,2,10,0,0,12,0,6,0,4,10
2020,45002,Bagnone,MS,80,4,12,0,2,18,0,3,0,9,12
2020,45002,Bagnone,MS,81,1,11,0,0,12,1,6,1,9,17
2020,45002,Bagnone,MS,82,0,11,1,1,13,0,6,1,6,13
2020,45002,Bagnone,MS,83,2,7,0,0,9,0,6,0,6,12
2020,45002,Bagnone,MS,84,0,2,0,2,4,2,3,1,10,16
2020,45002,Bagnone,MS,85,1,5,1,1,8,0,3,0,8,11
2020,45002,Bagnone,MS,86,2,2,0,1,5,0,0,0,12,12
2020,45002,Bagnone,MS,87,0,6,1,0,7,1,3,0,8,12
2020,45002,Bagnone,MS,88,2,1,0,2,5,1,0,0,10,11
2020,45002,Bagnone,MS,89,0,3,0,1,4,0,1,0,10,11
2020,45002,Bagnone,MS,90,0,1,0,2,3,0,0,0,10,10
2020,45002,Bagnone,MS,91,0,1,0,0,1,2,0,0,7,9
2020,45002,Bagnone,MS,92,0,0,0,5,5,0,2,0,5,7
2020,45002,Bagnone,MS,93,0,1,0,2,3,0,0,0,1,1
2020,45002,Bagnone,MS,94,0,1,0,1,2,1,0,0,4,5
2020,45002,Bagnone,MS,95,0,1,0,1,2,1,0,0,5,6
2020,45002,Bagnone,MS,96,0,0,0,1,1,0,0,0,1,1
2020,45002,Bagnone,MS,97,0,0,0,0,0,1,0,0,1,2
2020,45002,Bagnone,MS,98,0,0,0,0,0,0,0,0,0,0
2020,45002,Bagnone,MS,99,0,0,0,1,1,0,0,0,1,1
2020,45002,Bagnone,MS,100 e più,0,0,0,0,0,0,0,0,3,3
2020,45003,Carrara,MS,0,150,0,0,0,150,148,0,0,0,148
2020,45003,Carrara,MS,1,162,0,0,0,162,162,0,0,0,162
2020,45003,Carrara,MS,2,176,0,0,0,176,175,0,0,0,175
2020,45003,Carrara,MS,3,218,0,0,0,218,193,0,0,0,193
2020,45003,Carrara,MS,4,193,0,0,0,193,191,0,0,0,191
2020,45003,Carrara,MS,5,233,0,0,0,233,199,0,0,0,199
2020,45003,Carrara,MS,6,221,0,0,0,221,200,0,0,0,200
2020,45003,Carrara,MS,7,216,0,0,0,216,214,0,0,0,214
2020,45003,Carrara,MS,8,241,0,0,0,241,231,0,0,0,231
2020,45003,Carrara,MS,9,245,0,0,0,245,245,0,0,0,245
2020,45003,Carrara,MS,10,242,0,0,0,242,240,0,0,0,240
2020,45003,Carrara,MS,11,237,0,0,0,237,231,0,0,0,231
2020,45003,Carrara,MS,12,310,0,0,0,310,250,0,0,0,250
2020,45003,Carrara,MS,13,293,0,0,0,293,252,0,0,0,252
2020,45003,Carrara,MS,14,272,0,0,0,272,252,0,0,0,252
2020,45003,Carrara,MS,15,287,0,0,0,287,224,0,0,0,224
2020,45003,Carrara,MS,16,252,0,0,0,252,248,0,0,0,248
2020,45003,Carrara,MS,17,255,0,0,0,255,254,0,0,0,254
2020,45003,Carrara,MS,18,300,0,0,0,300,244,0,0,0,244
2020,45003,Carrara,MS,19,279,0,0,0,279,241,0,0,0,241
2020,45003,Carrara,MS,20,300,1,0,0,301,242,2,0,0,244
2020,45003,Carrara,MS,21,300,2,0,0,302,276,6,0,0,282
2020,45003,Carrara,MS,22,273,2,0,0,275,263,13,0,0,276
2020,45003,Carrara,MS,23,319,1,0,0,320,245,12,0,0,257
2020,45003,Carrara,MS,24,283,2,0,0,285,287,10,0,0,297
2020,45003,Carrara,MS,25,277,8,0,0,285,250,25,0,0,275
2020,45003,Carrara,MS,26,268,11,0,0,279,218,22,0,0,240
2020,45003,Carrara,MS,27,283,12,0,0,295,218,35,1,0,254
2020,45003,Carrara,MS,28,266,12,0,0,278,220,48,1,0,269
2020,45003,Carrara,MS,29,258,21,2,0,281,243,70,1,1,315
2020,45003,Carrara,MS,30,263,27,0,0,290,226,74,5,0,305
2020,45003,Carrara,MS,31,263,46,4,0,313,193,65,4,0,262
2020,45003,Carrara,MS,32,228,62,2,0,293,171,95,5,0,271
2020,45003,Carrara,MS,33,206,64,2,0,273,182,103,8,1,294
2020,45003,Carrara,MS,34,230,77,8,0,316,131,138,5,0,274
2020,45003,Carrara,MS,35,219,88,2,0,309,145,135,10,1,291
2020,45003,Carrara,MS,36,225,120,4,0,349,149,145,8,0,302
2020,45003,Carrara,MS,37,212,111,7,0,330,130,169,10,0,309
2020,45003,Carrara,MS,38,193,124,8,0,325,164,181,11,1,357
2020,45003,Carrara,MS,39,197,171,5,0,373,138,204,17,3,362
2020,45003,Carrara,MS,40,198,168,13,1,380,143,206,24,2,375
2020,45003,Carrara,MS,41,185,176,17,0,378,145,220,28,3,397
2020,45003,Carrara,MS,42,178,187,14,0,379,118,228,23,2,371
2020,45003,Carrara,MS,43,195,241,25,0,461,127,262,36,2,427
2020,45003,Carrara,MS,44,205,208,21,1,435,127,285,29,4,445
2020,45003,Carrara,MS,45,193,293,18,3,507,143,314,42,8,508
2020,45003,Carrara,MS,46,219,266,20,2,507,122,316,45,3,488
2020,45003,Carrara,MS,47,166,270,26,0,462,122,315,52,8,498
2020,45003,Carrara,MS,48,173,297,32,2,504,112,340,52,2,507
2020,45003,Carrara,MS,49,175,299,33,2,510,110,315,60,12,497
2020,45003,Carrara,MS,50,144,318,37,2,502,97,363,71,6,537
2020,45003,Carrara,MS,51,144,309,52,2,508,105,380,56,8,550
2020,45003,Carrara,MS,52,128,310,36,1,476,65,335,49,22,472
2020,45003,Carrara,MS,53,124,327,37,1,489,69,369,49,18,505
2020,45003,Carrara,MS,54,94,334,42,3,474,58,373,65,16,512
2020,45003,Carrara,MS,55,105,350,49,1,505,56,370,54,15,495
2020,45003,Carrara,MS,56,92,367,56,5,520,67,378,58,23,526
2020,45003,Carrara,MS,57,75,386,45,5,511,50,374,62,23,509
2020,45003,Carrara,MS,58,88,360,43,8,499,51,363,51,23,488
2020,45003,Carrara,MS,59,71,319,37,5,432,43,335,46,33,457
2020,45003,Carrara,MS,60,63,299,43,1,406,42,320,48,37,447
2020,45003,Carrara,MS,61,48,361,42,6,457,30,358,58,34,480
2020,45003,Carrara,MS,62,55,365,26,12,458,46,351,54,38,489
2020,45003,Carrara,MS,63,49,320,27,1,397,29,328,44,57,458
2020,45003,Carrara,MS,64,48,321,31,8,408,26,322,38,59,445
2020,45003,Carrara,MS,65,26,316,23,11,376,37,310,31,57,435
2020,45003,Carrara,MS,66,47,298,27,8,380,21,310,24,69,424
2020,45003,Carrara,MS,67,25,265,21,8,319,17,288,27,76,408
2020,45003,Carrara,MS,68,23,289,25,23,360,19,247,34,78,378
2020,45003,Carrara,MS,69,22,281,21,19,343,16,258,19,79,372
2020,45003,Carrara,MS,70,21,318,23,15,377,30,261,25,88,404
2020,45003,Carrara,MS,71,22,290,17,32,361,19,266,24,109,418
2020,45003,Carrara,MS,72,28,308,21,26,383,21,275,16,135,447
2020,45003,Carrara,MS,73,26,333,18,39,416,20,306,16,148,490
2020,45003,Carrara,MS,74,17,334,17,31,399,19,252,25,154,450
2020,45003,Carrara,MS,75,10,161,10,19,200,10,172,10,91,283
2020,45003,Carrara,MS,76,10,249,7,38,304,20,214,23,141,398
2020,45003,Carrara,MS,77,9,198,7,29,243,12,168,6,128,314
2020,45003,Carrara,MS,78,11,221,4,25,261,12,153,7,137,309
2020,45003,Carrara,MS,79,16,226,9,38,289,9,192,11,189,401
2020,45003,Carrara,MS,80,13,214,4,39,270,14,161,11,206,392
2020,45003,Carrara,MS,81,11,193,4,43,251,20,140,6,177,343
2020,45003,Carrara,MS,82,9,233,6,43,291,23,104,2,250,379
2020,45003,Carrara,MS,83,4,153,7,35,199,14,92,4,192,302
2020,45003,Carrara,MS,84,5,138,4,25,172,17,80,4,199,300
2020,45003,Carrara,MS,85,5,107,2,34,148,18,57,5,183,263
2020,45003,Carrara,MS,86,8,79,0,33,120,11,48,4,169,232
2020,45003,Carrara,MS,87,2,75,1,26,104,7,46,6,140,199
2020,45003,Carrara,MS,88,5,48,0,34,87,14,25,1,165,205
2020,45003,Carrara,MS,89,3,52,0,23,78,8,16,1,131,156
2020,45003,Carrara,MS,90,6,36,2,22,66,11,14,4,144,173
2020,45003,Carrara,MS,91,1,33,1,23,58,9,5,1,107,122
2020,45003,Carrara,MS,92,1,13,0,7,21,6,8,3,94,111
2020,45003,Carrara,MS,93,2,12,0,13,27,5,1,1,76,83
2020,45003,Carrara,MS,94,0,10,0,10,20,5,2,0,60,67
2020,45003,Carrara,MS,95,1,6,0,10,17,2,1,0,61,64
2020,45003,Carrara,MS,96,0,2,0,4,6,5,0,0,39,44
2020,45003,Carrara,MS,97,0,1,0,3,4,1,0,0,26,27
2020,45003,Carrara,MS,98,0,1,0,3,4,2,0,0,19,21
2020,45003,Carrara,MS,99,0,0,0,4,4,0,0,0,12,12
2020,45003,Carrara,MS,100 e più,0,0,0,0,0,2,0,0,15,17
2020,45004,Casola in Lunigiana,MS,0,2,0,0,0,2,1,0,0,0,1
2020,45004,Casola in Lunigiana,MS,1,2,0,0,0,2,6,0,0,0,6
2020,45004,Casola in Lunigiana,MS,2,1,0,0,0,1,4,0,0,0,4
2020,45004,Casola in Lunigiana,MS,3,0,0,0,0,0,1,0,0,0,1
2020,45004,Casola in Lunigiana,MS,4,3,0,0,0,3,2,0,0,0,2
2020,45004,Casola in Lunigiana,MS,5,1,0,0,0,1,1,0,0,0,1
2020,45004,Casola in Lunigiana,MS,6,3,0,0,0,3,2,0,0,0,2
2020,45004,Casola in Lunigiana,MS,7,5,0,0,0,5,1,0,0,0,1
2020,45004,Casola in Lunigiana,MS,8,1,0,0,0,1,2,0,0,0,2
2020,45004,Casola in Lunigiana,MS,9,3,0,0,0,3,5,0,0,0,5
2020,45004,Casola in Lunigiana,MS,10,1,0,0,0,1,2,0,0,0,2
2020,45004,Casola in Lunigiana,MS,11,5,0,0,0,5,1,0,0,0,1
2020,45004,Casola in Lunigiana,MS,12,4,0,0,0,4,3,0,0,0,3
2020,45004,Casola in Lunigiana,MS,13,2,0,0,0,2,3,0,0,0,3
2020,45004,Casola in Lunigiana,MS,14,2,0,0,0,2,3,0,0,0,3
2020,45004,Casola in Lunigiana,MS,15,3,0,0,0,3,4,0,0,0,4
2020,45004,Casola in Lunigiana,MS,16,1,0,0,0,1,2,0,0,0,2
2020,45004,Casola in Lunigiana,MS,17,2,0,0,0,2,6,0,0,0,6
2020,45004,Casola in Lunigiana,MS,18,4,0,0,0,4,2,0,0,0,2
2020,45004,Casola in Lunigiana,MS,19,4,0,0,0,4,2,0,0,0,2
2020,45004,Casola in Lunigiana,MS,20,2,0,0,0,2,6,0,0,0,6
2020,45004,Casola in Lunigiana,MS,21,3,0,0,0,3,9,0,0,0,9
2020,45004,Casola in Lunigiana,MS,22,2,0,0,0,2,4,0,0,0,4
2020,45004,Casola in Lunigiana,MS,23,0,0,0,0,0,2,0,0,0,2
2020,45004,Casola in Lunigiana,MS,24,5,0,0,0,5,2,0,0,0,2
2020,45004,Casola in Lunigiana,MS,25,6,0,0,0,6,1,0,0,0,1
2020,45004,Casola in Lunigiana,MS,26,4,0,0,0,4,6,0,0,0,6
2020,45004,Casola in Lunigiana,MS,27,2,0,0,0,2,2,2,0,0,4
2020,45004,Casola in Lunigiana,MS,28,4,0,1,0,5,3,1,0,0,4
2020,45004,Casola in Lunigiana,MS,29,5,0,0,0,5,3,1,0,0,4
2020,45004,Casola in Lunigiana,MS,30,6,2,0,0,8,2,3,0,0,5
2020,45004,Casola in Lunigiana,MS,31,4,0,0,0,4,5,0,0,0,5
2020,45004,Casola in Lunigiana,MS,32,3,0,0,0,3,5,1,0,0,6
2020,45004,Casola in Lunigiana,MS,33,7,0,0,0,7,1,2,0,0,3
2020,45004,Casola in Lunigiana,MS,34,7,3,0,0,10,1,1,0,0,2
2020,45004,Casola in Lunigiana,MS,35,5,1,0,0,6,2,0,0,0,2
2020,45004,Casola in Lunigiana,MS,36,2,1,0,0,3,4,1,0,0,5
2020,45004,Casola in Lunigiana,MS,37,5,1,0,0,6,1,4,0,0,5
2020,45004,Casola in Lunigiana,MS,38,2,1,0,0,3,4,0,0,0,4
2020,45004,Casola in Lunigiana,MS,39,2,0,0,0,2,0,2,0,0,2
2020,45004,Casola in Lunigiana,MS,40,1,0,0,0,1,2,4,0,0,6
2020,45004,Casola in Lunigiana,MS,41,1,3,0,0,4,3,3,1,0,7
2020,45004,Casola in Lunigiana,MS,42,1,1,0,0,2,3,2,0,0,5
2020,45004,Casola in Lunigiana,MS,43,2,4,0,0,6,1,3,0,0,4
2020,45004,Casola in Lunigiana,MS,44,4,3,0,0,7,1,0,0,0,1
2020,45004,Casola in Lunigiana,MS,45,4,4,0,0,8,3,5,0,0,8
2020,45004,Casola in Lunigiana,MS,46,0,5,0,0,5,1,2,0,0,3
2020,45004,Casola in Lunigiana,MS,47,6,2,0,0,8,0,6,1,0,7
2020,45004,Casola in Lunigiana,MS,48,2,4,0,0,6,3,1,0,0,4
2020,45004,Casola in Lunigiana,MS,49,2,4,0,0,6,0,5,1,0,6
2020,45004,Casola in Lunigiana,MS,50,1,3,1,0,5,2,2,0,1,5
2020,45004,Casola in Lunigiana,MS,51,2,3,0,0,5,1,3,1,0,5
2020,45004,Casola in Lunigiana,MS,52,2,3,0,0,5,2,6,0,0,8
2020,45004,Casola in Lunigiana,MS,53,4,2,3,0,9,1,9,1,0,11
2020,45004,Casola in Lunigiana,MS,54,1,4,0,0,5,1,5,0,0,6
2020,45004,Casola in Lunigiana,MS,55,2,3,0,1,6,1,4,0,0,5
2020,45004,Casola in Lunigiana,MS,56,3,5,1,1,10,1,13,0,0,14
2020,45004,Casola in Lunigiana,MS,57,2,8,1,0,11,0,6,0,0,6
2020,45004,Casola in Lunigiana,MS,58,1,9,1,0,11,0,2,1,0,3
2020,45004,Casola in Lunigiana,MS,59,1,5,0,0,6,2,12,0,0,14
2020,45004,Casola in Lunigiana,MS,60,0,7,0,0,7,0,6,0,1,7
2020,45004,Casola in Lunigiana,MS,61,2,5,2,2,11,1,5,1,0,7
2020,45004,Casola in Lunigiana,MS,62,1,3,1,0,5,2,11,0,0,13
2020,45004,Casola in Lunigiana,MS,63,1,7,0,0,8,0,6,1,0,7
2020,45004,Casola in Lunigiana,MS,64,2,4,0,0,6,1,4,0,1,6
2020,45004,Casola in Lunigiana,MS,65,4,6,0,0,10,1,7,0,1,9
2020,45004,Casola in Lunigiana,MS,66,0,5,2,0,7,1,8,0,1,10
2020,45004,Casola in Lunigiana,MS,67,1,4,1,0,6,0,6,0,1,7
2020,45004,Casola in Lunigiana,MS,68,0,10,1,0,11,1,5,0,1,7
2020,45004,Casola in Lunigiana,MS,69,0,10,2,0,12,1,6,1,4,12
2020,45004,Casola in Lunigiana,MS,70,3,10,0,0,13,1,1,1,2,5
2020,45004,Casola in Lunigiana,MS,71,0,2,0,0,2,1,3,0,0,4
2020,45004,Casola in Lunigiana,MS,72,0,10,2,1,13,0,7,1,1,9
2020,45004,Casola in Lunigiana,MS,73,0,6,0,0,6,0,4,2,4,10
2020,45004,Casola in Lunigiana,MS,74,2,2,0,2,6,0,3,0,2,5
2020,45004,Casola in Lunigiana,MS,75,1,2,0,0,3,2,5,0,3,10
2020,45004,Casola in Lunigiana,MS,76,1,9,0,0,10,0,5,1,1,7
2020,45004,Casola in Lunigiana,MS,77,2,1,0,1,4,0,9,0,2,11
2020,45004,Casola in Lunigiana,MS,78,1,4,0,0,5,2,1,0,2,5
2020,45004,Casola in Lunigiana,MS,79,1,4,1,1,7,0,3,0,7,10
2020,45004,Casola in Lunigiana,MS,80,0,4,0,2,6,0,3,0,5,8
2020,45004,Casola in Lunigiana,MS,81,1,3,0,0,4,1,4,0,3,8
2020,45004,Casola in Lunigiana,MS,82,0,0,0,0,0,0,1,0,3,4
2020,45004,Casola in Lunigiana,MS,83,0,10,0,2,12,0,5,0,4,9
2020,45004,Casola in Lunigiana,MS,84,0,1,0,0,1,1,4,0,2,7
2020,45004,Casola in Lunigiana,MS,85,1,2,0,2,5,1,1,0,3,5
2020,45004,Casola in Lunigiana,MS,86,0,5,0,0,5,0,1,0,5,6
2020,45004,Casola in Lunigiana,MS,87,0,4,0,2,6,1,0,0,5,6
2020,45004,Casola in Lunigiana,MS,88,0,3,0,0,3,0,3,0,2,5
2020,45004,Casola in Lunigiana,MS,89,1,3,0,1,5,0,1,0,7,8
2020,45004,Casola in Lunigiana,MS,90,0,3,0,1,4,0,2,0,3,5
2020,45004,Casola in Lunigiana,MS,91,0,2,0,0,2,0,1,0,4,5
2020,45004,Casola in Lunigiana,MS,92,0,2,0,0,2,1,0,0,1,2
2020,45004,Casola in Lunigiana,MS,93,0,1,0,0,1,0,0,0,1,1
2020,45004,Casola in Lunigiana,MS,94,0,0,0,1,1,1,1,0,0,2
2020,45004,Casola in Lunigiana,MS,95,0,0,0,0,0,0,0,0,5,5
2020,45004,Casola in Lunigiana,MS,96,0,1,0,0,1,0,0,0,2,2
2020,45004,Casola in Lunigiana,MS,97,0,0,0,0,0,0,0,0,1,1
2020,45004,Casola in Lunigiana,MS,98,0,0,0,0,0,0,0,0,2,2
2020,45004,Casola in Lunigiana,MS,99,0,0,0,0,0,0,0,0,0,0
2020,45004,Casola in Lunigiana,MS,100 e più,0,0,0,0,0,0,1,0,2,3
2020,45005,Comano,MS,0,2,0,0,0,2,1,0,0,0,1
2020,45005,Comano,MS,1,2,0,0,0,2,2,0,0,0,2
2020,45005,Comano,MS,2,1,0,0,0,1,1,0,0,0,1
2020,45005,Comano,MS,3,3,0,0,0,3,0,0,0,0,0
2020,45005,Comano,MS,4,1,0,0,0,1,1,0,0,0,1
2020,45005,Comano,MS,5,4,0,0,0,4,0,0,0,0,0
2020,45005,Comano,MS,6,0,0,0,0,0,2,0,0,0,2
2020,45005,Comano,MS,7,2,0,0,0,2,2,0,0,0,2
2020,45005,Comano,MS,8,3,0,0,0,3,2,0,0,0,2
2020,45005,Comano,MS,9,0,0,0,0,0,2,0,0,0,2
2020,45005,Comano,MS,10,2,0,0,0,2,4,0,0,0,4
2020,45005,Comano,MS,11,1,0,0,0,1,1,0,0,0,1
2020,45005,Comano,MS,12,2,0,0,0,2,1,0,0,0,1
2020,45005,Comano,MS,13,0,0,0,0,0,0,0,0,0,0
2020,45005,Comano,MS,14,1,0,0,0,1,1,0,0,0,1
2020,45005,Comano,MS,15,5,0,0,0,5,0,0,0,0,0
2020,45005,Comano,MS,16,4,0,0,0,4,1,0,0,0,1
2020,45005,Comano,MS,17,0,0,0,0,0,3,0,0,0,3
2020,45005,Comano,MS,18,2,0,0,0,2,1,0,0,0,1
2020,45005,Comano,MS,19,2,0,0,0,2,2,0,0,0,2
2020,45005,Comano,MS,20,5,0,0,0,5,2,0,0,0,2
2020,45005,Comano,MS,21,2,0,0,0,2,3,0,0,0,3
2020,45005,Comano,MS,22,1,0,0,0,1,2,0,0,0,2
2020,45005,Comano,MS,23,3,0,0,0,3,3,0,0,0,3
2020,45005,Comano,MS,24,5,0,0,0,5,3,0,0,0,3
2020,45005,Comano,MS,25,2,0,0,0,2,1,0,0,0,1
2020,45005,Comano,MS,26,2,0,0,0,2,5,0,0,0,5
2020,45005,Comano,MS,27,2,0,0,0,2,1,1,0,0,2
2020,45005,Comano,MS,28,1,0,0,0,1,1,0,0,0,1
2020,45005,Comano,MS,29,3,0,0,0,3,1,1,0,0,2
2020,45005,Comano,MS,30,1,0,0,0,1,2,1,0,0,3
2020,45005,Comano,MS,31,2,1,0,0,3,0,1,0,0,1
2020,45005,Comano,MS,32,3,1,0,0,4,2,1,0,0,3
2020,45005,Comano,MS,33,2,1,0,0,3,1,0,0,0,1
2020,45005,Comano,MS,34,3,0,0,0,3,2,2,0,0,4
2020,45005,Comano,MS,35,1,1,0,0,2,4,1,0,0,5
2020,45005,Comano,MS,36,0,0,0,0,0,1,2,0,0,3
2020,45005,Comano,MS,37,2,1,0,0,3,2,1,0,0,3
2020,45005,Comano,MS,38,2,0,0,0,2,3,1,0,0,4
2020,45005,Comano,MS,39,2,0,0,0,2,0,0,0,0,0
2020,45005,Comano,MS,40,0,0,0,0,0,1,3,0,0,4
2020,45005,Comano,MS,41,2,3,1,0,6,0,1,0,0,1
2020,45005,Comano,MS,42,3,2,0,0,5,0,3,0,0,3
2020,45005,Comano,MS,43,0,1,0,0,1,0,0,1,0,1
2020,45005,Comano,MS,44,2,3,1,0,6,1,3,0,0,4
2020,45005,Comano,MS,45,3,1,1,0,5,2,1,0,0,3
2020,45005,Comano,MS,46,2,2,1,0,5,0,2,0,1,3
2020,45005,Comano,MS,47,3,1,0,0,4,2,3,0,1,6
2020,45005,Comano,MS,48,1,1,0,0,2,1,4,0,0,5
2020,45005,Comano,MS,49,6,3,0,0,9,2,5,0,0,7
2020,45005,Comano,MS,50,1,2,1,0,4,2,1,3,0,6
2020,45005,Comano,MS,51,3,2,0,0,5,1,3,1,0,5
2020,45005,Comano,MS,52,3,4,2,0,9,2,5,0,0,7
2020,45005,Comano,MS,53,1,1,0,0,2,1,2,0,0,3
2020,45005,Comano,MS,54,3,4,0,1,8,1,8,3,0,12
2020,45005,Comano,MS,55,1,1,1,0,3,0,4,0,1,5
2020,45005,Comano,MS,56,0,3,0,0,3,0,3,2,1,6
2020,45005,Comano,MS,57,1,2,0,0,3,1,5,0,0,6
2020,45005,Comano,MS,58,0,5,1,0,6,1,1,0,1,3
2020,45005,Comano,MS,59,2,3,1,0,6,0,3,1,1,5
2020,45005,Comano,MS,60,0,7,4,0,11,1,1,0,0,2
2020,45005,Comano,MS,61,0,7,0,0,7,0,4,0,0,4
2020,45005,Comano,MS,62,2,1,1,0,4,0,1,0,0,1
2020,45005,Comano,MS,63,0,4,2,0,6,0,3,0,0,3
2020,45005,Comano,MS,64,1,4,0,0,5,1,5,1,3,10
2020,45005,Comano,MS,65,0,6,0,0,6,1,4,0,0,5
2020,45005,Comano,MS,66,1,4,2,0,7,1,4,1,1,7
2020,45005,Comano,MS,67,2,6,1,0,9,0,1,1,1,3
2020,45005,Comano,MS,68,0,3,0,0,3,0,5,0,2,7
2020,45005,Comano,MS,69,2,2,0,0,4,1,2,1,0,4
2020,45005,Comano,MS,70,2,6,0,1,9,0,6,0,2,8
2020,45005,Comano,MS,71,0,2,1,0,3,0,4,1,2,7
2020,45005,Comano,MS,72,2,2,2,1,7,0,4,0,0,4
2020,45005,Comano,MS,73,0,4,1,0,5,0,5,0,1,6
2020,45005,Comano,MS,74,1,3,0,0,4,0,2,1,2,5
2020,45005,Comano,MS,75,1,3,0,1,5,0,2,0,4,6
2020,45005,Comano,MS,76,0,3,1,0,4,0,1,1,0,2
2020,45005,Comano,MS,77,0,6,0,1,7,0,2,1,2,5
2020,45005,Comano,MS,78,0,7,0,2,9,1,3,0,3,7
2020,45005,Comano,MS,79,0,4,0,1,5,0,2,0,1,3
2020,45005,Comano,MS,80,0,3,0,0,3,0,2,0,2,4
2020,45005,Comano,MS,81,1,0,0,0,1,0,3,0,2,5
2020,45005,Comano,MS,82,2,1,0,1,4,0,0,0,4,4
2020,45005,Comano,MS,83,0,4,0,2,6,0,2,0,1,3
2020,45005,Comano,MS,84,0,4,0,1,5,0,1,0,3,4
2020,45005,Comano,MS,85,0,2,0,1,3,1,1,0,4,6
2020,45005,Comano,MS,86,0,3,0,0,3,1,0,0,7,8
2020,45005,Comano,MS,87,0,0,0,0,0,0,0,0,7,7
2020,45005,Comano,MS,88,1,1,0,1,3,0,1,0,3,4
2020,45005,Comano,MS,89,0,2,0,1,3,0,0,0,2,2
2020,45005,Comano,MS,90,0,0,0,1,1,2,0,0,3,5
2020,45005,Comano,MS,91,0,2,0,0,2,1,0,0,1,2
2020,45005,Comano,MS,92,0,0,0,0,0,0,0,0,4,4
2020,45005,Comano,MS,93,0,0,0,0,0,1,0,0,3,4
2020,45005,Comano,MS,94,0,0,0,0,0,0,0,0,2,2
2020,45005,Comano,MS,95,0,0,0,0,0,0,0,0,2,2
2020,45005,Comano,MS,96,0,0,0,0,0,0,0,0,0,0
2020,45005,Comano,MS,97,0,0,0,0,0,0,0,0,0,0
2020,45005,Comano,MS,98,0,0,0,0,0,0,0,0,1,1
2020,45005,Comano,MS,99,0,0,0,0,0,0,0,0,1,1
2020,45005,Comano,MS,100 e più,0,0,0,0,0,0,0,0,0,0
2020,45006,Filattiera,MS,0,6,0,0,0,6,9,0,0,0,9
2020,45006,Filattiera,MS,1,4,0,0,0,4,3,0,0,0,3
2020,45006,Filattiera,MS,2,8,0,0,0,8,8,0,0,0,8
2020,45006,Filattiera,MS,3,6,0,0,0,6,8,0,0,0,8
2020,45006,Filattiera,MS,4,6,0,0,0,6,7,0,0,0,7
2020,45006,Filattiera,MS,5,16,0,0,0,16,4,0,0,0,4
2020,45006,Filattiera,MS,6,8,0,0,0,8,6,0,0,0,6
2020,45006,Filattiera,MS,7,4,0,0,0,4,6,0,0,0,6
2020,45006,Filattiera,MS,8,7,0,0,0,7,10,0,0,0,10
2020,45006,Filattiera,MS,9,4,0,0,0,4,8,0,0,0,8
2020,45006,Filattiera,MS,10,8,0,0,0,8,10,0,0,0,10
2020,45006,Filattiera,MS,11,3,0,0,0,3,7,0,0,0,7
2020,45006,Filattiera,MS,12,9,0,0,0,9,6,0,0,0,6
2020,45006,Filattiera,MS,13,11,0,0,0,11,7,0,0,0,7
2020,45006,Filattiera,MS,14,10,0,0,0,10,7,0,0,0,7
2020,45006,Filattiera,MS,15,11,0,0,0,11,5,0,0,0,5
2020,45006,Filattiera,MS,16,12,0,0,0,12,2,0,0,0,2
2020,45006,Filattiera,MS,17,8,0,0,0,8,3,0,0,0,3
2020,45006,Filattiera,MS,18,7,0,0,0,7,8,0,0,0,8
2020,45006,Filattiera,MS,19,17,0,0,0,17,8,0,0,0,8
2020,45006,Filattiera,MS,20,10,0,0,0,10,8,0,0,0,8
2020,45006,Filattiera,MS,21,9,0,0,0,9,7,0,0,0,7
2020,45006,Filattiera,MS,22,14,0,0,0,14,8,1,0,0,9
2020,45006,Filattiera,MS,23,10,0,0,0,10,13,0,0,0,13
2020,45006,Filattiera,MS,24,9,1,0,0,10,7,0,0,0,7
2020,45006,Filattiera,MS,25,14,0,0,0,14,15,0,0,0,15
2020,45006,Filattiera,MS,26,8,0,0,0,8,8,0,0,0,8
2020,45006,Filattiera,MS,27,11,0,0,0,11,8,4,0,0,12
2020,45006,Filattiera,MS,28,5,0,0,0,5,7,1,0,0,8
2020,45006,Filattiera,MS,29,6,0,0,0,6,11,3,0,0,14
2020,45006,Filattiera,MS,30,13,0,0,0,13,9,3,0,0,12
2020,45006,Filattiera,MS,31,8,1,0,0,9,7,4,0,0,11
2020,45006,Filattiera,MS,32,9,1,0,0,10,7,4,0,0,11
2020,45006,Filattiera,MS,33,7,4,0,0,11,5,3,0,0,8
2020,45006,Filattiera,MS,34,3,5,0,0,8,9,3,0,0,12
2020,45006,Filattiera,MS,35,4,2,0,0,6,7,5,0,0,12
2020,45006,Filattiera,MS,36,10,3,0,0,13,4,4,0,0,8
2020,45006,Filattiera,MS,37,5,6,0,0,11,4,4,0,0,8
2020,45006,Filattiera,MS,38,3,4,0,0,7,3,5,0,0,8
2020,45006,Filattiera,MS,39,6,2,1,0,9,4,13,0,0,17
2020,45006,Filattiera,MS,40,5,4,0,0,9,4,2,1,0,7
2020,45006,Filattiera,MS,41,4,8,0,0,12,3,6,0,0,9
2020,45006,Filattiera,MS,42,8,8,0,0,16,5,4,0,0,9
2020,45006,Filattiera,MS,43,9,5,0,0,14,3,6,0,0,9
2020,45006,Filattiera,MS,44,5,8,0,0,13,4,7,1,0,12
2020,45006,Filattiera,MS,45,6,2,1,0,9,5,16,0,0,21
2020,45006,Filattiera,MS,46,6,6,1,0,13,3,15,3,0,21
2020,45006,Filattiera,MS,47,2,9,1,0,12,4,5,1,2,12
2020,45006,Filattiera,MS,48,5,10,1,0,16,3,12,0,0,15
2020,45006,Filattiera,MS,49,3,10,1,0,14,2,14,1,0,17
2020,45006,Filattiera,MS,50,7,14,1,0,22,3,8,1,0,12
2020,45006,Filattiera,MS,51,6,15,1,0,22,2,15,1,0,18
2020,45006,Filattiera,MS,52,3,5,3,0,11,2,19,0,0,21
2020,45006,Filattiera,MS,53,5,5,0,0,10,1,14,2,0,17
2020,45006,Filattiera,MS,54,4,15,0,2,21,3,16,0,0,19
2020,45006,Filattiera,MS,55,2,16,1,1,20,4,19,0,0,23
2020,45006,Filattiera,MS,56,5,11,2,0,18,2,16,2,0,20
2020,45006,Filattiera,MS,57,5,21,0,1,27,2,18,3,1,24
2020,45006,Filattiera,MS,58,3,11,2,0,16,1,17,0,1,19
2020,45006,Filattiera,MS,59,2,22,3,0,27,1,10,3,0,14
2020,45006,Filattiera,MS,60,2,15,0,1,18,0,15,1,2,18
2020,45006,Filattiera,MS,61,4,17,1,2,24,2,10,1,0,13
2020,45006,Filattiera,MS,62,1,14,0,1,16,0,14,1,2,17
2020,45006,Filattiera,MS,63,5,10,0,1,16,1,9,0,3,13
2020,45006,Filattiera,MS,64,1,10,0,1,12,0,12,1,5,18
2020,45006,Filattiera,MS,65,4,7,3,1,15,0,8,0,1,9
2020,45006,Filattiera,MS,66,1,11,0,0,12,0,11,0,6,17
2020,45006,Filattiera,MS,67,2,9,0,0,11,2,14,0,2,18
2020,45006,Filattiera,MS,68,0,14,0,1,15,0,11,0,2,13
2020,45006,Filattiera,MS,69,2,5,0,0,7,1,5,0,2,8
2020,45006,Filattiera,MS,70,6,11,1,5,23,1,14,1,4,20
2020,45006,Filattiera,MS,71,2,7,0,1,10,0,8,0,4,12
2020,45006,Filattiera,MS,72,2,15,0,1,18,0,15,1,2,18
2020,45006,Filattiera,MS,73,2,8,0,1,11,0,10,0,8,18
2020,45006,Filattiera,MS,74,2,13,0,0,15,0,9,1,6,16
2020,45006,Filattiera,MS,75,2,8,0,0,10,0,7,0,10,17
2020,45006,Filattiera,MS,76,2,11,1,2,16,1,7,1,7,16
2020,45006,Filattiera,MS,77,1,9,0,1,11,3,10,0,5,18
2020,45006,Filattiera,MS,78,1,8,0,0,9,0,9,0,7,16
2020,45006,Filattiera,MS,79,3,8,0,2,13,0,9,0,3,12
2020,45006,Filattiera,MS,80,0,10,1,2,13,0,5,0,4,9
2020,45006,Filattiera,MS,81,3,8,0,1,12,0,7,0,11,18
2020,45006,Filattiera,MS,82,1,9,0,1,11,0,4,0,16,20
2020,45006,Filattiera,MS,83,2,7,0,1,10,0,3,0,6,9
2020,45006,Filattiera,MS,84,1,4,0,0,5,0,5,0,9,14
2020,45006,Filattiera,MS,85,0,7,1,1,9,0,6,0,11,17
2020,45006,Filattiera,MS,86,2,7,0,2,11,1,1,1,7,10
2020,45006,Filattiera,MS,87,3,6,0,2,11,0,3,0,12,15
2020,45006,Filattiera,MS,88,0,7,0,2,9,0,2,0,8,10
2020,45006,Filattiera,MS,89,1,0,0,1,2,1,0,0,8,9
2020,45006,Filattiera,MS,90,1,3,0,1,5,0,0,0,7,7
2020,45006,Filattiera,MS,91,0,4,0,2,6,0,1,0,5,6
2020,45006,Filattiera,MS,92,1,1,0,0,2,0,0,0,7,7
2020,45006,Filattiera,MS,93,0,2,0,1,3,0,0,0,6,6
2020,45006,Filattiera,MS,94,0,0,0,0,0,0,0,0,3,3
2020,45006,Filattiera,MS,95,0,0,0,0,0,0,0,0,4,4
2020,45006,Filattiera,MS,96,0,0,0,0,0,0,0,0,2,2
2020,45006,Filattiera,MS,97,0,0,0,0,0,0,0,0,2,2
2020,45006,Filattiera,MS,98,0,0,0,0,0,0,0,0,0,0
2020,45006,Filattiera,MS,99,0,0,0,0,0,0,0,0,2,2
2020,45006,Filattiera,MS,100 e più,0,0,0,0,0,1,0,0,0,1
2020,45007,Fivizzano,MS,0,15,0,0,0,15,14,0,0,0,14
2020,45007,Fivizzano,MS,1,6,0,0,0,6,12,0,0,0,12
2020,45007,Fivizzano,MS,2,23,0,0,0,23,8,0,0,0,8
2020,45007,Fivizzano,MS,3,20,0,0,0,20,21,0,0,0,21
2020,45007,Fivizzano,MS,4,20,0,0,0,20,15,0,0,0,15
2020,45007,Fivizzano,MS,5,22,0,0,0,22,27,0,0,0,27
2020,45007,Fivizzano,MS,6,12,0,0,0,12,18,0,0,0,18
2020,45007,Fivizzano,MS,7,21,0,0,0,21,20,0,0,0,20
2020,45007,Fivizzano,MS,8,32,0,0,0,32,25,0,0,0,25
2020,45007,Fivizzano,MS,9,17,0,0,0,17,20,0,0,0,20
2020,45007,Fivizzano,MS,10,28,0,0,0,28,28,0,0,0,28
2020,45007,Fivizzano,MS,11,18,0,0,0,18,15,0,0,0,15
2020,45007,Fivizzano,MS,12,21,0,0,0,21,31,0,0,0,31
2020,45007,Fivizzano,MS,13,26,0,0,0,26,25,0,0,0,25
2020,45007,Fivizzano,MS,14,16,0,0,0,16,22,0,0,0,22
2020,45007,Fivizzano,MS,15,34,0,0,0,34,19,0,0,0,19
2020,45007,Fivizzano,MS,16,19,0,0,0,19,30,0,0,0,30
2020,45007,Fivizzano,MS,17,20,0,0,0,20,17,0,0,0,17
2020,45007,Fivizzano,MS,18,25,0,0,0,25,24,0,0,0,24
2020,45007,Fivizzano,MS,19,27,0,0,0,27,19,1,0,0,20
2020,45007,Fivizzano,MS,20,21,0,0,0,21,28,0,0,0,28
2020,45007,Fivizzano,MS,21,23,0,0,0,23,28,0,0,0,28
2020,45007,Fivizzano,MS,22,25,0,0,0,25,32,0,0,0,32
2020,45007,Fivizzano,MS,23,26,0,0,0,26,18,1,0,0,19
2020,45007,Fivizzano,MS,24,28,0,0,0,28,19,0,0,0,19
2020,45007,Fivizzano,MS,25,33,0,0,0,33,14,3,0,0,17
2020,45007,Fivizzano,MS,26,30,1,0,0,31,29,3,0,0,32
2020,45007,Fivizzano,MS,27,28,1,0,0,29,10,1,0,0,11
2020,45007,Fivizzano,MS,28,24,2,0,0,26,14,3,0,0,17
2020,45007,Fivizzano,MS,29,22,4,0,0,26,13,5,0,0,18
2020,45007,Fivizzano,MS,30,31,1,0,0,32,22,8,0,0,30
2020,45007,Fivizzano,MS,31,27,4,0,0,31,18,6,0,0,24
2020,45007,Fivizzano,MS,32,35,3,0,0,38,19,11,1,0,31
2020,45007,Fivizzano,MS,33,28,5,1,0,34,11,16,0,0,27
2020,45007,Fivizzano,MS,34,19,9,0,0,28,11,8,1,0,20
2020,45007,Fivizzano,MS,35,18,9,1,0,28,14,11,1,0,26
2020,45007,Fivizzano,MS,36,36,9,1,0,46,14,12,0,0,26
2020,45007,Fivizzano,MS,37,22,9,1,0,32,14,24,0,0,38
2020,45007,Fivizzano,MS,38,30,8,1,0,39,12,19,0,0,31
2020,45007,Fivizzano,MS,39,17,15,1,0,33,13,15,1,0,29
2020,45007,Fivizzano,MS,40,16,15,2,0,33,11,19,2,0,32
2020,45007,Fivizzano,MS,41,18,11,1,0,30,11,20,2,1,34
2020,45007,Fivizzano,MS,42,13,16,3,0,32,14,22,0,0,36
2020,45007,Fivizzano,MS,43,21,14,2,0,37,11,23,2,0,36
2020,45007,Fivizzano,MS,44,26,31,2,0,59,10,23,2,1,36
2020,45007,Fivizzano,MS,45,20,22,2,0,44,10,44,6,0,60
2020,45007,Fivizzano,MS,46,26,23,2,0,51,11,32,3,1,47
2020,45007,Fivizzano,MS,47,21,37,1,0,59,10,31,2,1,44
2020,45007,Fivizzano,MS,48,20,31,5,0,56,4,30,7,0,41
2020,45007,Fivizzano,MS,49,20,37,2,0,59,7,38,2,0,47
2020,45007,Fivizzano,MS,50,16,31,9,0,56,7,38,4,2,51
2020,45007,Fivizzano,MS,51,20,35,5,0,60,19,44,3,1,67
2020,45007,Fivizzano,MS,52,17,42,4,0,63,8,49,6,2,65
2020,45007,Fivizzano,MS,53,15,42,4,0,61,7,35,3,1,46
2020,45007,Fivizzano,MS,54,16,44,2,0,62,10,46,6,1,63
2020,45007,Fivizzano,MS,55,15,38,7,1,61,5,40,2,1,48
2020,45007,Fivizzano,MS,56,13,42,5,0,60,4,36,5,4,49
2020,45007,Fivizzano,MS,57,12,39,3,0,54,6,53,4,4,67
2020,45007,Fivizzano,MS,58,15,36,7,1,59,6,49,7,2,64
2020,45007,Fivizzano,MS,59,14,40,5,2,61,6,46,4,4,60
2020,45007,Fivizzano,MS,60,8,37,3,0,48,3,33,4,2,42
2020,45007,Fivizzano,MS,61,12,34,7,1,54,4,49,4,4,61
2020,45007,Fivizzano,MS,62,7,40,6,0,53,2,54,4,6,66
2020,45007,Fivizzano,MS,63,8,34,9,1,52,8,57,6,8,79
2020,45007,Fivizzano,MS,64,6,52,3,0,61,3,39,4,7,53
2020,45007,Fivizzano,MS,65,7,37,4,1,49,3,36,4,8,51
2020,45007,Fivizzano,MS,66,14,44,3,2,63,1,36,1,9,47
2020,45007,Fivizzano,MS,67,6,40,3,6,55,3,41,0,17,61
2020,45007,Fivizzano,MS,68,5,50,3,1,59,1,37,1,8,47
2020,45007,Fivizzano,MS,69,6,41,0,2,49,3,45,1,13,62
2020,45007,Fivizzano,MS,70,9,52,3,2,66,2,43,3,13,61
2020,45007,Fivizzano,MS,71,9,60,1,3,73,3,39,0,15,57
2020,45007,Fivizzano,MS,72,4,54,7,4,69,2,44,2,16,64
2020,45007,Fivizzano,MS,73,7,55,4,3,69,2,49,1,22,74
2020,45007,Fivizzano,MS,74,5,41,0,6,52,0,33,2,24,59
2020,45007,Fivizzano,MS,75,5,29,2,6,42,1,30,3,18,52
2020,45007,Fivizzano,MS,76,7,41,0,1,49,2,25,1,15,43
2020,45007,Fivizzano,MS,77,5,32,1,4,42,1,25,2,21,49
2020,45007,Fivizzano,MS,78,7,30,2,4,43,3,30,0,21,54
2020,45007,Fivizzano,MS,79,6,32,1,4,43,1,20,3,27,51
2020,45007,Fivizzano,MS,80,3,31,0,8,42,2,28,3,30,63
2020,45007,Fivizzano,MS,81,2,34,1,5,42,1,25,1,31,58
2020,45007,Fivizzano,MS,82,5,36,1,9,51,2,17,2,28,49
2020,45007,Fivizzano,MS,83,5,27,0,9,41,1,23,1,37,62
2020,45007,Fivizzano,MS,84,3,24,0,3,30,2,10,0,31,43
2020,45007,Fivizzano,MS,85,3,15,0,4,22,1,17,1,27,46
2020,45007,Fivizzano,MS,86,2,17,0,9,28,1,8,1,35,45
2020,45007,Fivizzano,MS,87,6,13,0,11,30,2,10,0,43,55
2020,45007,Fivizzano,MS,88,1,23,0,6,30,1,2,1,39,43
2020,45007,Fivizzano,MS,89,2,11,1,9,23,0,5,0,27,32
2020,45007,Fivizzano,MS,90,0,8,0,7,15,2,2,0,34,38
2020,45007,Fivizzano,MS,91,1,4,1,5,11,2,3,1,29,35
2020,45007,Fivizzano,MS,92,1,6,0,2,9,2,2,0,23,27
2020,45007,Fivizzano,MS,93,0,3,0,3,6,2,1,0,17,20
2020,45007,Fivizzano,MS,94,0,3,0,2,5,2,1,0,20,23
2020,45007,Fivizzano,MS,95,0,2,0,1,3,0,0,0,16,16
2020,45007,Fivizzano,MS,96,0,1,0,2,3,0,0,0,13,13
2020,45007,Fivizzano,MS,97,0,0,0,1,1,1,0,0,5,6
2020,45007,Fivizzano,MS,98,0,1,0,0,1,0,0,0,6,6
2020,45007,Fivizzano,MS,99,0,0,0,0,0,0,1,0,4,5
2020,45007,Fivizzano,MS,100 e più,0,0,0,1,1,0,0,0,2,2
2020,45008,Fosdinovo,MS,0,15,0,0,0,15,9,0,0,0,9
2020,45008,Fosdinovo,MS,1,6,0,0,0,6,5,0,0,0,5
2020,45008,Fosdinovo,MS,2,14,0,0,0,14,10,0,0,0,10
2020,45008,Fosdinovo,MS,3,13,0,0,0,13,14,0,0,0,14
2020,45008,Fosdinovo,MS,4,15,0,0,0,15,14,0,0,0,14
2020,45008,Fosdinovo,MS,5,15,0,0,0,15,13,0,0,0,13
2020,45008,Fosdinovo,MS,6,11,0,0,0,11,9,0,0,0,9
2020,45008,Fosdinovo,MS,7,16,0,0,0,16,16,0,0,0,16
2020,45008,Fosdinovo,MS,8,22,0,0,0,22,12,0,0,0,12
2020,45008,Fosdinovo,MS,9,24,0,0,0,24,23,0,0,0,23
2020,45008,Fosdinovo,MS,10,21,0,0,0,21,23,0,0,0,23
2020,45008,Fosdinovo,MS,11,24,0,0,0,24,16,0,0,0,16
2020,45008,Fosdinovo,MS,12,21,0,0,0,21,22,0,0,0,22
2020,45008,Fosdinovo,MS,13,18,0,0,0,18,26,0,0,0,26
2020,45008,Fosdinovo,MS,14,20,0,0,0,20,15,0,0,0,15
2020,45008,Fosdinovo,MS,15,26,0,0,0,26,18,0,0,0,18
2020,45008,Fosdinovo,MS,16,18,0,0,0,18,19,0,0,0,19
2020,45008,Fosdinovo,MS,17,18,0,0,0,18,16,0,0,0,16
2020,45008,Fosdinovo,MS,18,21,0,0,0,21,14,0,0,0,14
2020,45008,Fosdinovo,MS,19,20,0,0,0,20,17,0,0,0,17
2020,45008,Fosdinovo,MS,20,28,0,0,0,28,18,0,0,0,18
2020,45008,Fosdinovo,MS,21,15,0,0,0,15,13,0,0,0,13
2020,45008,Fosdinovo,MS,22,21,0,0,0,21,19,0,0,0,19
2020,45008,Fosdinovo,MS,23,18,0,0,0,18,16,0,0,0,16
2020,45008,Fosdinovo,MS,24,18,0,0,0,18,17,1,0,0,18
2020,45008,Fosdinovo,MS,25,24,0,0,0,24,15,1,0,0,16
2020,45008,Fosdinovo,MS,26,18,2,0,0,20,17,3,0,0,20
2020,45008,Fosdinovo,MS,27,13,1,0,0,14,16,3,0,0,19
2020,45008,Fosdinovo,MS,28,11,2,0,0,13,18,1,0,0,19
2020,45008,Fosdinovo,MS,29,13,1,0,0,14,13,2,0,0,15
2020,45008,Fosdinovo,MS,30,19,1,0,0,20,21,5,0,0,26
2020,45008,Fosdinovo,MS,31,11,2,0,0,13,13,3,0,0,16
2020,45008,Fosdinovo,MS,32,17,4,0,0,21,15,11,0,0,26
2020,45008,Fosdinovo,MS,33,14,2,0,0,16,14,4,0,0,18
2020,45008,Fosdinovo,MS,34,15,8,0,0,23,8,11,1,0,20
2020,45008,Fosdinovo,MS,35,16,5,0,0,21,13,9,0,0,22
2020,45008,Fosdinovo,MS,36,8,10,2,0,20,11,13,0,0,24
2020,45008,Fosdinovo,MS,37,15,7,0,0,22,12,16,0,1,29
2020,45008,Fosdinovo,MS,38,17,7,0,0,24,11,11,0,0,22
2020,45008,Fosdinovo,MS,39,12,14,1,0,27,7,13,1,0,21
2020,45008,Fosdinovo,MS,40,14,5,0,0,19,5,13,2,0,20
2020,45008,Fosdinovo,MS,41,14,9,1,0,24,10,14,5,0,29
2020,45008,Fosdinovo,MS,42,7,19,1,0,27,19,20,3,1,43
2020,45008,Fosdinovo,MS,43,17,14,2,0,33,9,12,2,0,23
2020,45008,Fosdinovo,MS,44,12,21,2,0,35,10,15,1,0,26
2020,45008,Fosdinovo,MS,45,12,13,2,0,27,10,19,1,1,31
2020,45008,Fosdinovo,MS,46,14,11,3,0,28,8,23,4,1,36
2020,45008,Fosdinovo,MS,47,16,23,1,0,40,11,23,4,0,38
2020,45008,Fosdinovo,MS,48,14,26,2,0,42,10,32,3,1,46
2020,45008,Fosdinovo,MS,49,8,22,0,0,30,13,29,1,0,43
2020,45008,Fosdinovo,MS,50,12,29,2,0,43,9,31,4,0,44
2020,45008,Fosdinovo,MS,51,13,18,8,0,39,4,34,2,1,41
2020,45008,Fosdinovo,MS,52,10,22,8,1,41,4,25,6,1,36
2020,45008,Fosdinovo,MS,53,11,28,2,0,41,14,29,1,0,44
2020,45008,Fosdinovo,MS,54,14,33,5,0,52,4,24,2,4,34
2020,45008,Fosdinovo,MS,55,9,37,3,0,49,10,38,6,2,56
2020,45008,Fosdinovo,MS,56,11,27,5,1,44,6,28,7,1,42
2020,45008,Fosdinovo,MS,57,5,36,5,0,46,4,34,11,1,50
2020,45008,Fosdinovo,MS,58,6,29,5,0,40,9,27,6,0,42
2020,45008,Fosdinovo,MS,59,5,37,2,0,44,1,32,2,4,39
2020,45008,Fosdinovo,MS,60,7,27,2,0,36,4,28,6,3,41
2020,45008,Fosdinovo,MS,61,3,28,3,0,34,1,20,0,0,21
2020,45008,Fosdinovo,MS,62,2,19,1,2,24,3,26,4,7,40
2020,45008,Fosdinovo,MS,63,6,24,1,1,32,3,24,2,3,32
2020,45008,Fosdinovo,MS,64,5,13,3,2,23,1,21,1,4,27
2020,45008,Fosdinovo,MS,65,2,17,8,1,28,3,26,4,5,38
2020,45008,Fosdinovo,MS,66,4,27,0,0,31,1,22,2,3,28
2020,45008,Fosdinovo,MS,67,3,33,1,1,38,1,20,4,4,29
2020,45008,Fosdinovo,MS,68,2,23,1,3,29,2,16,4,5,27
2020,45008,Fosdinovo,MS,69,2,23,1,1,27,2,17,3,7,29
2020,45008,Fosdinovo,MS,70,4,28,2,1,35,1,30,2,4,37
2020,45008,Fosdinovo,MS,71,3,26,1,3,33,0,22,2,4,28
2020,45008,Fosdinovo,MS,72,4,22,1,2,29,3,22,1,3,29
2020,45008,Fosdinovo,MS,73,2,22,2,1,27,2,24,3,5,34
2020,45008,Fosdinovo,MS,74,2,26,0,3,31,1,23,3,14,41
2020,45008,Fosdinovo,MS,75,0,23,2,3,28,0,17,1,12,30
2020,45008,Fosdinovo,MS,76,1,16,0,3,20,2,24,0,13,39
2020,45008,Fosdinovo,MS,77,1,24,1,2,28,1,14,0,13,28
2020,45008,Fosdinovo,MS,78,1,22,2,2,27,0,11,0,11,22
2020,45008,Fosdinovo,MS,79,2,16,1,4,23,2,11,0,6,19
2020,45008,Fosdinovo,MS,80,3,16,0,4,23,0,21,1,10,32
2020,45008,Fosdinovo,MS,81,2,16,1,0,19,0,16,0,13,29
2020,45008,Fosdinovo,MS,82,4,18,1,4,27,1,12,0,16,29
2020,45008,Fosdinovo,MS,83,2,21,0,1,24,0,7,1,15,23
2020,45008,Fosdinovo,MS,84,1,12,0,4,17,0,5,1,15,21
2020,45008,Fosdinovo,MS,85,2,9,0,1,12,3,5,0,14,22
2020,45008,Fosdinovo,MS,86,1,10,0,0,11,0,7,1,7,15
2020,45008,Fosdinovo,MS,87,0,10,0,1,11,1,5,0,20,26
2020,45008,Fosdinovo,MS,88,1,9,0,2,12,0,2,0,11,13
2020,45008,Fosdinovo,MS,89,4,4,0,3,11,1,1,0,8,10
2020,45008,Fosdinovo,MS,90,0,5,0,2,7,1,1,0,6,8
2020,45008,Fosdinovo,MS,91,1,2,0,4,7,1,2,0,13,16
2020,45008,Fosdinovo,MS,92,0,1,0,0,1,1,0,0,8,9
2020,45008,Fosdinovo,MS,93,0,2,0,0,2,0,1,0,5,6
2020,45008,Fosdinovo,MS,94,0,0,0,1,1,0,0,0,3,3
2020,45008,Fosdinovo,MS,95,0,0,0,0,0,0,0,0,3,3
2020,45008,Fosdinovo,MS,96,1,1,0,0,2,0,0,0,4,4
2020,45008,Fosdinovo,MS,97,0,0,0,0,0,0,0,0,2,2
2020,45008,Fosdinovo,MS,98,0,0,0,0,0,0,0,0,2,2
2020,45008,Fosdinovo,MS,99,0,0,0,0,0,0,0,0,0,0
2020,45008,Fosdinovo,MS,100 e più,0,0,0,0,0,0,0,0,2,2
2020,45009,Licciana Nardi,MS,0,21,0,0,0,21,14,0,0,0,14
2020,45009,Licciana Nardi,MS,1,15,0,0,0,15,15,0,0,0,15
2020,45009,Licciana Nardi,MS,2,16,0,0,0,16,13,0,0,0,13
2020,45009,Licciana Nardi,MS,3,14,0,0,0,14,17,0,0,0,17
2020,45009,Licciana Nardi,MS,4,17,0,0,0,17,15,0,0,0,15
2020,45009,Licciana Nardi,MS,5,11,0,0,0,11,19,0,0,0,19
2020,45009,Licciana Nardi,MS,6,23,0,0,0,23,27,0,0,0,27
2020,45009,Licciana Nardi,MS,7,27,0,0,0,27,20,0,0,0,20
2020,45009,Licciana Nardi,MS,8,23,0,0,0,23,18,0,0,0,18
2020,45009,Licciana Nardi,MS,9,9,0,0,0,9,25,0,0,0,25
2020,45009,Licciana Nardi,MS,10,22,0,0,0,22,24,0,0,0,24
2020,45009,Licciana Nardi,MS,11,19,0,0,0,19,20,0,0,0,20
2020,45009,Licciana Nardi,MS,12,30,0,0,0,30,14,0,0,0,14
2020,45009,Licciana Nardi,MS,13,24,0,0,0,24,14,0,0,0,14
2020,45009,Licciana Nardi,MS,14,20,0,0,0,20,19,0,0,0,19
2020,45009,Licciana Nardi,MS,15,13,0,0,0,13,16,0,0,0,16
2020,45009,Licciana Nardi,MS,16,14,0,0,0,14,13,0,0,0,13
2020,45009,Licciana Nardi,MS,17,18,0,0,0,18,22,0,0,0,22
2020,45009,Licciana Nardi,MS,18,20,0,0,0,20,21,0,0,0,21
2020,45009,Licciana Nardi,MS,19,18,0,0,0,18,15,0,0,0,15
2020,45009,Licciana Nardi,MS,20,17,0,0,0,17,13,0,0,0,13
2020,45009,Licciana Nardi,MS,21,22,0,0,0,22,16,1,0,0,17
2020,45009,Licciana Nardi,MS,22,26,0,0,0,26,9,1,0,0,10
2020,45009,Licciana Nardi,MS,23,17,0,0,0,17,20,0,0,0,20
2020,45009,Licciana Nardi,MS,24,16,0,0,0,16,18,2,0,0,20
2020,45009,Licciana Nardi,MS,25,22,0,0,0,22,21,0,0,0,21
2020,45009,Licciana Nardi,MS,26,21,3,0,0,24,19,2,0,0,21
2020,45009,Licciana Nardi,MS,27,26,1,0,0,27,12,3,0,0,15
2020,45009,Licciana Nardi,MS,28,22,2,0,0,24,11,6,0,0,17
2020,45009,Licciana Nardi,MS,29,24,2,0,0,26,12,4,0,0,16
2020,45009,Licciana Nardi,MS,30,23,4,0,0,27,12,5,0,0,17
2020,45009,Licciana Nardi,MS,31,14,2,0,0,16,12,9,2,0,23
2020,45009,Licciana Nardi,MS,32,22,7,0,0,29,15,13,2,0,30
2020,45009,Licciana Nardi,MS,33,22,5,0,0,27,23,6,1,0,30
2020,45009,Licciana Nardi,MS,34,16,7,0,0,23,11,7,0,0,18
2020,45009,Licciana Nardi,MS,35,10,6,1,0,17,11,10,0,0,21
2020,45009,Licciana Nardi,MS,36,16,10,1,0,27,10,16,1,1,28
2020,45009,Licciana Nardi,MS,37,18,10,1,0,29,12,15,2,0,29
2020,45009,Licciana Nardi,MS,38,19,11,0,0,30,9,20,0,0,29
2020,45009,Licciana Nardi,MS,39,13,13,0,0,26,17,12,1,0,30
2020,45009,Licciana Nardi,MS,40,22,16,2,1,41,8,17,2,0,27
2020,45009,Licciana Nardi,MS,41,15,19,0,0,34,17,18,1,0,36
2020,45009,Licciana Nardi,MS,42,20,16,2,0,38,11,23,5,0,39
2020,45009,Licciana Nardi,MS,43,21,22,0,0,43,14,17,2,1,34
2020,45009,Licciana Nardi,MS,44,18,19,0,0,37,12,26,3,0,41
2020,45009,Licciana Nardi,MS,45,20,30,1,0,51,13,27,2,0,42
2020,45009,Licciana Nardi,MS,46,15,17,1,0,33,13,10,2,0,25
2020,45009,Licciana Nardi,MS,47,8,16,2,0,26,3,32,1,0,36
2020,45009,Licciana Nardi,MS,48,9,20,2,1,32,6,22,1,1,30
2020,45009,Licciana Nardi,MS,49,14,24,3,0,41,9,24,0,2,35
2020,45009,Licciana Nardi,MS,50,6,20,3,0,29,3,32,5,1,41
2020,45009,Licciana Nardi,MS,51,16,34,5,0,55,7,28,2,1,38
2020,45009,Licciana Nardi,MS,52,9,30,3,1,43,9,27,4,0,40
2020,45009,Licciana Nardi,MS,53,8,33,1,0,42,4,30,3,0,37
2020,45009,Licciana Nardi,MS,54,10,27,1,2,40,2,38,4,3,47
2020,45009,Licciana Nardi,MS,55,8,32,4,0,44,7,29,6,0,42
2020,45009,Licciana Nardi,MS,56,3,40,2,2,47,6,32,4,3,45
2020,45009,Licciana Nardi,MS,57,5,25,8,1,39,6,38,5,5,54
2020,45009,Licciana Nardi,MS,58,2,46,2,0,50,2,33,1,3,39
2020,45009,Licciana Nardi,MS,59,6,21,4,2,33,4,40,3,3,50
2020,45009,Licciana Nardi,MS,60,5,30,1,0,36,1,24,0,5,30
2020,45009,Licciana Nardi,MS,61,6,28,2,1,37,5,22,3,3,33
2020,45009,Licciana Nardi,MS,62,4,38,1,1,44,1,32,0,2,35
2020,45009,Licciana Nardi,MS,63,4,26,0,0,30,1,26,1,10,38
2020,45009,Licciana Nardi,MS,64,3,28,5,2,38,1,21,1,1,24
2020,45009,Licciana Nardi,MS,65,1,19,1,0,21,3,29,2,4,38
2020,45009,Licciana Nardi,MS,66,1,27,1,1,30,1,26,0,5,32
2020,45009,Licciana Nardi,MS,67,2,25,1,2,30,3,19,2,6,30
2020,45009,Licciana Nardi,MS,68,11,16,0,0,27,4,21,2,7,34
2020,45009,Licciana Nardi,MS,69,4,28,0,1,33,2,17,0,3,22
2020,45009,Licciana Nardi,MS,70,4,21,2,1,28,3,16,0,5,24
2020,45009,Licciana Nardi,MS,71,3,30,2,0,35,1,15,0,7,23
2020,45009,Licciana Nardi,MS,72,2,22,2,2,28,0,20,0,6,26
2020,45009,Licciana Nardi,MS,73,0,13,1,2,16,2,19,2,11,34
2020,45009,Licciana Nardi,MS,74,3,25,0,2,30,1,16,0,8,25
2020,45009,Licciana Nardi,MS,75,0,17,0,1,18,1,16,0,4,21
2020,45009,Licciana Nardi,MS,76,2,21,0,2,25,1,15,0,8,24
2020,45009,Licciana Nardi,MS,77,1,18,0,3,22,2,14,0,9,25
2020,45009,Licciana Nardi,MS,78,2,19,0,0,21,0,16,0,9,25
2020,45009,Licciana Nardi,MS,79,3,15,1,2,21,0,9,1,15,25
2020,45009,Licciana Nardi,MS,80,1,19,0,4,24,3,11,0,15,29
2020,45009,Licciana Nardi,MS,81,3,19,0,6,28,1,15,0,15,31
2020,45009,Licciana Nardi,MS,82,2,6,0,1,9,1,11,1,19,32
2020,45009,Licciana Nardi,MS,83,1,14,0,6,21,0,4,0,26,30
2020,45009,Licciana Nardi,MS,84,1,8,0,2,11,1,4,0,17,22
2020,45009,Licciana Nardi,MS,85,2,4,0,1,7,1,2,1,18,22
2020,45009,Licciana Nardi,MS,86,0,8,0,2,10,1,3,0,13,17
2020,45009,Licciana Nardi,MS,87,0,9,0,1,10,0,2,0,10,12
2020,45009,Licciana Nardi,MS,88,1,3,0,3,7,0,3,0,15,18
2020,45009,Licciana Nardi,MS,89,1,1,0,5,7,1,1,1,10,13
2020,45009,Licciana Nardi,MS,90,0,1,0,4,5,0,0,0,16,16
2020,45009,Licciana Nardi,MS,91,1,3,0,3,7,2,1,0,12,15
2020,45009,Licciana Nardi,MS,92,0,1,0,5,6,0,0,0,11,11
2020,45009,Licciana Nardi,MS,93,0,1,0,1,2,0,0,0,12,12
2020,45009,Licciana Nardi,MS,94,0,0,0,1,1,0,1,0,6,7
2020,45009,Licciana Nardi,MS,95,0,0,0,0,0,1,1,0,0,2
2020,45009,Licciana Nardi,MS,96,0,0,0,0,0,0,1,0,4,5
2020,45009,Licciana Nardi,MS,97,0,0,0,0,0,0,0,0,2,2
2020,45009,Licciana Nardi,MS,98,0,0,0,0,0,0,0,0,3,3
2020,45009,Licciana Nardi,MS,99,0,0,0,0,0,0,0,0,0,0
2020,45009,Licciana Nardi,MS,100 e più,0,0,0,1,1,0,0,0,3,3
2020,45010,Massa,MS,0,209,0,0,0,209,153,0,0,0,153
2020,45010,Massa,MS,1,187,0,0,0,187,199,0,0,0,199
2020,45010,Massa,MS,2,204,0,0,0,204,209,0,0,0,209
2020,45010,Massa,MS,3,231,0,0,0,231,210,0,0,0,210
2020,45010,Massa,MS,4,226,0,0,0,226,242,0,0,0,242
2020,45010,Massa,MS,5,222,0,0,0,222,206,0,0,0,206
2020,45010,Massa,MS,6,233,0,0,0,233,235,0,0,0,235
2020,45010,Massa,MS,7,275,0,0,0,275,268,0,0,0,268
2020,45010,Massa,MS,8,277,0,0,0,277,271,0,0,0,271
2020,45010,Massa,MS,9,272,0,0,0,272,260,0,0,0,260
2020,45010,Massa,MS,10,293,0,0,0,293,279,0,0,0,279
2020,45010,Massa,MS,11,276,0,0,0,276,273,0,0,0,273
2020,45010,Massa,MS,12,318,0,0,0,318,302,0,0,0,302
2020,45010,Massa,MS,13,285,0,0,0,285,284,0,0,0,284
2020,45010,Massa,MS,14,330,0,0,0,330,291,0,0,0,291
2020,45010,Massa,MS,15,299,0,0,0,299,304,0,0,0,304
2020,45010,Massa,MS,16,264,0,0,0,264,275,0,0,0,275
2020,45010,Massa,MS,17,310,0,0,0,310,280,0,0,0,280
2020,45010,Massa,MS,18,327,0,0,0,327,290,0,0,0,290
2020,45010,Massa,MS,19,282,0,0,0,282,289,1,0,0,290
2020,45010,Massa,MS,20,319,1,0,0,320,266,1,0,0,267
2020,45010,Massa,MS,21,292,1,0,0,293,266,4,0,0,270
2020,45010,Massa,MS,22,345,3,0,0,348,292,4,0,0,296
2020,45010,Massa,MS,23,300,2,0,0,302,258,8,0,0,266
2020,45010,Massa,MS,24,320,6,0,0,326,275,14,0,0,289
2020,45010,Massa,MS,25,338,5,0,0,343,292,20,0,0,312
2020,45010,Massa,MS,26,282,6,0,0,288,272,25,0,0,297
2020,45010,Massa,MS,27,318,13,0,0,331,261,37,2,0,300
2020,45010,Massa,MS,28,328,14,2,0,344,258,55,1,0,314
2020,45010,Massa,MS,29,323,25,1,1,351,248,68,1,1,318
2020,45010,Massa,MS,30,286,51,0,0,338,222,93,1,1,317
2020,45010,Massa,MS,31,279,53,6,0,339,223,84,4,0,311
2020,45010,Massa,MS,32,296,83,7,0,386,197,108,2,1,308
2020,45010,Massa,MS,33,263,78,5,0,346,193,147,6,0,346
2020,45010,Massa,MS,34,247,98,2,0,348,194,136,11,0,341
2020,45010,Massa,MS,35,242,107,6,0,355,180,171,6,1,359
2020,45010,Massa,MS,36,282,115,7,0,404,181,186,8,1,376
2020,45010,Massa,MS,37,235,165,6,2,408,193,193,13,1,401
2020,45010,Massa,MS,38,196,167,3,1,369,147,218,13,1,379
2020,45010,Massa,MS,39,189,178,11,0,380,145,193,19,2,359
2020,45010,Massa,MS,40,242,176,10,0,429,114,222,19,1,356
2020,45010,Massa,MS,41,203,200,11,0,416,141,239,16,4,400
2020,45010,Massa,MS,42,213,204,13,1,431,148,249,25,3,426
2020,45010,Massa,MS,43,213,222,10,1,446,153,329,40,4,526
2020,45010,Massa,MS,44,189,284,14,0,487,134,301,43,2,480
2020,45010,Massa,MS,45,189,274,28,2,493,158,312,46,7,523
2020,45010,Massa,MS,46,169,284,22,3,479,133,349,48,9,539
2020,45010,Massa,MS,47,186,315,38,0,540,119,360,45,9,534
2020,45010,Massa,MS,48,174,346,29,3,552,101,371,48,10,530
2020,45010,Massa,MS,49,148,319,39,4,510,119,340,49,9,517
2020,45010,Massa,MS,50,140,334,31,0,506,111,374,57,14,556
2020,45010,Massa,MS,51,148,354,31,2,535,113,416,54,16,600
2020,45010,Massa,MS,52,119,362,34,2,518,100,364,51,14,529
2020,45010,Massa,MS,53,115,366,48,4,533,92,373,55,13,534
2020,45010,Massa,MS,54,123,376,41,7,548,82,399,64,15,560
2020,45010,Massa,MS,55,115,400,47,4,567,97,399,64,24,584
2020,45010,Massa,MS,56,99,443,49,6,600,73,438,57,29,598
2020,45010,Massa,MS,57,72,406,63,3,546,65,431,64,22,582
2020,45010,Massa,MS,58,96,397,49,6,548,68,394,55,29,546
2020,45010,Massa,MS,59,81,377,43,8,509,59,399,46,34,538
2020,45010,Massa,MS,60,61,387,38,6,492,70,372,60,33,535
2020,45010,Massa,MS,61,59,375,35,6,475,58,380,40,39,517
2020,45010,Massa,MS,62,61,375,30,18,484,69,406,37,50,562
2020,45010,Massa,MS,63,52,390,35,10,488,55,399,32,51,537
2020,45010,Massa,MS,64,52,425,33,7,518,43,397,33,73,546
2020,45010,Massa,MS,65,59,350,30,19,458,40,397,26,64,527
2020,45010,Massa,MS,66,47,372,27,17,464,48,330,42,49,469
2020,45010,Massa,MS,67,30,387,15,17,449,36,328,21,82,467
2020,45010,Massa,MS,68,30,347,12,10,399,32,296,19,80,427
2020,45010,Massa,MS,69,33,321,25,20,399,34,280,24,75,413
2020,45010,Massa,MS,70,26,322,21,23,392,30,297,25,94,446
2020,45010,Massa,MS,71,28,324,14,28,395,32,295,32,105,464
2020,45010,Massa,MS,72,32,338,15,20,405,29,269,29,122,449
2020,45010,Massa,MS,73,19,318,11,24,372,19,307,16,147,489
2020,45010,Massa,MS,74,34,333,17,32,416,25,272,18,163,478
2020,45010,Massa,MS,75,8,200,6,18,232,15,175,16,99,305
2020,45010,Massa,MS,76,11,219,5,27,262,13,193,20,164,390
2020,45010,Massa,MS,77,13,236,7,23,279,13,175,16,123,327
2020,45010,Massa,MS,78,17,227,8,26,278,11,167,12,153,343
2020,45010,Massa,MS,79,16,244,8,27,295,18,180,13,155,366
2020,45010,Massa,MS,80,18,244,11,39,313,17,184,16,227,444
2020,45010,Massa,MS,81,9,194,5,39,247,21,133,9,174,337
2020,45010,Massa,MS,82,16,187,4,34,241,11,112,5,190,318
2020,45010,Massa,MS,83,19,125,2,33,179,18,103,4,190,315
2020,45010,Massa,MS,84,9,107,3,42,161,12,67,3,186,268
2020,45010,Massa,MS,85,9,127,1,31,168,13,65,1,197,276
2020,45010,Massa,MS,86,6,90,0,25,121,10,47,5,188,250
2020,45010,Massa,MS,87,9,79,1,25,114,14,34,3,170,221
2020,45010,Massa,MS,88,6,69,1,28,104,9,27,1,172,209
2020,45010,Massa,MS,89,1,50,0,22,73,10,19,4,147,180
2020,45010,Massa,MS,90,7,41,3,33,84,7,20,4,130,161
2020,45010,Massa,MS,91,5,35,1,22,63,14,10,0,129,153
2020,45010,Massa,MS,92,0,20,0,24,44,8,8,1,95,112
2020,45010,Massa,MS,93,0,12,0,12,24,5,3,1,71,80
2020,45010,Massa,MS,94,1,5,0,12,18,6,3,0,58,67
2020,45010,Massa,MS,95,0,4,1,9,14,3,1,1,50,55
2020,45010,Massa,MS,96,0,2,0,8,10,3,1,0,31,35
2020,45010,Massa,MS,97,1,0,0,1,2,3,0,0,16,19
2020,45010,Massa,MS,98,0,1,0,1,2,1,0,0,16,17
2020,45010,Massa,MS,99,0,1,0,2,3,5,0,0,2,7
2020,45010,Massa,MS,100 e più,0,2,0,1,3,1,0,0,18,19
2020,45011,Montignoso,MS,0,20,0,0,0,20,21,0,0,0,21
2020,45011,Montignoso,MS,1,34,0,0,0,34,21,0,0,0,21
2020,45011,Montignoso,MS,2,37,0,0,0,37,39,0,0,0,39
2020,45011,Montignoso,MS,3,43,0,0,0,43,41,0,0,0,41
2020,45011,Montignoso,MS,4,38,0,0,0,38,29,0,0,0,29
2020,45011,Montignoso,MS,5,32,0,0,0,32,26,0,0,0,26
2020,45011,Montignoso,MS,6,38,0,0,0,38,37,0,0,0,37
2020,45011,Montignoso,MS,7,41,0,0,0,41,38,0,0,0,38
2020,45011,Montignoso,MS,8,44,0,0,0,44,36,0,0,0,36
2020,45011,Montignoso,MS,9,50,0,0,0,50,35,0,0,0,35
2020,45011,Montignoso,MS,10,44,0,0,0,44,41,0,0,0,41
2020,45011,Montignoso,MS,11,43,0,0,0,43,31,0,0,0,31
2020,45011,Montignoso,MS,12,44,0,0,0,44,41,0,0,0,41
2020,45011,Montignoso,MS,13,40,0,0,0,40,46,0,0,0,46
2020,45011,Montignoso,MS,14,45,0,0,0,45,36,0,0,0,36
2020,45011,Montignoso,MS,15,45,0,0,0,45,49,0,0,0,49
2020,45011,Montignoso,MS,16,61,0,0,0,61,42,0,0,0,42
2020,45011,Montignoso,MS,17,38,0,0,0,38,42,0,0,0,42
2020,45011,Montignoso,MS,18,40,0,0,0,40,39,0,0,0,39
2020,45011,Montignoso,MS,19,55,0,0,0,55,33,0,0,0,33
2020,45011,Montignoso,MS,20,38,0,0,0,38,35,1,0,0,36
2020,45011,Montignoso,MS,21,45,0,0,0,45,39,1,0,0,40
2020,45011,Montignoso,MS,22,55,0,0,0,55,41,1,0,0,42
2020,45011,Montignoso,MS,23,41,0,0,0,41,38,2,0,0,40
2020,45011,Montignoso,MS,24,54,0,0,0,54,43,1,0,0,44
2020,45011,Montignoso,MS,25,48,1,0,0,49,41,1,1,0,43
2020,45011,Montignoso,MS,26,43,0,0,0,43,39,3,1,0,43
2020,45011,Montignoso,MS,27,57,2,0,0,59,44,6,1,0,51
2020,45011,Montignoso,MS,28,49,3,0,0,52,45,4,0,0,49
2020,45011,Montignoso,MS,29,47,4,0,0,51,36,11,0,0,47
2020,45011,Montignoso,MS,30,37,7,2,0,46,31,11,0,0,42
2020,45011,Montignoso,MS,31,35,4,0,0,39,26,11,0,0,37
2020,45011,Montignoso,MS,32,36,9,0,0,45,26,17,1,0,44
2020,45011,Montignoso,MS,33,33,11,1,0,45,23,20,1,0,44
2020,45011,Montignoso,MS,34,40,9,1,0,50,23,23,0,0,46
2020,45011,Montignoso,MS,35,36,20,1,0,57,33,19,1,0,53
2020,45011,Montignoso,MS,36,32,23,1,0,56,35,25,3,0,63
2020,45011,Montignoso,MS,37,39,19,3,0,61,24,33,1,1,59
2020,45011,Montignoso,MS,38,28,23,2,1,54,24,29,3,1,57
2020,45011,Montignoso,MS,39,25,22,2,0,49,17,45,4,1,67
2020,45011,Montignoso,MS,40,27,41,3,0,71,22,28,1,1,52
2020,45011,Montignoso,MS,41,30,27,1,0,58,22,36,4,0,62
2020,45011,Montignoso,MS,42,37,30,4,0,71,11,42,5,0,58
2020,45011,Montignoso,MS,43,21,48,4,0,73,21,55,3,0,79
2020,45011,Montignoso,MS,44,28,46,5,0,79,19,44,5,0,68
2020,45011,Montignoso,MS,45,29,52,3,0,84,20,52,7,0,79
2020,45011,Montignoso,MS,46,31,39,7,0,77,22,40,3,4,69
2020,45011,Montignoso,MS,47,18,49,4,1,72,15,61,7,2,85
2020,45011,Montignoso,MS,48,30,49,7,0,86,23,55,4,0,82
2020,45011,Montignoso,MS,49,26,53,0,0,79,21,50,8,3,82
2020,45011,Montignoso,MS,50,15,63,6,0,84,12,53,12,3,80
2020,45011,Montignoso,MS,51,24,53,8,0,85,20,47,13,1,81
2020,45011,Montignoso,MS,52,15,53,5,1,74,16,71,6,2,95
2020,45011,Montignoso,MS,53,20,50,4,0,74,15,69,9,0,93
2020,45011,Montignoso,MS,54,16,57,5,1,79,7,71,7,2,87
2020,45011,Montignoso,MS,55,23,71,12,1,107,12,65,10,2,89
2020,45011,Montignoso,MS,56,15,69,12,0,96,11,83,15,1,110
2020,45011,Montignoso,MS,57,10,73,10,1,94,16,73,8,5,102
2020,45011,Montignoso,MS,58,7,71,6,1,85,7,62,13,2,84
2020,45011,Montignoso,MS,59,15,53,8,1,77,6,72,5,5,88
2020,45011,Montignoso,MS,60,6,61,5,2,74,6,58,9,3,76
2020,45011,Montignoso,MS,61,4,66,10,4,84,12,54,5,4,75
2020,45011,Montignoso,MS,62,5,57,2,2,66,6,61,3,10,80
2020,45011,Montignoso,MS,63,8,66,4,3,81,4,68,4,12,88
2020,45011,Montignoso,MS,64,5,65,2,2,74,3,55,8,13,79
2020,45011,Montignoso,MS,65,9,50,2,5,66,5,47,7,8,67
2020,45011,Montignoso,MS,66,8,54,2,3,67,7,46,5,12,70
2020,45011,Montignoso,MS,67,6,43,3,3,55,2,41,3,17,63
2020,45011,Montignoso,MS,68,5,49,2,1,57,0,43,1,7,51
2020,45011,Montignoso,MS,69,4,53,3,3,63,1,45,5,11,62
2020,45011,Montignoso,MS,70,3,43,3,2,51,1,48,7,18,74
2020,45011,Montignoso,MS,71,6,48,1,1,56,1,60,7,8,76
2020,45011,Montignoso,MS,72,2,52,4,3,61,5,47,2,18,72
2020,45011,Montignoso,MS,73,3,60,2,2,67,4,37,1,23,65
2020,45011,Montignoso,MS,74,5,52,2,7,66,1,45,3,24,73
2020,45011,Montignoso,MS,75,1,32,2,2,37,1,25,1,15,42
2020,45011,Montignoso,MS,76,2,38,1,3,44,2,31,3,21,57
2020,45011,Montignoso,MS,77,3,38,2,5,48,3,34,1,17,55
2020,45011,Montignoso,MS,78,1,37,1,8,47,3,18,3,28,52
2020,45011,Montignoso,MS,79,3,35,0,4,42,3,30,1,16,50
2020,45011,Montignoso,MS,80,5,39,2,4,50,2,32,0,29,63
2020,45011,Montignoso,MS,81,2,43,2,6,53,0,14,0,27,41
2020,45011,Montignoso,MS,82,0,28,2,2,32,1,14,0,25,40
2020,45011,Montignoso,MS,83,2,17,0,6,25,3,13,2,29,47
2020,45011,Montignoso,MS,84,1,25,0,4,30,3,12,0,24,39
2020,45011,Montignoso,MS,85,2,12,0,5,19,3,7,3,35,48
2020,45011,Montignoso,MS,86,0,15,0,5,20,2,8,0,19,29
2020,45011,Montignoso,MS,87,1,13,0,3,17,1,4,0,30,35
2020,45011,Montignoso,MS,88,1,7,0,6,14,0,6,1,18,25
2020,45011,Montignoso,MS,89,0,5,0,1,6,1,2,0,20,23
2020,45011,Montignoso,MS,90,0,8,0,3,11,5,0,0,23,28
2020,45011,Montignoso,MS,91,0,2,0,4,6,1,1,1,13,16
2020,45011,Montignoso,MS,92,0,2,0,2,4,1,4,0,20,25
2020,45011,Montignoso,MS,93,0,2,0,3,5,0,0,0,7,7
2020,45011,Montignoso,MS,94,0,0,1,1,2,0,0,0,7,7
2020,45011,Montignoso,MS,95,0,1,0,0,1,1,0,0,7,8
2020,45011,Montignoso,MS,96,0,1,0,2,3,1,0,0,2,3
2020,45011,Montignoso,MS,97,0,0,0,1,1,0,0,0,5,5
2020,45011,Montignoso,MS,98,0,0,0,0,0,0,0,0,2,2
2020,45011,Montignoso,MS,99,0,0,0,0,0,0,0,0,0,0
2020,45011,Montignoso,MS,100 e più,1,0,0,0,1,2,0,0,3,5
2020,45012,Mulazzo,MS,0,8,0,0,0,8,6,0,0,0,6
2020,45012,Mulazzo,MS,1,5,0,0,0,5,8,0,0,0,8
2020,45012,Mulazzo,MS,2,3,0,0,0,3,5,0,0,0,5
2020,45012,Mulazzo,MS,3,7,0,0,0,7,5,0,0,0,5
2020,45012,Mulazzo,MS,4,4,0,0,0,4,4,0,0,0,4
2020,45012,Mulazzo,MS,5,7,0,0,0,7,3,0,0,0,3
2020,45012,Mulazzo,MS,6,5,0,0,0,5,7,0,0,0,7
2020,45012,Mulazzo,MS,7,10,0,0,0,10,0,0,0,0,0
2020,45012,Mulazzo,MS,8,9,0,0,0,9,11,0,0,0,11
2020,45012,Mulazzo,MS,9,8,0,0,0,8,7,0,0,0,7
2020,45012,Mulazzo,MS,10,10,0,0,0,10,10,0,0,0,10
2020,45012,Mulazzo,MS,11,5,0,0,0,5,10,0,0,0,10
2020,45012,Mulazzo,MS,12,8,0,0,0,8,5,0,0,0,5
2020,45012,Mulazzo,MS,13,7,0,0,0,7,6,0,0,0,6
2020,45012,Mulazzo,MS,14,11,0,0,0,11,8,0,0,0,8
2020,45012,Mulazzo,MS,15,15,0,0,0,15,5,0,0,0,5
2020,45012,Mulazzo,MS,16,5,0,0,0,5,8,0,0,0,8
2020,45012,Mulazzo,MS,17,3,0,0,0,3,7,0,0,0,7
2020,45012,Mulazzo,MS,18,7,0,0,0,7,7,0,0,0,7
2020,45012,Mulazzo,MS,19,10,0,0,0,10,8,0,0,0,8
2020,45012,Mulazzo,MS,20,14,0,0,0,14,9,0,0,0,9
2020,45012,Mulazzo,MS,21,13,0,0,0,13,4,0,0,0,4
2020,45012,Mulazzo,MS,22,7,0,0,0,7,9,0,0,0,9
2020,45012,Mulazzo,MS,23,10,0,0,0,10,6,0,0,0,6
2020,45012,Mulazzo,MS,24,7,0,0,0,7,6,0,0,0,6
2020,45012,Mulazzo,MS,25,11,0,0,0,11,7,1,0,0,8
2020,45012,Mulazzo,MS,26,11,0,0,0,11,12,2,0,0,14
2020,45012,Mulazzo,MS,27,11,0,0,0,11,4,0,0,0,4
2020,45012,Mulazzo,MS,28,10,0,0,0,10,5,2,0,0,7
2020,45012,Mulazzo,MS,29,7,2,0,0,9,6,2,1,0,9
2020,45012,Mulazzo,MS,30,11,1,0,0,12,7,0,0,0,7
2020,45012,Mulazzo,MS,31,7,0,0,0,7,7,4,1,0,12
2020,45012,Mulazzo,MS,32,7,1,0,0,8,5,2,0,0,7
2020,45012,Mulazzo,MS,33,4,1,0,0,5,5,5,0,0,10
2020,45012,Mulazzo,MS,34,7,6,0,0,13,4,4,0,0,8
2020,45012,Mulazzo,MS,35,7,4,0,0,11,7,4,1,0,12
2020,45012,Mulazzo,MS,36,9,4,0,0,13,4,8,0,0,12
2020,45012,Mulazzo,MS,37,4,1,1,0,6,4,6,0,0,10
2020,45012,Mulazzo,MS,38,7,3,0,0,10,2,7,0,0,9
2020,45012,Mulazzo,MS,39,7,8,1,0,16,3,6,1,0,10
2020,45012,Mulazzo,MS,40,6,10,0,0,16,5,7,0,0,12
2020,45012,Mulazzo,MS,41,5,4,0,0,9,2,1,1,0,4
2020,45012,Mulazzo,MS,42,8,4,1,0,13,1,11,0,1,13
2020,45012,Mulazzo,MS,43,4,5,0,0,9,4,11,2,0,17
2020,45012,Mulazzo,MS,44,3,8,1,0,12,5,12,0,0,17
2020,45012,Mulazzo,MS,45,8,12,1,0,21,8,6,1,0,15
2020,45012,Mulazzo,MS,46,6,12,2,0,20,3,17,1,2,23
2020,45012,Mulazzo,MS,47,9,13,1,0,23,5,12,1,3,21
2020,45012,Mulazzo,MS,48,13,9,0,0,22,5,9,2,1,17
2020,45012,Mulazzo,MS,49,3,12,0,1,16,7,12,0,0,19
2020,45012,Mulazzo,MS,50,7,14,3,0,24,2,10,1,0,13
2020,45012,Mulazzo,MS,51,5,6,2,0,13,3,7,2,0,12
2020,45012,Mulazzo,MS,52,4,10,1,0,15,3,9,1,0,13
2020,45012,Mulazzo,MS,53,4,6,0,1,11,5,12,2,0,19
2020,45012,Mulazzo,MS,54,5,10,4,0,19,6,9,1,3,19
2020,45012,Mulazzo,MS,55,8,11,2,0,21,4,17,3,1,25
2020,45012,Mulazzo,MS,56,2,13,0,0,15,4,18,2,1,25
2020,45012,Mulazzo,MS,57,2,12,2,1,17,2,13,2,1,18
2020,45012,Mulazzo,MS,58,7,14,3,0,24,1,17,2,0,20
2020,45012,Mulazzo,MS,59,4,14,6,1,25,4,13,1,1,19
2020,45012,Mulazzo,MS,60,3,16,1,1,21,3,18,2,1,24
2020,45012,Mulazzo,MS,61,2,9,0,0,11,2,15,1,1,19
2020,45012,Mulazzo,MS,62,1,8,4,2,15,2,13,0,3,18
2020,45012,Mulazzo,MS,63,2,11,1,0,14,1,6,4,1,12
2020,45012,Mulazzo,MS,64,6,16,2,0,24,1,17,0,4,22
2020,45012,Mulazzo,MS,65,1,19,1,1,22,3,18,0,4,25
2020,45012,Mulazzo,MS,66,2,13,1,0,16,1,12,1,3,17
2020,45012,Mulazzo,MS,67,0,9,0,1,10,2,9,1,5,17
2020,45012,Mulazzo,MS,68,1,14,1,1,17,1,10,1,4,16
2020,45012,Mulazzo,MS,69,1,13,0,1,15,2,10,1,1,14
2020,45012,Mulazzo,MS,70,4,11,1,0,16,2,12,0,4,18
2020,45012,Mulazzo,MS,71,5,13,2,2,22,1,6,1,5,13
2020,45012,Mulazzo,MS,72,5,12,3,3,23,0,15,2,6,23
2020,45012,Mulazzo,MS,73,1,20,0,2,23,1,15,3,1,20
2020,45012,Mulazzo,MS,74,2,11,2,0,15,2,17,0,4,23
2020,45012,Mulazzo,MS,75,3,12,2,1,18,1,9,0,3,13
2020,45012,Mulazzo,MS,76,3,8,0,1,12,1,9,1,2,13
2020,45012,Mulazzo,MS,77,1,13,0,3,17,1,6,0,7,14
2020,45012,Mulazzo,MS,78,2,12,0,1,15,0,9,0,7,16
2020,45012,Mulazzo,MS,79,1,15,0,0,16,0,8,0,12,20
2020,45012,Mulazzo,MS,80,5,5,3,0,13,0,8,0,7,15
2020,45012,Mulazzo,MS,81,1,12,1,1,15,2,6,0,11,19
2020,45012,Mulazzo,MS,82,3,13,0,1,17,1,3,0,9,13
2020,45012,Mulazzo,MS,83,2,5,0,2,9,0,6,1,11,18
2020,45012,Mulazzo,MS,84,0,5,0,1,6,2,1,1,9,13
2020,45012,Mulazzo,MS,85,1,2,0,0,3,1,2,0,7,10
2020,45012,Mulazzo,MS,86,0,5,0,0,5,1,1,0,8,10
2020,45012,Mulazzo,MS,87,0,5,0,1,6,0,1,0,8,9
2020,45012,Mulazzo,MS,88,1,3,0,2,6,0,0,1,7,8
2020,45012,Mulazzo,MS,89,0,3,0,1,4,1,3,0,6,10
2020,45012,Mulazzo,MS,90,0,2,0,1,3,1,2,0,5,8
2020,45012,Mulazzo,MS,91,0,1,0,1,2,0,1,0,2,3
2020,45012,Mulazzo,MS,92,0,0,0,0,0,0,0,0,6,6
2020,45012,Mulazzo,MS,93,0,1,0,0,1,0,0,0,3,3
2020,45012,Mulazzo,MS,94,0,2,0,1,3,0,0,0,4,4
2020,45012,Mulazzo,MS,95,0,0,0,2,2,0,0,0,3,3
2020,45012,Mulazzo,MS,96,0,0,0,0,0,0,0,0,2,2
2020,45012,Mulazzo,MS,97,0,0,0,0,0,0,0,0,2,2
2020,45012,Mulazzo,MS,98,0,0,0,0,0,0,0,0,2,2
2020,45012,Mulazzo,MS,99,0,0,0,0,0,0,0,0,1,1
2020,45012,Mulazzo,MS,100 e più,0,0,0,0,0,0,0,0,0,0
2020,45013,Podenzana,MS,0,4,0,0,0,4,3,0,0,0,3
2020,45013,Podenzana,MS,1,8,0,0,0,8,1,0,0,0,1
2020,45013,Podenzana,MS,2,7,0,0,0,7,4,0,0,0,4
2020,45013,Podenzana,MS,3,5,0,0,0,5,4,0,0,0,4
2020,45013,Podenzana,MS,4,12,0,0,0,12,9,0,0,0,9
2020,45013,Podenzana,MS,5,5,0,0,0,5,8,0,0,0,8
2020,45013,Podenzana,MS,6,11,0,0,0,11,5,0,0,0,5
2020,45013,Podenzana,MS,7,11,0,0,0,11,6,0,0,0,6
2020,45013,Podenzana,MS,8,10,0,0,0,10,12,0,0,0,12
2020,45013,Podenzana,MS,9,16,0,0,0,16,15,0,0,0,15
2020,45013,Podenzana,MS,10,9,0,0,0,9,9,0,0,0,9
2020,45013,Podenzana,MS,11,4,0,0,0,4,12,0,0,0,12
2020,45013,Podenzana,MS,12,3,0,0,0,3,10,0,0,0,10
2020,45013,Podenzana,MS,13,10,0,0,0,10,10,0,0,0,10
2020,45013,Podenzana,MS,14,7,0,0,0,7,7,0,0,0,7
2020,45013,Podenzana,MS,15,13,0,0,0,13,11,0,0,0,11
2020,45013,Podenzana,MS,16,13,0,0,0,13,13,0,0,0,13
2020,45013,Podenzana,MS,17,9,0,0,0,9,10,0,0,0,10
2020,45013,Podenzana,MS,18,13,0,0,0,13,9,0,0,0,9
2020,45013,Podenzana,MS,19,9,0,0,0,9,7,0,0,0,7
2020,45013,Podenzana,MS,20,7,0,0,0,7,17,0,0,0,17
2020,45013,Podenzana,MS,21,11,0,0,0,11,8,1,0,0,9
2020,45013,Podenzana,MS,22,10,0,0,0,10,3,1,0,0,4
2020,45013,Podenzana,MS,23,6,0,0,0,6,6,1,0,0,7
2020,45013,Podenzana,MS,24,10,0,0,0,10,8,0,0,0,8
2020,45013,Podenzana,MS,25,6,0,0,0,6,7,1,0,0,8
2020,45013,Podenzana,MS,26,9,0,0,0,9,12,1,0,0,13
2020,45013,Podenzana,MS,27,12,0,0,0,12,10,1,0,0,11
2020,45013,Podenzana,MS,28,8,2,0,0,10,8,3,0,0,11
2020,45013,Podenzana,MS,29,7,0,0,0,7,1,5,0,0,6
2020,45013,Podenzana,MS,30,8,0,0,0,8,3,1,1,0,5
2020,45013,Podenzana,MS,31,11,1,0,0,12,4,2,0,0,6
2020,45013,Podenzana,MS,32,5,0,0,0,5,4,6,0,0,10
2020,45013,Podenzana,MS,33,10,1,0,0,11,4,3,0,0,7
2020,45013,Podenzana,MS,34,12,6,1,0,19,5,5,0,0,10
2020,45013,Podenzana,MS,35,5,6,0,0,11,5,9,0,0,14
2020,45013,Podenzana,MS,36,3,7,0,0,10,4,8,0,0,12
2020,45013,Podenzana,MS,37,7,1,0,0,8,5,5,0,0,10
2020,45013,Podenzana,MS,38,5,9,0,0,14,4,6,0,0,10
2020,45013,Podenzana,MS,39,7,4,1,0,12,4,9,0,0,13
2020,45013,Podenzana,MS,40,8,10,0,0,18,5,10,1,0,16
2020,45013,Podenzana,MS,41,6,10,0,0,16,3,8,1,1,13
2020,45013,Podenzana,MS,42,6,13,0,0,19,3,6,0,0,9
2020,45013,Podenzana,MS,43,2,12,0,0,14,6,7,0,0,13
2020,45013,Podenzana,MS,44,6,9,1,0,16,4,15,0,0,19
2020,45013,Podenzana,MS,45,7,8,1,0,16,4,16,0,0,20
2020,45013,Podenzana,MS,46,3,7,0,1,11,2,15,0,0,17
2020,45013,Podenzana,MS,47,4,15,1,0,20,1,11,1,0,13
2020,45013,Podenzana,MS,48,4,10,2,0,16,4,13,2,0,19
2020,45013,Podenzana,MS,49,8,11,1,0,20,8,12,2,0,22
2020,45013,Podenzana,MS,50,5,10,0,0,15,0,12,1,1,14
2020,45013,Podenzana,MS,51,10,14,1,0,25,3,15,3,0,21
2020,45013,Podenzana,MS,52,7,9,2,0,18,3,12,1,1,17
2020,45013,Podenzana,MS,53,7,7,2,1,17,2,23,5,0,30
2020,45013,Podenzana,MS,54,2,16,1,1,20,2,14,1,3,20
2020,45013,Podenzana,MS,55,2,19,2,0,23,1,8,0,0,9
2020,45013,Podenzana,MS,56,3,11,1,0,15,2,13,3,3,21
2020,45013,Podenzana,MS,57,3,14,3,1,21,1,11,1,1,14
2020,45013,Podenzana,MS,58,4,9,1,0,14,1,16,2,0,19
2020,45013,Podenzana,MS,59,3,17,1,1,22,1,15,3,2,21
2020,45013,Podenzana,MS,60,0,11,1,0,12,2,15,2,1,20
2020,45013,Podenzana,MS,61,5,9,1,0,15,1,11,0,1,13
2020,45013,Podenzana,MS,62,2,9,1,0,12,0,12,0,1,13
2020,45013,Podenzana,MS,63,1,15,1,1,18,0,10,3,2,15
2020,45013,Podenzana,MS,64,0,13,0,1,14,2,9,0,0,11
2020,45013,Podenzana,MS,65,4,11,0,0,15,1,17,0,1,19
2020,45013,Podenzana,MS,66,2,15,0,0,17,0,11,0,3,14
2020,45013,Podenzana,MS,67,1,10,0,2,13,0,12,0,2,14
2020,45013,Podenzana,MS,68,1,14,0,0,15,1,8,1,0,10
2020,45013,Podenzana,MS,69,3,9,1,0,13,1,8,0,0,9
2020,45013,Podenzana,MS,70,0,14,1,0,15,0,8,1,3,12
2020,45013,Podenzana,MS,71,1,5,2,1,9,1,11,0,1,13
2020,45013,Podenzana,MS,72,2,13,1,1,17,0,7,1,3,11
2020,45013,Podenzana,MS,73,1,10,2,3,16,1,4,0,4,9
2020,45013,Podenzana,MS,74,0,13,1,0,14,1,12,0,5,18
2020,45013,Podenzana,MS,75,0,8,1,1,10,0,6,0,3,9
2020,45013,Podenzana,MS,76,1,7,0,1,9,0,9,0,3,12
2020,45013,Podenzana,MS,77,1,8,0,0,9,0,6,0,3,9
2020,45013,Podenzana,MS,78,0,7,1,1,9,0,1,0,3,4
2020,45013,Podenzana,MS,79,1,7,0,0,8,0,7,0,3,10
2020,45013,Podenzana,MS,80,1,6,0,0,7,1,8,1,3,13
2020,45013,Podenzana,MS,81,1,6,0,0,7,0,7,0,8,15
2020,45013,Podenzana,MS,82,1,3,0,1,5,0,2,0,5,7
2020,45013,Podenzana,MS,83,1,4,1,1,7,0,5,0,8,13
2020,45013,Podenzana,MS,84,1,7,0,1,9,0,5,0,5,10
2020,45013,Podenzana,MS,85,0,8,0,0,8,1,0,0,4,5
2020,45013,Podenzana,MS,86,0,3,0,0,3,0,0,0,5,5
2020,45013,Podenzana,MS,87,1,2,0,0,3,0,1,0,4,5
2020,45013,Podenzana,MS,88,0,2,0,0,2,1,0,0,4,5
2020,45013,Podenzana,MS,89,1,5,0,0,6,0,0,1,5,6
2020,45013,Podenzana,MS,90,0,1,0,1,2,0,1,1,3,5
2020,45013,Podenzana,MS,91,0,0,0,0,0,0,0,0,2,2
2020,45013,Podenzana,MS,92,0,1,0,0,1,0,0,0,7,7
2020,45013,Podenzana,MS,93,0,0,0,0,0,0,0,0,1,1
2020,45013,Podenzana,MS,94,0,0,0,0,0,0,0,0,0,0
2020,45013,Podenzana,MS,95,0,0,0,0,0,0,1,0,1,2
2020,45013,Podenzana,MS,96,0,0,0,0,0,0,0,0,0,0
2020,45013,Podenzana,MS,97,0,0,0,1,1,0,0,0,1,1
2020,45013,Podenzana,MS,98,0,0,0,0,0,0,0,0,1,1
2020,45013,Podenzana,MS,99,0,0,0,0,0,0,0,0,0,0
2020,45013,Podenzana,MS,100 e più,0,0,0,0,0,0,0,0,1,1
2020,45014,Pontremoli,MS,0,15,0,0,0,15,22,0,0,0,22
2020,45014,Pontremoli,MS,1,21,0,0,0,21,20,0,0,0,20
2020,45014,Pontremoli,MS,2,22,0,0,0,22,14,0,0,0,14
2020,45014,Pontremoli,MS,3,18,0,0,0,18,19,0,0,0,19
2020,45014,Pontremoli,MS,4,22,0,0,0,22,17,0,0,0,17
2020,45014,Pontremoli,MS,5,19,0,0,0,19,19,0,0,0,19
2020,45014,Pontremoli,MS,6,26,0,0,0,26,14,0,0,0,14
2020,45014,Pontremoli,MS,7,22,0,0,0,22,21,0,0,0,21
2020,45014,Pontremoli,MS,8,21,0,0,0,21,28,0,0,0,28
2020,45014,Pontremoli,MS,9,22,0,0,0,22,30,0,0,0,30
2020,45014,Pontremoli,MS,10,17,0,0,0,17,26,0,0,0,26
2020,45014,Pontremoli,MS,11,23,0,0,0,23,23,0,0,0,23
2020,45014,Pontremoli,MS,12,31,0,0,0,31,31,0,0,0,31
2020,45014,Pontremoli,MS,13,24,0,0,0,24,30,0,0,0,30
2020,45014,Pontremoli,MS,14,35,0,0,0,35,22,0,0,0,22
2020,45014,Pontremoli,MS,15,27,0,0,0,27,25,0,0,0,25
2020,45014,Pontremoli,MS,16,22,0,0,0,22,32,0,0,0,32
2020,45014,Pontremoli,MS,17,29,0,0,0,29,24,0,0,0,24
2020,45014,Pontremoli,MS,18,27,0,0,0,27,30,0,0,0,30
2020,45014,Pontremoli,MS,19,21,0,0,0,21,34,0,0,0,34
2020,45014,Pontremoli,MS,20,30,0,0,0,30,25,0,0,0,25
2020,45014,Pontremoli,MS,21,26,0,0,0,26,18,0,0,0,18
2020,45014,Pontremoli,MS,22,42,0,0,0,42,29,0,0,0,29
2020,45014,Pontremoli,MS,23,20,0,0,0,20,22,3,0,0,25
2020,45014,Pontremoli,MS,24,41,0,0,0,41,28,2,0,0,30
2020,45014,Pontremoli,MS,25,36,0,0,0,36,32,0,0,0,32
2020,45014,Pontremoli,MS,26,22,0,0,0,22,27,4,0,0,31
2020,45014,Pontremoli,MS,27,43,1,0,0,44,27,5,0,0,32
2020,45014,Pontremoli,MS,28,32,3,0,0,35,25,7,0,0,32
2020,45014,Pontremoli,MS,29,35,3,0,0,38,27,8,0,0,35
2020,45014,Pontremoli,MS,30,24,4,0,0,28,26,4,0,0,30
2020,45014,Pontremoli,MS,31,28,3,0,0,31,20,4,0,0,24
2020,45014,Pontremoli,MS,32,21,4,0,0,25,21,16,0,0,37
2020,45014,Pontremoli,MS,33,22,4,0,0,26,13,17,0,0,30
2020,45014,Pontremoli,MS,34,17,9,0,0,26,14,11,0,0,25
2020,45014,Pontremoli,MS,35,16,8,0,0,24,16,23,0,0,39
2020,45014,Pontremoli,MS,36,18,16,0,0,34,10,14,1,0,25
2020,45014,Pontremoli,MS,37,33,13,0,0,46,18,11,0,0,29
2020,45014,Pontremoli,MS,38,16,10,0,0,26,6,20,2,0,28
2020,45014,Pontremoli,MS,39,14,20,1,0,35,15,20,2,0,37
2020,45014,Pontremoli,MS,40,10,18,2,0,30,18,18,1,1,38
2020,45014,Pontremoli,MS,41,11,14,0,0,25,10,14,1,0,25
2020,45014,Pontremoli,MS,42,16,19,2,0,37,13,15,4,1,33
2020,45014,Pontremoli,MS,43,18,16,3,0,37,11,19,1,0,31
2020,45014,Pontremoli,MS,44,31,15,1,0,47,16,23,4,0,43
2020,45014,Pontremoli,MS,45,13,32,1,0,46,7,16,6,0,29
2020,45014,Pontremoli,MS,46,22,27,0,0,49,17,28,4,1,50
2020,45014,Pontremoli,MS,47,19,26,1,0,46,8,39,1,0,48
2020,45014,Pontremoli,MS,48,18,20,3,1,42,7,43,3,0,53
2020,45014,Pontremoli,MS,49,22,23,8,0,53,16,41,4,1,62
2020,45014,Pontremoli,MS,50,22,33,7,0,62,8,31,7,3,49
2020,45014,Pontremoli,MS,51,13,37,6,1,57,13,38,6,0,57
2020,45014,Pontremoli,MS,52,23,36,5,0,64,13,31,4,2,50
2020,45014,Pontremoli,MS,53,18,33,2,0,53,16,30,3,1,50
2020,45014,Pontremoli,MS,54,16,33,2,2,53,11,48,5,3,67
2020,45014,Pontremoli,MS,55,13,44,1,2,60,7,49,3,3,62
2020,45014,Pontremoli,MS,56,22,44,8,0,74,11,44,9,2,66
2020,45014,Pontremoli,MS,57,12,37,3,1,53,4,46,5,2,57
2020,45014,Pontremoli,MS,58,5,34,4,0,43,10,34,8,4,56
2020,45014,Pontremoli,MS,59,14,39,2,1,56,9,46,4,5,64
2020,45014,Pontremoli,MS,60,9,46,4,1,60,6,32,1,7,46
2020,45014,Pontremoli,MS,61,9,39,2,1,51,8,41,2,3,54
2020,45014,Pontremoli,MS,62,9,27,6,1,43,7,28,5,8,48
2020,45014,Pontremoli,MS,63,8,33,2,1,44,4,36,5,8,53
2020,45014,Pontremoli,MS,64,7,34,2,0,43,6,33,5,14,58
2020,45014,Pontremoli,MS,65,7,31,3,0,41,5,33,0,5,43
2020,45014,Pontremoli,MS,66,6,37,3,0,46,0,33,1,12,46
2020,45014,Pontremoli,MS,67,9,42,1,1,53,8,34,1,9,52
2020,45014,Pontremoli,MS,68,4,36,3,1,44,6,25,2,9,42
2020,45014,Pontremoli,MS,69,4,28,2,5,39,0,44,3,7,54
2020,45014,Pontremoli,MS,70,2,40,3,2,47,2,24,0,14,40
2020,45014,Pontremoli,MS,71,8,44,3,4,59,5,29,0,10,44
2020,45014,Pontremoli,MS,72,9,39,2,3,53,6,44,2,13,65
2020,45014,Pontremoli,MS,73,8,34,4,2,48,6,30,1,13,50
2020,45014,Pontremoli,MS,74,5,41,2,1,49,4,25,0,14,43
2020,45014,Pontremoli,MS,75,0,26,0,2,28,6,16,0,14,36
2020,45014,Pontremoli,MS,76,5,28,1,3,37,3,23,2,20,48
2020,45014,Pontremoli,MS,77,5,22,1,6,34,3,20,0,13,36
2020,45014,Pontremoli,MS,78,6,29,1,3,39,1,23,1,15,40
2020,45014,Pontremoli,MS,79,1,30,0,6,37,5,20,1,24,50
2020,45014,Pontremoli,MS,80,4,35,0,5,44,7,25,1,38,71
2020,45014,Pontremoli,MS,81,5,24,0,8,37,0,23,0,34,57
2020,45014,Pontremoli,MS,82,1,26,0,7,34,6,17,0,26,49
2020,45014,Pontremoli,MS,83,4,21,0,11,36,0,8,0,34,42
2020,45014,Pontremoli,MS,84,1,19,0,2,22,6,18,1,28,53
2020,45014,Pontremoli,MS,85,2,9,0,6,17,2,17,0,28,47
2020,45014,Pontremoli,MS,86,2,8,1,6,17,0,10,0,30,40
2020,45014,Pontremoli,MS,87,2,17,0,3,22,4,3,1,30,38
2020,45014,Pontremoli,MS,88,0,13,0,6,19,2,4,0,33,39
2020,45014,Pontremoli,MS,89,0,9,0,2,11,1,6,1,30,38
2020,45014,Pontremoli,MS,90,1,10,0,3,14,1,3,2,21,27
2020,45014,Pontremoli,MS,91,2,4,0,5,11,2,1,0,23,26
2020,45014,Pontremoli,MS,92,0,6,0,2,8,1,2,1,31,35
2020,45014,Pontremoli,MS,93,0,6,0,3,9,1,0,0,13,14
2020,45014,Pontremoli,MS,94,1,2,0,1,4,3,0,0,20,23
2020,45014,Pontremoli,MS,95,0,6,0,0,6,1,0,0,5,6
2020,45014,Pontremoli,MS,96,0,0,0,0,0,0,0,0,14,14
2020,45014,Pontremoli,MS,97,0,1,0,0,1,1,1,0,7,9
2020,45014,Pontremoli,MS,98,0,0,0,0,0,0,1,0,5,6
2020,45014,Pontremoli,MS,99,0,0,0,0,0,1,1,0,3,5
2020,45014,Pontremoli,MS,100 e più,0,1,0,1,2,0,0,0,4,4
2020,45015,Tresana,MS,0,4,0,0,0,4,4,0,0,0,4
2020,45015,Tresana,MS,1,5,0,0,0,5,4,0,0,0,4
2020,45015,Tresana,MS,2,9,0,0,0,9,4,0,0,0,4
2020,45015,Tresana,MS,3,5,0,0,0,5,7,0,0,0,7
2020,45015,Tresana,MS,4,6,0,0,0,6,8,0,0,0,8
2020,45015,Tresana,MS,5,9,0,0,0,9,5,0,0,0,5
2020,45015,Tresana,MS,6,10,0,0,0,10,10,0,0,0,10
2020,45015,Tresana,MS,7,6,0,0,0,6,4,0,0,0,4
2020,45015,Tresana,MS,8,4,0,0,0,4,4,0,0,0,4
2020,45015,Tresana,MS,9,5,0,0,0,5,10,0,0,0,10
2020,45015,Tresana,MS,10,10,0,0,0,10,7,0,0,0,7
2020,45015,Tresana,MS,11,7,0,0,0,7,4,0,0,0,4
2020,45015,Tresana,MS,12,4,0,0,0,4,7,0,0,0,7
2020,45015,Tresana,MS,13,8,0,0,0,8,11,0,0,0,11
2020,45015,Tresana,MS,14,5,0,0,0,5,10,0,0,0,10
2020,45015,Tresana,MS,15,6,0,0,0,6,8,0,0,0,8
2020,45015,Tresana,MS,16,12,0,0,0,12,3,0,0,0,3
2020,45015,Tresana,MS,17,5,0,0,0,5,5,0,0,0,5
2020,45015,Tresana,MS,18,3,0,0,0,3,7,0,0,0,7
2020,45015,Tresana,MS,19,6,0,0,0,6,14,0,0,0,14
2020,45015,Tresana,MS,20,12,0,0,0,12,7,0,0,0,7
2020,45015,Tresana,MS,21,5,0,0,0,5,9,0,0,0,9
2020,45015,Tresana,MS,22,8,0,0,0,8,7,0,0,0,7
2020,45015,Tresana,MS,23,9,0,0,0,9,7,0,0,0,7
2020,45015,Tresana,MS,24,12,0,0,0,12,4,1,0,0,5
2020,45015,Tresana,MS,25,3,0,0,0,3,3,0,0,0,3
2020,45015,Tresana,MS,26,10,0,0,0,10,2,2,0,0,4
2020,45015,Tresana,MS,27,5,0,0,0,5,7,2,0,0,9
2020,45015,Tresana,MS,28,13,0,0,0,13,2,4,0,0,6
2020,45015,Tresana,MS,29,6,3,0,0,9,6,1,0,0,7
2020,45015,Tresana,MS,30,8,0,0,0,8,5,0,0,0,5
2020,45015,Tresana,MS,31,4,1,0,0,5,8,4,0,0,12
2020,45015,Tresana,MS,32,3,3,0,0,6,4,3,0,0,7
2020,45015,Tresana,MS,33,4,3,0,0,7,4,3,0,0,7
2020,45015,Tresana,MS,34,7,1,0,0,8,5,7,1,0,13
2020,45015,Tresana,MS,35,11,0,0,0,11,3,5,1,0,9
2020,45015,Tresana,MS,36,5,1,0,0,6,8,7,0,0,15
2020,45015,Tresana,MS,37,9,2,0,0,11,5,5,0,0,10
2020,45015,Tresana,MS,38,7,5,0,0,12,4,5,1,0,10
2020,45015,Tresana,MS,39,5,6,0,0,11,2,3,2,0,7
2020,45015,Tresana,MS,40,9,3,1,0,13,6,4,1,0,11
2020,45015,Tresana,MS,41,8,7,1,0,16,4,7,0,0,11
2020,45015,Tresana,MS,42,3,7,0,0,10,5,11,2,0,18
2020,45015,Tresana,MS,43,6,7,2,0,15,4,6,1,0,11
2020,45015,Tresana,MS,44,6,4,1,0,11,2,7,2,0,11
2020,45015,Tresana,MS,45,5,9,1,0,15,1,8,0,0,9
2020,45015,Tresana,MS,46,5,14,1,0,20,3,15,1,0,19
2020,45015,Tresana,MS,47,9,6,0,0,15,3,6,1,0,10
2020,45015,Tresana,MS,48,6,7,2,0,15,2,6,0,0,8
2020,45015,Tresana,MS,49,6,12,2,0,20,3,4,3,1,11
2020,45015,Tresana,MS,50,6,9,1,1,17,2,7,1,1,11
2020,45015,Tresana,MS,51,6,3,1,0,10,7,8,2,0,17
2020,45015,Tresana,MS,52,3,13,3,0,19,4,13,0,0,17
2020,45015,Tresana,MS,53,4,11,1,0,16,6,10,0,0,16
2020,45015,Tresana,MS,54,2,9,2,0,13,2,15,2,0,19
2020,45015,Tresana,MS,55,5,18,0,0,23,1,11,0,2,14
2020,45015,Tresana,MS,56,0,16,1,0,17,2,10,0,0,12
2020,45015,Tresana,MS,57,6,12,0,0,18,1,12,3,0,16
2020,45015,Tresana,MS,58,5,8,1,1,15,1,13,1,0,15
2020,45015,Tresana,MS,59,4,10,0,0,14,0,12,1,2,15
2020,45015,Tresana,MS,60,0,14,0,0,14,0,18,0,0,18
2020,45015,Tresana,MS,61,1,9,1,0,11,1,10,0,6,17
2020,45015,Tresana,MS,62,0,8,1,0,9,0,14,0,1,15
2020,45015,Tresana,MS,63,1,8,3,0,12,0,11,3,5,19
2020,45015,Tresana,MS,64,3,8,1,0,12,1,8,2,0,11
2020,45015,Tresana,MS,65,1,7,2,0,10,2,10,0,2,14
2020,45015,Tresana,MS,66,1,15,0,1,17,0,5,0,2,7
2020,45015,Tresana,MS,67,0,12,0,0,12,0,7,1,1,9
2020,45015,Tresana,MS,68,0,10,1,0,11,2,10,0,4,16
2020,45015,Tresana,MS,69,2,6,1,1,10,0,6,0,2,8
2020,45015,Tresana,MS,70,2,14,0,0,16,0,14,1,1,16
2020,45015,Tresana,MS,71,1,12,0,1,14,0,9,0,4,13
2020,45015,Tresana,MS,72,1,6,0,0,7,1,18,1,1,21
2020,45015,Tresana,MS,73,3,19,1,0,23,1,11,0,4,16
2020,45015,Tresana,MS,74,3,22,0,0,25,1,8,0,6,15
2020,45015,Tresana,MS,75,3,7,0,1,11,2,7,0,2,11
2020,45015,Tresana,MS,76,1,11,0,1,13,0,7,0,3,10
2020,45015,Tresana,MS,77,1,8,3,0,12,0,3,0,7,10
2020,45015,Tresana,MS,78,1,11,0,0,12,0,5,0,3,8
2020,45015,Tresana,MS,79,0,7,0,2,9,0,9,1,5,15
2020,45015,Tresana,MS,80,1,3,0,1,5,0,8,0,8,16
2020,45015,Tresana,MS,81,1,11,1,4,17,0,5,0,4,9
2020,45015,Tresana,MS,82,1,7,0,0,8,1,4,0,6,11
2020,45015,Tresana,MS,83,2,5,0,2,9,0,3,1,7,11
2020,45015,Tresana,MS,84,0,5,1,3,9,1,5,0,10,16
2020,45015,Tresana,MS,85,0,0,0,2,2,0,2,0,9,11
2020,45015,Tresana,MS,86,1,2,1,2,6,0,1,0,6,7
2020,45015,Tresana,MS,87,0,0,0,2,2,0,3,0,7,10
2020,45015,Tresana,MS,88,0,4,0,0,4,0,2,0,5,7
2020,45015,Tresana,MS,89,0,2,0,1,3,0,0,0,8,8
2020,45015,Tresana,MS,90,0,2,0,1,3,0,2,0,6,8
2020,45015,Tresana,MS,91,0,4,0,0,4,1,0,0,3,4
2020,45015,Tresana,MS,92,0,2,0,2,4,0,0,0,3,3
2020,45015,Tresana,MS,93,0,0,0,1,1,1,1,1,2,5
2020,45015,Tresana,MS,94,0,3,0,0,3,0,0,0,4,4
2020,45015,Tresana,MS,95,0,0,0,0,0,0,0,0,3,3
2020,45015,Tresana,MS,96,0,0,0,0,0,0,0,0,0,0
2020,45015,Tresana,MS,97,0,0,0,0,0,0,0,0,1,1
2020,45015,Tresana,MS,98,0,0,0,0,0,0,0,0,1,1
2020,45015,Tresana,MS,99,0,0,0,0,0,0,0,0,1,1
2020,45015,Tresana,MS,100 e più,0,0,0,0,0,0,0,0,2,2
2020,45016,Villafranca in Lunigiana,MS,0,6,0,0,0,6,7,0,0,0,7
2020,45016,Villafranca in Lunigiana,MS,1,16,0,0,0,16,10,0,0,0,10
2020,45016,Villafranca in Lunigiana,MS,2,13,0,0,0,13,15,0,0,0,15
2020,45016,Villafranca in Lunigiana,MS,3,15,0,0,0,15,14,0,0,0,14
2020,45016,Villafranca in Lunigiana,MS,4,19,0,0,0,19,13,0,0,0,13
2020,45016,Villafranca in Lunigiana,MS,5,12,0,0,0,12,8,0,0,0,8
2020,45016,Villafranca in Lunigiana,MS,6,24,0,0,0,24,17,0,0,0,17
2020,45016,Villafranca in Lunigiana,MS,7,22,0,0,0,22,17,0,0,0,17
2020,45016,Villafranca in Lunigiana,MS,8,15,0,0,0,15,18,0,0,0,18
2020,45016,Villafranca in Lunigiana,MS,9,18,0,0,0,18,17,0,0,0,17
2020,45016,Villafranca in Lunigiana,MS,10,18,0,0,0,18,19,0,0,0,19
2020,45016,Villafranca in Lunigiana,MS,11,25,0,0,0,25,17,0,0,0,17
2020,45016,Villafranca in Lunigiana,MS,12,24,0,0,0,24,15,0,0,0,15
2020,45016,Villafranca in Lunigiana,MS,13,15,0,0,0,15,12,0,0,0,12
2020,45016,Villafranca in Lunigiana,MS,14,26,0,0,0,26,12,0,0,0,12
2020,45016,Villafranca in Lunigiana,MS,15,15,0,0,0,15,17,0,0,0,17
2020,45016,Villafranca in Lunigiana,MS,16,17,0,0,0,17,17,0,0,0,17
2020,45016,Villafranca in Lunigiana,MS,17,30,0,0,0,30,17,0,0,0,17
2020,45016,Villafranca in Lunigiana,MS,18,19,0,0,0,19,13,0,0,0,13
2020,45016,Villafranca in Lunigiana,MS,19,14,0,0,0,14,17,0,0,0,17
2020,45016,Villafranca in Lunigiana,MS,20,19,0,0,0,19,15,0,0,0,15
2020,45016,Villafranca in Lunigiana,MS,21,20,0,0,0,20,21,1,0,0,22
2020,45016,Villafranca in Lunigiana,MS,22,18,0,0,0,18,10,3,0,0,13
2020,45016,Villafranca in Lunigiana,MS,23,20,0,0,0,20,16,0,0,0,16
2020,45016,Villafranca in Lunigiana,MS,24,23,0,0,0,23,23,0,0,0,23
2020,45016,Villafranca in Lunigiana,MS,25,29,1,0,0,30,20,1,0,0,21
2020,45016,Villafranca in Lunigiana,MS,26,21,1,0,0,22,17,2,0,0,19
2020,45016,Villafranca in Lunigiana,MS,27,23,1,0,0,24,20,3,0,0,23
2020,45016,Villafranca in Lunigiana,MS,28,24,0,0,0,24,18,4,1,0,23
2020,45016,Villafranca in Lunigiana,MS,29,22,2,0,0,24,16,4,0,0,20
2020,45016,Villafranca in Lunigiana,MS,30,21,0,0,0,21,15,4,1,0,20
2020,45016,Villafranca in Lunigiana,MS,31,26,3,0,0,29,9,6,0,0,15
2020,45016,Villafranca in Lunigiana,MS,32,19,3,0,0,22,10,7,0,0,17
2020,45016,Villafranca in Lunigiana,MS,33,15,7,1,0,23,12,10,1,0,23
2020,45016,Villafranca in Lunigiana,MS,34,11,8,0,0,19,6,10,1,0,17
2020,45016,Villafranca in Lunigiana,MS,35,21,7,0,0,28,10,22,1,0,33
2020,45016,Villafranca in Lunigiana,MS,36,19,14,0,0,33,6,8,0,0,14
2020,45016,Villafranca in Lunigiana,MS,37,17,14,1,0,32,14,20,1,0,35
2020,45016,Villafranca in Lunigiana,MS,38,12,9,2,0,23,11,8,1,1,21
2020,45016,Villafranca in Lunigiana,MS,39,11,12,0,0,23,11,12,1,0,24
2020,45016,Villafranca in Lunigiana,MS,40,10,11,0,0,21,11,15,1,0,27
2020,45016,Villafranca in Lunigiana,MS,41,11,12,1,0,24,15,16,3,1,35
2020,45016,Villafranca in Lunigiana,MS,42,18,19,2,0,39,17,13,0,1,31
2020,45016,Villafranca in Lunigiana,MS,43,13,17,0,0,30,10,20,3,0,33
2020,45016,Villafranca in Lunigiana,MS,44,12,15,1,0,28,8,27,2,0,37
2020,45016,Villafranca in Lunigiana,MS,45,14,21,1,0,36,9,22,1,1,33
2020,45016,Villafranca in Lunigiana,MS,46,12,19,0,0,31,8,28,3,0,39
2020,45016,Villafranca in Lunigiana,MS,47,11,14,5,0,30,8,25,2,0,35
2020,45016,Villafranca in Lunigiana,MS,48,10,23,0,0,33,6,25,1,2,34
2020,45016,Villafranca in Lunigiana,MS,49,16,18,2,1,37,8,26,3,0,37
2020,45016,Villafranca in Lunigiana,MS,50,9,30,2,0,41,4,29,0,0,33
2020,45016,Villafranca in Lunigiana,MS,51,7,29,5,1,42,6,18,5,0,29
2020,45016,Villafranca in Lunigiana,MS,52,6,21,1,1,29,10,35,4,0,49
2020,45016,Villafranca in Lunigiana,MS,53,4,19,1,0,24,5,27,0,1,33
2020,45016,Villafranca in Lunigiana,MS,54,9,21,4,1,35,6,23,1,0,30
2020,45016,Villafranca in Lunigiana,MS,55,10,29,0,0,39,4,22,6,1,33
2020,45016,Villafranca in Lunigiana,MS,56,9,31,1,0,41,3,31,6,1,41
2020,45016,Villafranca in Lunigiana,MS,57,12,22,3,0,37,8,28,3,1,40
2020,45016,Villafranca in Lunigiana,MS,58,5,31,5,2,43,3,34,2,3,42
2020,45016,Villafranca in Lunigiana,MS,59,4,23,1,0,28,3,32,6,5,46
2020,45016,Villafranca in Lunigiana,MS,60,4,33,2,1,40,1,19,2,2,24
2020,45016,Villafranca in Lunigiana,MS,61,6,31,1,0,38,2,36,1,2,41
2020,45016,Villafranca in Lunigiana,MS,62,2,20,2,0,24,1,29,4,1,35
2020,45016,Villafranca in Lunigiana,MS,63,2,29,2,1,34,2,23,3,2,30
2020,45016,Villafranca in Lunigiana,MS,64,8,23,0,2,33,1,20,3,4,28
2020,45016,Villafranca in Lunigiana,MS,65,2,23,1,3,29,1,27,3,3,34
2020,45016,Villafranca in Lunigiana,MS,66,2,29,1,0,32,3,27,1,5,36
2020,45016,Villafranca in Lunigiana,MS,67,5,22,0,0,27,4,31,2,6,43
2020,45016,Villafranca in Lunigiana,MS,68,3,25,0,0,28,2,21,1,8,32
2020,45016,Villafranca in Lunigiana,MS,69,4,23,0,0,27,3,26,1,2,32
2020,45016,Villafranca in Lunigiana,MS,70,6,21,0,1,28,1,18,0,1,20
2020,45016,Villafranca in Lunigiana,MS,71,3,24,1,0,28,1,18,0,8,27
2020,45016,Villafranca in Lunigiana,MS,72,4,28,1,5,38,3,22,1,6,32
2020,45016,Villafranca in Lunigiana,MS,73,2,29,0,4,35,0,21,2,7,30
2020,45016,Villafranca in Lunigiana,MS,74,3,23,1,3,30,0,17,1,13,31
2020,45016,Villafranca in Lunigiana,MS,75,1,12,0,0,13,2,17,0,5,24
2020,45016,Villafranca in Lunigiana,MS,76,0,17,2,3,22,1,11,0,8,20
2020,45016,Villafranca in Lunigiana,MS,77,1,17,2,3,23,0,14,0,14,28
2020,45016,Villafranca in Lunigiana,MS,78,3,22,0,3,28,0,21,0,9,30
2020,45016,Villafranca in Lunigiana,MS,79,2,18,0,1,21,1,22,1,12,36
2020,45016,Villafranca in Lunigiana,MS,80,2,33,0,2,37,0,11,0,10,21
2020,45016,Villafranca in Lunigiana,MS,81,1,16,0,3,20,0,10,1,13,24
2020,45016,Villafranca in Lunigiana,MS,82,1,15,0,6,22,2,9,0,19,30
2020,45016,Villafranca in Lunigiana,MS,83,3,14,2,8,27,1,9,0,15,25
2020,45016,Villafranca in Lunigiana,MS,84,1,10,1,8,20,1,4,1,13,19
2020,45016,Villafranca in Lunigiana,MS,85,0,12,0,2,14,1,4,0,19,24
2020,45016,Villafranca in Lunigiana,MS,86,0,9,1,2,12,0,2,1,11,14
2020,45016,Villafranca in Lunigiana,MS,87,1,4,0,2,7,2,3,0,12,17
2020,45016,Villafranca in Lunigiana,MS,88,1,3,0,2,6,1,4,0,10,15
2020,45016,Villafranca in Lunigiana,MS,89,1,3,0,2,6,1,4,0,12,17
2020,45016,Villafranca in Lunigiana,MS,90,1,3,0,4,8,1,0,0,9,10
2020,45016,Villafranca in Lunigiana,MS,91,0,5,0,0,5,0,0,0,15,15
2020,45016,Villafranca in Lunigiana,MS,92,1,1,0,3,5,0,1,0,8,9
2020,45016,Villafranca in Lunigiana,MS,93,0,0,0,0,0,0,0,0,8,8
2020,45016,Villafranca in Lunigiana,MS,94,0,1,0,1,2,0,1,1,5,7
2020,45016,Villafranca in Lunigiana,MS,95,0,1,0,1,2,0,0,0,6,6
2020,45016,Villafranca in Lunigiana,MS,96,0,2,0,3,5,0,0,0,2,2
2020,45016,Villafranca in Lunigiana,MS,97,0,0,0,1,1,1,0,0,3,4
2020,45016,Villafranca in Lunigiana,MS,98,0,0,0,0,0,0,0,0,1,1
2020,45016,Villafranca in Lunigiana,MS,99,0,0,0,0,0,0,0,0,1,1
2020,45016,Villafranca in Lunigiana,MS,100 e più,0,0,0,0,0,0,0,0,2,2
2020,45017,Zeri,MS,0,0,0,0,0,0,2,0,0,0,2
2020,45017,Zeri,MS,1,2,0,0,0,2,0,0,0,0,0
2020,45017,Zeri,MS,2,1,0,0,0,1,1,0,0,0,1
2020,45017,Zeri,MS,3,1,0,0,0,1,5,0,0,0,5
2020,45017,Zeri,MS,4,0,0,0,0,0,2,0,0,0,2
2020,45017,Zeri,MS,5,1,0,0,0,1,2,0,0,0,2
2020,45017,Zeri,MS,6,2,0,0,0,2,1,0,0,0,1
2020,45017,Zeri,MS,7,1,0,0,0,1,3,0,0,0,3
2020,45017,Zeri,MS,8,5,0,0,0,5,1,0,0,0,1
2020,45017,Zeri,MS,9,2,0,0,0,2,3,0,0,0,3
2020,45017,Zeri,MS,10,2,0,0,0,2,3,0,0,0,3
2020,45017,Zeri,MS,11,2,0,0,0,2,1,0,0,0,1
2020,45017,Zeri,MS,12,5,0,0,0,5,7,0,0,0,7
2020,45017,Zeri,MS,13,2,0,0,0,2,1,0,0,0,1
2020,45017,Zeri,MS,14,3,0,0,0,3,1,0,0,0,1
2020,45017,Zeri,MS,15,1,0,0,0,1,7,0,0,0,7
2020,45017,Zeri,MS,16,3,0,0,0,3,1,0,0,0,1
2020,45017,Zeri,MS,17,6,0,0,0,6,2,0,0,0,2
2020,45017,Zeri,MS,18,1,0,0,0,1,2,0,0,0,2
2020,45017,Zeri,MS,19,2,0,0,0,2,2,0,0,0,2
2020,45017,Zeri,MS,20,3,0,0,0,3,3,0,0,0,3
2020,45017,Zeri,MS,21,5,0,0,0,5,5,0,0,0,5
2020,45017,Zeri,MS,22,1,0,0,0,1,2,0,0,0,2
2020,45017,Zeri,MS,23,0,0,0,0,0,1,0,0,0,1
2020,45017,Zeri,MS,24,1,0,0,0,1,1,0,0,0,1
2020,45017,Zeri,MS,25,2,0,0,0,2,2,0,0,0,2
2020,45017,Zeri,MS,26,2,0,0,0,2,2,0,0,0,2
2020,45017,Zeri,MS,27,2,0,0,0,2,4,1,0,0,5
2020,45017,Zeri,MS,28,2,0,0,0,2,1,0,0,0,1
2020,45017,Zeri,MS,29,5,0,0,0,5,6,0,0,0,6
2020,45017,Zeri,MS,30,2,0,0,0,2,2,2,0,0,4
2020,45017,Zeri,MS,31,2,1,0,0,3,1,0,0,0,1
2020,45017,Zeri,MS,32,2,0,0,0,2,5,1,0,0,6
2020,45017,Zeri,MS,33,1,0,0,0,1,0,1,0,0,1
2020,45017,Zeri,MS,34,2,2,0,0,4,1,0,0,0,1
2020,45017,Zeri,MS,35,2,1,0,0,3,2,1,0,0,3
2020,45017,Zeri,MS,36,2,0,0,0,2,2,2,0,0,4
2020,45017,Zeri,MS,37,4,4,0,0,8,2,1,0,0,3
2020,45017,Zeri,MS,38,3,1,0,0,4,3,5,0,0,8
2020,45017,Zeri,MS,39,1,0,0,0,1,3,2,0,0,5
2020,45017,Zeri,MS,40,1,2,0,0,3,2,5,0,0,7
2020,45017,Zeri,MS,41,3,4,0,0,7,2,3,0,0,5
2020,45017,Zeri,MS,42,4,3,0,0,7,1,1,0,0,2
2020,45017,Zeri,MS,43,6,3,0,0,9,4,4,0,0,8
2020,45017,Zeri,MS,44,1,1,0,0,2,2,5,0,0,7
2020,45017,Zeri,MS,45,4,3,0,0,7,2,0,0,0,2
2020,45017,Zeri,MS,46,2,3,0,0,5,1,6,1,0,8
2020,45017,Zeri,MS,47,3,4,0,0,7,2,2,0,0,4
2020,45017,Zeri,MS,48,0,8,2,0,10,1,8,0,0,9
2020,45017,Zeri,MS,49,2,4,0,0,6,4,2,0,0,6
2020,45017,Zeri,MS,50,2,3,0,0,5,5,2,0,0,7
2020,45017,Zeri,MS,51,2,3,1,0,6,2,4,0,0,6
2020,45017,Zeri,MS,52,2,0,0,0,2,0,2,3,0,5
2020,45017,Zeri,MS,53,3,1,1,0,5,0,5,1,0,6
2020,45017,Zeri,MS,54,4,2,1,0,7,0,3,0,1,4
2020,45017,Zeri,MS,55,3,3,1,0,7,1,3,0,0,4
2020,45017,Zeri,MS,56,2,4,2,0,8,3,7,0,0,10
2020,45017,Zeri,MS,57,1,6,0,0,7,0,5,1,0,6
2020,45017,Zeri,MS,58,6,9,1,0,16,2,7,0,0,9
2020,45017,Zeri,MS,59,3,7,1,0,11,0,3,0,1,4
2020,45017,Zeri,MS,60,2,1,0,0,3,1,3,1,0,5
2020,45017,Zeri,MS,61,3,4,1,0,8,0,6,0,0,6
2020,45017,Zeri,MS,62,1,5,1,0,7,3,6,0,2,11
2020,45017,Zeri,MS,63,1,1,1,0,3,0,7,0,1,8
2020,45017,Zeri,MS,64,2,6,0,0,8,0,5,1,0,6
2020,45017,Zeri,MS,65,1,8,0,0,9,1,9,1,1,12
2020,45017,Zeri,MS,66,1,4,1,1,7,1,4,0,0,5
2020,45017,Zeri,MS,67,0,4,0,0,4,0,5,0,2,7
2020,45017,Zeri,MS,68,0,6,0,0,6,1,8,0,0,9
2020,45017,Zeri,MS,69,3,6,0,1,10,0,4,0,1,5
2020,45017,Zeri,MS,70,2,8,0,0,10,0,5,0,3,8
2020,45017,Zeri,MS,71,0,5,0,0,5,1,11,1,1,14
2020,45017,Zeri,MS,72,0,6,1,0,7,0,4,0,2,6
2020,45017,Zeri,MS,73,3,8,0,0,11,1,10,0,3,14
2020,45017,Zeri,MS,74,3,10,0,1,14,0,2,1,3,6
2020,45017,Zeri,MS,75,0,8,1,0,9,0,3,0,4,7
2020,45017,Zeri,MS,76,3,5,2,0,10,0,3,0,3,6
2020,45017,Zeri,MS,77,1,6,0,1,8,0,3,0,4,7
2020,45017,Zeri,MS,78,0,7,0,1,8,1,11,0,2,14
2020,45017,Zeri,MS,79,1,1,0,0,2,1,8,0,3,12
2020,45017,Zeri,MS,80,0,6,0,1,7,0,9,0,2,11
2020,45017,Zeri,MS,81,3,8,0,1,12,0,11,0,6,17
2020,45017,Zeri,MS,82,1,7,0,1,9,0,5,0,1,6
2020,45017,Zeri,MS,83,1,7,0,1,9,0,4,0,7,11
2020,45017,Zeri,MS,84,0,8,0,4,12,0,3,1,2,6
2020,45017,Zeri,MS,85,2,4,1,1,8,0,5,0,2,7
2020,45017,Zeri,MS,86,0,5,0,1,6,0,2,0,5,7
2020,45017,Zeri,MS,87,0,4,0,0,4,0,3,0,3,6
2020,45017,Zeri,MS,88,0,2,0,1,3,1,3,0,8,12
2020,45017,Zeri,MS,89,0,9,0,1,10,0,0,1,4,5
2020,45017,Zeri,MS,90,0,2,0,0,2,0,0,0,6,6
2020,45017,Zeri,MS,91,0,3,0,2,5,0,0,0,5,5
2020,45017,Zeri,MS,92,1,1,0,1,3,0,1,0,6,7
2020,45017,Zeri,MS,93,0,0,0,2,2,0,0,0,2,2
2020,45017,Zeri,MS,94,0,1,0,0,1,0,0,0,3,3
2020,45017,Zeri,MS,95,0,0,0,0,0,0,0,0,2,2
2020,45017,Zeri,MS,96,1,0,0,0,1,0,0,0,0,0
2020,45017,Zeri,MS,97,0,0,0,0,0,0,0,0,0,0
2020,45017,Zeri,MS,98,0,0,0,0,0,0,0,0,2,2
2020,45017,Zeri,MS,99,0,0,0,0,0,0,0,0,1,1
2020,45017,Zeri,MS,100 e più,0,0,0,1,1,0,0,0,2,2
2020,50001,Bientina,PI,0,36,0,0,0,36,40,0,0,0,40
2020,50001,Bientina,PI,1,41,0,0,0,41,46,0,0,0,46
2020,50001,Bientina,PI,2,41,0,0,0,41,35,0,0,0,35
2020,50001,Bientina,PI,3,36,0,0,0,36,42,0,0,0,42
2020,50001,Bientina,PI,4,39,0,0,0,39,35,0,0,0,35
2020,50001,Bientina,PI,5,52,0,0,0,52,45,0,0,0,45
2020,50001,Bientina,PI,6,44,0,0,0,44,58,0,0,0,58
2020,50001,Bientina,PI,7,44,0,0,0,44,34,0,0,0,34
2020,50001,Bientina,PI,8,45,0,0,0,45,52,0,0,0,52
2020,50001,Bientina,PI,9,50,0,0,0,50,46,0,0,0,46
2020,50001,Bientina,PI,10,46,0,0,0,46,38,0,0,0,38
2020,50001,Bientina,PI,11,51,0,0,0,51,47,0,0,0,47
2020,50001,Bientina,PI,12,38,0,0,0,38,36,0,0,0,36
2020,50001,Bientina,PI,13,35,0,0,0,35,45,0,0,0,45
2020,50001,Bientina,PI,14,49,0,0,0,49,57,0,0,0,57
2020,50001,Bientina,PI,15,44,0,0,0,44,47,0,0,0,47
2020,50001,Bientina,PI,16,53,0,0,0,53,42,0,0,0,42
2020,50001,Bientina,PI,17,31,0,0,0,31,33,0,0,0,33
2020,50001,Bientina,PI,18,41,0,0,0,41,38,0,0,0,38
2020,50001,Bientina,PI,19,46,0,0,0,46,30,0,0,0,30
2020,50001,Bientina,PI,20,33,0,0,0,33,37,0,0,0,37
2020,50001,Bientina,PI,21,39,0,0,0,39,34,0,0,0,34
2020,50001,Bientina,PI,22,49,0,0,0,49,32,0,0,0,32
2020,50001,Bientina,PI,23,29,0,0,0,29,51,0,0,0,51
2020,50001,Bientina,PI,24,21,0,0,0,21,39,1,0,0,40
2020,50001,Bientina,PI,25,33,0,0,0,33,37,1,0,0,38
2020,50001,Bientina,PI,26,32,1,0,0,33,26,6,0,0,32
2020,50001,Bientina,PI,27,43,4,1,0,48,41,5,0,0,46
2020,50001,Bientina,PI,28,30,4,0,0,34,40,13,1,0,54
2020,50001,Bientina,PI,29,42,3,0,0,45,34,13,0,0,47
2020,50001,Bientina,PI,30,38,7,0,0,45,40,11,0,0,51
2020,50001,Bientina,PI,31,42,9,0,0,51,36,21,1,0,58
2020,50001,Bientina,PI,32,33,14,0,0,47,28,40,0,0,68
2020,50001,Bientina,PI,33,40,16,0,0,56,16,16,0,0,32
2020,50001,Bientina,PI,34,21,17,1,0,39,26,37,2,0,65
2020,50001,Bientina,PI,35,41,20,0,0,61,24,30,1,0,55
2020,50001,Bientina,PI,36,26,34,0,0,60,23,43,2,0,68
2020,50001,Bientina,PI,37,26,26,0,0,52,20,39,0,0,59
2020,50001,Bientina,PI,38,31,40,2,0,73,21,38,3,1,63
2020,50001,Bientina,PI,39,19,40,0,0,59,21,42,2,1,66
2020,50001,Bientina,PI,40,29,25,1,0,55,17,43,3,0,63
2020,50001,Bientina,PI,41,20,54,5,0,79,28,37,4,0,69
2020,50001,Bientina,PI,42,38,38,2,0,78,17,49,2,0,68
2020,50001,Bientina,PI,43,26,38,2,0,66,16,41,4,0,61
2020,50001,Bientina,PI,44,29,47,2,0,78,19,55,3,0,77
2020,50001,Bientina,PI,45,15,58,2,1,76,14,56,5,0,75
2020,50001,Bientina,PI,46,25,63,2,1,91,15,68,2,1,86
2020,50001,Bientina,PI,47,24,55,5,1,85,14,60,3,0,77
2020,50001,Bientina,PI,48,26,60,3,0,89,13,50,5,2,70
2020,50001,Bientina,PI,49,17,39,4,0,60,9,54,8,1,72
2020,50001,Bientina,PI,50,9,61,2,1,73,20,41,8,0,69
2020,50001,Bientina,PI,51,12,48,2,0,62,10,70,6,3,89
2020,50001,Bientina,PI,52,14,51,10,0,75,6,43,10,1,60
2020,50001,Bientina,PI,53,10,43,6,0,59,9,47,4,1,61
2020,50001,Bientina,PI,54,8,55,4,0,67,5,59,10,2,76
2020,50001,Bientina,PI,55,6,49,5,0,60,8,59,3,2,72
2020,50001,Bientina,PI,56,10,44,5,0,59,7,57,6,2,72
2020,50001,Bientina,PI,57,4,47,5,1,57,3,39,5,2,49
2020,50001,Bientina,PI,58,5,37,3,2,47,4,37,2,2,45
2020,50001,Bientina,PI,59,5,45,4,0,54,3,38,7,1,49
2020,50001,Bientina,PI,60,2,29,4,2,37,6,44,5,3,58
2020,50001,Bientina,PI,61,4,39,2,3,48,1,39,5,1,46
2020,50001,Bientina,PI,62,3,36,2,0,41,1,42,4,6,53
2020,50001,Bientina,PI,63,2,41,1,2,46,1,36,3,5,45
2020,50001,Bientina,PI,64,1,35,1,3,40,0,33,6,4,43
2020,50001,Bientina,PI,65,4,41,3,2,50,2,40,3,6,51
2020,50001,Bientina,PI,66,3,45,3,0,51,3,35,1,8,47
2020,50001,Bientina,PI,67,2,31,1,1,35,1,30,2,9,42
2020,50001,Bientina,PI,68,3,41,1,0,45,2,32,6,8,48
2020,50001,Bientina,PI,69,0,46,1,1,48,0,35,4,7,46
2020,50001,Bientina,PI,70,2,28,3,2,35,0,31,2,12,45
2020,50001,Bientina,PI,71,3,24,2,2,31,2,37,2,16,57
2020,50001,Bientina,PI,72,7,44,3,2,56,1,49,0,13,63
2020,50001,Bientina,PI,73,0,35,2,3,40,1,41,1,12,55
2020,50001,Bientina,PI,74,2,40,2,5,49,1,32,1,12,46
2020,50001,Bientina,PI,75,3,26,1,2,32,0,21,0,15,36
2020,50001,Bientina,PI,76,2,28,0,3,33,0,18,0,14,32
2020,50001,Bientina,PI,77,0,31,1,3,35,1,10,2,15,28
2020,50001,Bientina,PI,78,2,27,1,0,30,1,14,0,13,28
2020,50001,Bientina,PI,79,0,17,1,0,18,1,14,2,15,32
2020,50001,Bientina,PI,80,0,18,0,8,26,1,13,2,15,31
2020,50001,Bientina,PI,81,2,17,0,2,21,2,13,1,23,39
2020,50001,Bientina,PI,82,2,18,0,1,21,3,8,0,19,30
2020,50001,Bientina,PI,83,2,11,0,6,19,0,12,0,16,28
2020,50001,Bientina,PI,84,0,14,0,4,18,0,9,0,15,24
2020,50001,Bientina,PI,85,1,12,1,4,18,1,8,0,14,23
2020,50001,Bientina,PI,86,1,17,0,3,21,1,3,0,13,17
2020,50001,Bientina,PI,87,1,7,0,4,12,0,5,0,16,21
2020,50001,Bientina,PI,88,1,8,0,1,10,0,3,0,5,8
2020,50001,Bientina,PI,89,0,7,0,1,8,0,2,0,12,14
2020,50001,Bientina,PI,90,0,3,0,2,5,1,2,0,15,18
2020,50001,Bientina,PI,91,0,2,0,2,4,0,0,0,15,15
2020,50001,Bientina,PI,92,0,2,0,0,2,0,1,0,13,14
2020,50001,Bientina,PI,93,0,1,0,2,3,0,0,0,10,10
2020,50001,Bientina,PI,94,0,0,0,1,1,0,0,0,4,4
2020,50001,Bientina,PI,95,0,0,0,2,2,0,0,0,1,1
2020,50001,Bientina,PI,96,0,0,0,1,1,0,0,0,2,2
2020,50001,Bientina,PI,97,0,0,0,0,0,0,0,0,0,0
2020,50001,Bientina,PI,98,0,1,0,0,1,0,0,0,1,1
2020,50001,Bientina,PI,99,0,0,0,1,1,0,0,0,4,4
2020,50001,Bientina,PI,100 e più,0,0,0,0,0,0,0,0,4,4
2020,50002,Buti,PI,0,16,0,0,0,16,16,0,0,0,16
2020,50002,Buti,PI,1,16,0,0,0,16,14,0,0,0,14
2020,50002,Buti,PI,2,17,0,0,0,17,19,0,0,0,19
2020,50002,Buti,PI,3,27,0,0,0,27,12,0,0,0,12
2020,50002,Buti,PI,4,19,0,0,0,19,16,0,0,0,16
2020,50002,Buti,PI,5,26,0,0,0,26,29,0,0,0,29
2020,50002,Buti,PI,6,20,0,0,0,20,18,0,0,0,18
2020,50002,Buti,PI,7,29,0,0,0,29,16,0,0,0,16
2020,50002,Buti,PI,8,27,0,0,0,27,17,0,0,0,17
2020,50002,Buti,PI,9,26,0,0,0,26,30,0,0,0,30
2020,50002,Buti,PI,10,26,0,0,0,26,18,0,0,0,18
2020,50002,Buti,PI,11,29,0,0,0,29,24,0,0,0,24
2020,50002,Buti,PI,12,17,0,0,0,17,25,0,0,0,25
2020,50002,Buti,PI,13,33,0,0,0,33,29,0,0,0,29
2020,50002,Buti,PI,14,28,0,0,0,28,32,0,0,0,32
2020,50002,Buti,PI,15,22,0,0,0,22,22,0,0,0,22
2020,50002,Buti,PI,16,24,0,0,0,24,21,0,0,0,21
2020,50002,Buti,PI,17,21,0,0,0,21,19,0,0,0,19
2020,50002,Buti,PI,18,29,0,0,0,29,21,0,0,0,21
2020,50002,Buti,PI,19,15,0,0,0,15,23,1,0,0,24
2020,50002,Buti,PI,20,23,1,0,0,24,30,0,0,0,30
2020,50002,Buti,PI,21,24,0,0,0,24,25,0,0,0,25
2020,50002,Buti,PI,22,20,0,0,0,20,24,0,0,0,24
2020,50002,Buti,PI,23,28,0,0,0,28,18,1,0,0,19
2020,50002,Buti,PI,24,19,0,0,0,19,22,2,0,0,24
2020,50002,Buti,PI,25,26,0,0,0,26,22,2,0,0,24
2020,50002,Buti,PI,26,19,0,0,0,19,26,1,0,0,27
2020,50002,Buti,PI,27,29,2,0,0,31,18,5,0,0,23
2020,50002,Buti,PI,28,26,1,0,0,27,27,2,0,0,29
2020,50002,Buti,PI,29,30,5,0,0,35,25,4,0,0,29
2020,50002,Buti,PI,30,27,2,0,0,29,20,7,0,0,27
2020,50002,Buti,PI,31,19,4,0,0,23,19,6,0,0,25
2020,50002,Buti,PI,32,23,2,0,0,25,15,10,0,0,25
2020,50002,Buti,PI,33,18,9,0,0,27,14,16,1,0,31
2020,50002,Buti,PI,34,25,9,0,0,34,10,11,0,0,21
2020,50002,Buti,PI,35,11,6,0,0,17,10,11,1,0,22
2020,50002,Buti,PI,36,9,7,3,0,19,10,9,1,0,20
2020,50002,Buti,PI,37,14,14,0,0,28,15,20,0,1,36
2020,50002,Buti,PI,38,17,17,2,1,37,14,19,1,0,34
2020,50002,Buti,PI,39,17,12,0,0,29,8,17,1,0,26
2020,50002,Buti,PI,40,13,16,1,0,30,20,21,2,0,43
2020,50002,Buti,PI,41,17,16,1,0,34,10,27,2,1,40
2020,50002,Buti,PI,42,12,24,1,0,37,7,22,4,0,33
2020,50002,Buti,PI,43,21,23,1,0,45,12,21,4,0,37
2020,50002,Buti,PI,44,21,32,2,0,55,13,31,2,0,46
2020,50002,Buti,PI,45,23,19,3,1,46,9,32,1,1,43
2020,50002,Buti,PI,46,17,23,4,0,44,5,39,2,0,46
2020,50002,Buti,PI,47,23,31,3,0,57,15,36,7,0,58
2020,50002,Buti,PI,48,12,36,3,0,51,10,22,4,0,36
2020,50002,Buti,PI,49,11,33,5,1,50,14,33,4,0,51
2020,50002,Buti,PI,50,13,31,7,0,51,7,20,7,1,35
2020,50002,Buti,PI,51,11,34,4,0,49,1,31,7,2,41
2020,50002,Buti,PI,52,11,42,4,0,57,6,32,4,1,43
2020,50002,Buti,PI,53,8,33,6,0,47,3,35,4,2,44
2020,50002,Buti,PI,54,9,34,4,0,47,1,42,3,0,46
2020,50002,Buti,PI,55,4,28,3,0,35,5,25,3,1,34
2020,50002,Buti,PI,56,4,31,2,1,38,2,41,5,0,48
2020,50002,Buti,PI,57,7,27,4,1,39,8,39,7,1,55
2020,50002,Buti,PI,58,7,29,4,0,40,1,42,2,2,47
2020,50002,Buti,PI,59,6,32,2,3,43,3,35,1,4,43
2020,50002,Buti,PI,60,0,36,2,1,39,1,45,4,3,53
2020,50002,Buti,PI,61,5,36,2,1,44,3,32,2,1,38
2020,50002,Buti,PI,62,4,35,4,0,43,1,39,0,5,45
2020,50002,Buti,PI,63,4,34,1,0,39,2,25,2,3,32
2020,50002,Buti,PI,64,5,40,3,0,48,5,31,2,4,42
2020,50002,Buti,PI,65,2,30,1,1,34,1,30,2,3,36
2020,50002,Buti,PI,66,2,29,1,1,33,0,33,0,9,42
2020,50002,Buti,PI,67,1,37,2,0,40,0,30,0,6,36
2020,50002,Buti,PI,68,1,26,0,2,29,0,30,0,11,41
2020,50002,Buti,PI,69,0,27,1,3,31,1,37,1,4,43
2020,50002,Buti,PI,70,2,21,1,1,25,0,25,0,5,30
2020,50002,Buti,PI,71,3,33,0,3,39,2,28,0,6,36
2020,50002,Buti,PI,72,2,24,1,3,30,0,30,1,6,37
2020,50002,Buti,PI,73,2,31,0,2,35,0,24,3,13,40
2020,50002,Buti,PI,74,2,34,0,1,37,1,26,1,17,45
2020,50002,Buti,PI,75,0,26,1,3,30,1,18,1,10,30
2020,50002,Buti,PI,76,1,18,0,1,20,0,21,0,12,33
2020,50002,Buti,PI,77,1,22,1,0,24,1,16,0,10,27
2020,50002,Buti,PI,78,1,29,0,3,33,0,16,0,13,29
2020,50002,Buti,PI,79,0,11,0,1,12,1,12,0,13,26
2020,50002,Buti,PI,80,4,23,1,2,30,0,11,1,10,22
2020,50002,Buti,PI,81,2,20,0,0,22,1,9,0,12,22
2020,50002,Buti,PI,82,2,17,1,3,23,0,11,0,15,26
2020,50002,Buti,PI,83,0,10,0,2,12,1,9,0,16,26
2020,50002,Buti,PI,84,0,14,0,1,15,2,5,0,25,32
2020,50002,Buti,PI,85,0,10,0,4,14,2,3,0,11,16
2020,50002,Buti,PI,86,1,5,0,3,9,1,2,0,15,18
2020,50002,Buti,PI,87,0,3,0,3,6,0,3,0,11,14
2020,50002,Buti,PI,88,0,7,0,0,7,0,2,0,16,18
2020,50002,Buti,PI,89,0,4,0,4,8,1,1,0,10,12
2020,50002,Buti,PI,90,0,6,1,1,8,0,3,0,6,9
2020,50002,Buti,PI,91,0,4,0,3,7,0,1,0,14,15
2020,50002,Buti,PI,92,0,1,0,3,4,0,0,0,9,9
2020,50002,Buti,PI,93,0,1,0,1,2,0,1,0,5,6
2020,50002,Buti,PI,94,0,0,0,0,0,1,2,0,12,15
2020,50002,Buti,PI,95,0,1,0,0,1,0,0,0,1,1
2020,50002,Buti,PI,96,0,0,0,1,1,0,0,0,0,0
2020,50002,Buti,PI,97,0,1,0,0,1,0,0,0,3,3
2020,50002,Buti,PI,98,0,0,0,0,0,0,0,0,2,2
2020,50002,Buti,PI,99,0,0,0,0,0,0,0,0,0,0
2020,50002,Buti,PI,100 e più,0,0,0,0,0,0,0,0,1,1
2020,50003,Calci,PI,0,23,0,0,0,23,20,0,0,0,20
2020,50003,Calci,PI,1,18,0,0,0,18,14,0,0,0,14
2020,50003,Calci,PI,2,25,0,0,0,25,23,0,0,0,23
2020,50003,Calci,PI,3,23,0,0,0,23,25,0,0,0,25
2020,50003,Calci,PI,4,25,0,0,0,25,23,0,0,0,23
2020,50003,Calci,PI,5,18,0,0,0,18,22,0,0,0,22
2020,50003,Calci,PI,6,21,0,0,0,21,21,0,0,0,21
2020,50003,Calci,PI,7,31,0,0,0,31,25,0,0,0,25
2020,50003,Calci,PI,8,33,0,0,0,33,37,0,0,0,37
2020,50003,Calci,PI,9,26,0,0,0,26,30,0,0,0,30
2020,50003,Calci,PI,10,27,0,0,0,27,32,0,0,0,32
2020,50003,Calci,PI,11,28,0,0,0,28,33,0,0,0,33
2020,50003,Calci,PI,12,41,0,0,0,41,31,0,0,0,31
2020,50003,Calci,PI,13,39,0,0,0,39,33,0,0,0,33
2020,50003,Calci,PI,14,36,0,0,0,36,32,0,0,0,32
2020,50003,Calci,PI,15,34,0,0,0,34,23,0,0,0,23
2020,50003,Calci,PI,16,32,0,0,0,32,29,0,0,0,29
2020,50003,Calci,PI,17,27,0,0,0,27,21,0,0,0,21
2020,50003,Calci,PI,18,37,0,0,0,37,25,0,0,0,25
2020,50003,Calci,PI,19,23,0,0,0,23,19,0,0,0,19
2020,50003,Calci,PI,20,27,0,0,0,27,20,1,0,0,21
2020,50003,Calci,PI,21,28,0,0,0,28,21,0,0,0,21
2020,50003,Calci,PI,22,17,0,0,0,17,22,0,0,0,22
2020,50003,Calci,PI,23,25,0,0,0,25,24,1,0,0,25
2020,50003,Calci,PI,24,31,0,0,0,31,34,0,0,0,34
2020,50003,Calci,PI,25,28,1,0,0,29,26,0,0,0,26
2020,50003,Calci,PI,26,23,0,0,0,23,16,4,0,0,20
2020,50003,Calci,PI,27,22,1,0,0,23,21,1,0,0,22
2020,50003,Calci,PI,28,23,2,0,0,25,22,7,0,0,29
2020,50003,Calci,PI,29,28,3,0,0,31,30,2,0,0,32
2020,50003,Calci,PI,30,22,2,1,0,25,30,10,0,0,40
2020,50003,Calci,PI,31,25,5,0,0,30,20,4,1,0,25
2020,50003,Calci,PI,32,21,5,0,0,26,17,13,0,0,30
2020,50003,Calci,PI,33,19,2,2,0,23,19,8,0,0,27
2020,50003,Calci,PI,34,21,7,0,0,28,22,5,0,0,27
2020,50003,Calci,PI,35,21,9,2,0,32,21,9,0,0,30
2020,50003,Calci,PI,36,16,9,2,0,27,21,11,0,0,32
2020,50003,Calci,PI,37,17,11,0,0,28,16,23,0,0,39
2020,50003,Calci,PI,38,27,19,0,0,46,18,12,0,0,30
2020,50003,Calci,PI,39,18,14,0,0,32,15,21,2,0,38
2020,50003,Calci,PI,40,15,16,1,0,32,15,14,0,0,29
2020,50003,Calci,PI,41,19,24,0,0,43,17,27,1,1,46
2020,50003,Calci,PI,42,24,12,0,0,36,15,28,2,0,45
2020,50003,Calci,PI,43,31,21,2,0,54,20,35,0,0,55
2020,50003,Calci,PI,44,20,32,1,0,53,17,31,5,0,53
2020,50003,Calci,PI,45,16,24,2,0,42,21,30,4,0,55
2020,50003,Calci,PI,46,26,43,1,0,70,17,39,2,0,58
2020,50003,Calci,PI,47,19,28,3,0,50,8,37,6,0,51
2020,50003,Calci,PI,48,20,30,2,0,52,17,40,7,1,65
2020,50003,Calci,PI,49,18,33,2,0,53,17,34,7,0,58
2020,50003,Calci,PI,50,15,37,4,0,56,15,34,6,1,56
2020,50003,Calci,PI,51,12,35,3,0,50,9,41,5,1,56
2020,50003,Calci,PI,52,13,40,4,1,58,12,36,5,3,56
2020,50003,Calci,PI,53,10,33,6,0,49,8,33,5,2,48
2020,50003,Calci,PI,54,7,35,8,0,50,6,41,6,2,55
2020,50003,Calci,PI,55,13,38,7,0,58,7,45,4,2,58
2020,50003,Calci,PI,56,11,26,7,0,44,6,44,5,3,58
2020,50003,Calci,PI,57,6,34,5,0,45,10,41,8,2,61
2020,50003,Calci,PI,58,12,34,3,0,49,5,30,8,2,45
2020,50003,Calci,PI,59,9,32,3,0,44,7,30,5,2,44
2020,50003,Calci,PI,60,8,38,5,2,53,8,37,3,3,51
2020,50003,Calci,PI,61,6,30,3,2,41,3,39,3,3,48
2020,50003,Calci,PI,62,7,36,5,0,48,3,42,11,3,59
2020,50003,Calci,PI,63,2,35,4,2,43,3,32,4,3,42
2020,50003,Calci,PI,64,0,35,2,0,37,6,40,0,4,50
2020,50003,Calci,PI,65,5,39,2,0,46,1,35,3,7,46
2020,50003,Calci,PI,66,5,27,3,0,35,2,32,6,8,48
2020,50003,Calci,PI,67,3,29,1,2,35,0,23,1,9,33
2020,50003,Calci,PI,68,5,31,2,0,38,3,28,3,8,42
2020,50003,Calci,PI,69,2,45,0,2,49,1,24,4,6,35
2020,50003,Calci,PI,70,2,37,2,2,43,1,31,3,8,43
2020,50003,Calci,PI,71,3,39,3,6,51,0,33,2,14,49
2020,50003,Calci,PI,72,3,36,1,0,40,2,35,1,6,44
2020,50003,Calci,PI,73,2,35,1,3,41,6,24,4,9,43
2020,50003,Calci,PI,74,3,31,2,4,40,3,34,1,20,58
2020,50003,Calci,PI,75,0,23,2,4,29,2,17,0,15,34
2020,50003,Calci,PI,76,2,26,0,3,31,3,24,1,8,36
2020,50003,Calci,PI,77,0,25,1,0,26,1,25,2,14,42
2020,50003,Calci,PI,78,0,19,1,1,21,1,19,3,6,29
2020,50003,Calci,PI,79,4,17,0,4,25,1,15,0,17,33
2020,50003,Calci,PI,80,1,21,1,3,26,1,12,0,23,36
2020,50003,Calci,PI,81,1,18,0,2,21,1,12,0,12,25
2020,50003,Calci,PI,82,3,21,0,4,28,1,6,1,16,24
2020,50003,Calci,PI,83,0,16,0,0,16,1,8,0,26,35
2020,50003,Calci,PI,84,0,9,1,4,14,1,8,0,15,24
2020,50003,Calci,PI,85,1,7,0,6,14,0,4,0,14,18
2020,50003,Calci,PI,86,1,8,0,2,11,1,6,1,16,24
2020,50003,Calci,PI,87,0,9,0,3,12,1,3,0,17,21
2020,50003,Calci,PI,88,0,4,0,4,8,0,0,0,7,7
2020,50003,Calci,PI,89,1,5,0,5,11,0,1,0,17,18
2020,50003,Calci,PI,90,0,5,0,4,9,0,1,1,10,12
2020,50003,Calci,PI,91,0,0,0,1,1,1,2,0,16,19
2020,50003,Calci,PI,92,2,1,0,0,3,0,1,0,9,10
2020,50003,Calci,PI,93,0,2,0,0,2,1,0,0,2,3
2020,50003,Calci,PI,94,0,1,0,2,3,0,0,0,2,2
2020,50003,Calci,PI,95,0,1,0,0,1,0,0,0,5,5
2020,50003,Calci,PI,96,0,1,0,1,2,0,0,0,4,4
2020,50003,Calci,PI,97,0,0,0,0,0,0,1,0,4,5
2020,50003,Calci,PI,98,0,0,0,1,1,0,0,0,3,3
2020,50003,Calci,PI,99,0,0,0,0,0,0,0,0,3,3
2020,50003,Calci,PI,100 e più,0,0,0,0,0,0,0,0,3,3
2020,50004,Calcinaia,PI,0,55,0,0,0,55,41,0,0,0,41
2020,50004,Calcinaia,PI,1,57,0,0,0,57,58,0,0,0,58
2020,50004,Calcinaia,PI,2,53,0,0,0,53,52,0,0,0,52
2020,50004,Calcinaia,PI,3,62,0,0,0,62,42,0,0,0,42
2020,50004,Calcinaia,PI,4,66,0,0,0,66,58,0,0,0,58
2020,50004,Calcinaia,PI,5,96,0,0,0,96,55,0,0,0,55
2020,50004,Calcinaia,PI,6,69,0,0,0,69,48,0,0,0,48
2020,50004,Calcinaia,PI,7,67,0,0,0,67,53,0,0,0,53
2020,50004,Calcinaia,PI,8,62,0,0,0,62,80,0,0,0,80
2020,50004,Calcinaia,PI,9,69,0,0,0,69,65,0,0,0,65
2020,50004,Calcinaia,PI,10,70,0,0,0,70,65,0,0,0,65
2020,50004,Calcinaia,PI,11,59,0,0,0,59,79,0,0,0,79
2020,50004,Calcinaia,PI,12,73,0,0,0,73,69,0,0,0,69
2020,50004,Calcinaia,PI,13,69,0,0,0,69,57,0,0,0,57
2020,50004,Calcinaia,PI,14,66,0,0,0,66,68,0,0,0,68
2020,50004,Calcinaia,PI,15,66,0,0,0,66,66,0,0,0,66
2020,50004,Calcinaia,PI,16,61,0,0,0,61,51,0,0,0,51
2020,50004,Calcinaia,PI,17,72,0,0,0,72,62,0,0,0,62
2020,50004,Calcinaia,PI,18,52,0,0,0,52,47,0,0,0,47
2020,50004,Calcinaia,PI,19,61,0,0,0,61,45,0,0,0,45
2020,50004,Calcinaia,PI,20,62,0,0,0,62,58,1,0,0,59
2020,50004,Calcinaia,PI,21,51,0,0,0,51,59,1,0,0,60
2020,50004,Calcinaia,PI,22,47,1,0,0,48,59,2,0,0,61
2020,50004,Calcinaia,PI,23,56,0,0,0,56,46,3,0,0,49
2020,50004,Calcinaia,PI,24,44,1,0,0,45,41,3,0,0,44
2020,50004,Calcinaia,PI,25,57,4,0,0,61,48,4,0,0,52
2020,50004,Calcinaia,PI,26,50,3,0,0,53,49,3,1,0,53
2020,50004,Calcinaia,PI,27,48,4,0,0,52,56,10,0,0,66
2020,50004,Calcinaia,PI,28,49,8,0,0,57,51,13,0,0,64
2020,50004,Calcinaia,PI,29,57,4,0,0,61,39,15,0,0,54
2020,50004,Calcinaia,PI,30,44,15,0,0,59,42,29,0,0,71
2020,50004,Calcinaia,PI,31,48,8,0,0,56,33,26,2,0,61
2020,50004,Calcinaia,PI,32,51,24,1,0,76,28,41,0,0,69
2020,50004,Calcinaia,PI,33,44,26,0,0,70,39,36,3,0,78
2020,50004,Calcinaia,PI,34,46,33,1,0,80,42,38,0,0,80
2020,50004,Calcinaia,PI,35,36,35,0,0,71,38,49,1,0,88
2020,50004,Calcinaia,PI,36,39,40,0,0,79,39,50,1,0,90
2020,50004,Calcinaia,PI,37,50,49,1,0,100,40,67,0,1,108
2020,50004,Calcinaia,PI,38,37,54,0,0,91,25,66,2,0,93
2020,50004,Calcinaia,PI,39,43,59,3,0,105,30,64,4,1,99
2020,50004,Calcinaia,PI,40,29,67,2,0,98,28,60,6,0,94
2020,50004,Calcinaia,PI,41,28,69,0,0,97,29,73,3,0,105
2020,50004,Calcinaia,PI,42,41,60,5,0,106,28,78,5,0,111
2020,50004,Calcinaia,PI,43,49,70,6,0,125,35,69,5,0,109
2020,50004,Calcinaia,PI,44,32,65,2,0,99,25,78,5,1,109
2020,50004,Calcinaia,PI,45,35,88,7,0,130,10,103,9,0,122
2020,50004,Calcinaia,PI,46,37,84,5,0,126,30,93,9,0,132
2020,50004,Calcinaia,PI,47,33,67,4,0,104,17,93,7,0,117
2020,50004,Calcinaia,PI,48,26,103,11,0,140,16,80,10,0,106
2020,50004,Calcinaia,PI,49,25,80,4,0,109,19,91,15,3,128
2020,50004,Calcinaia,PI,50,34,70,3,0,107,12,78,5,3,98
2020,50004,Calcinaia,PI,51,19,78,6,0,103,11,87,9,1,108
2020,50004,Calcinaia,PI,52,16,81,5,0,102,18,74,5,2,99
2020,50004,Calcinaia,PI,53,14,93,10,0,117,9,65,13,1,88
2020,50004,Calcinaia,PI,54,13,75,10,2,100,15,71,1,2,89
2020,50004,Calcinaia,PI,55,13,79,4,2,98,10,70,12,3,95
2020,50004,Calcinaia,PI,56,10,73,6,0,89,9,80,12,1,102
2020,50004,Calcinaia,PI,57,4,60,7,2,73,12,74,8,3,97
2020,50004,Calcinaia,PI,58,8,62,5,0,75,5,74,6,5,90
2020,50004,Calcinaia,PI,59,8,60,6,1,75,3,66,5,7,81
2020,50004,Calcinaia,PI,60,4,66,4,0,74,6,51,4,5,66
2020,50004,Calcinaia,PI,61,2,61,7,0,70,3,63,7,7,80
2020,50004,Calcinaia,PI,62,2,72,4,0,78,3,56,4,12,75
2020,50004,Calcinaia,PI,63,5,61,5,2,73,5,63,9,7,84
2020,50004,Calcinaia,PI,64,2,51,3,3,59,2,60,6,7,75
2020,50004,Calcinaia,PI,65,5,54,5,2,66,1,61,4,7,73
2020,50004,Calcinaia,PI,66,0,52,6,1,59,3,48,1,11,63
2020,50004,Calcinaia,PI,67,4,54,1,1,60,0,48,2,9,59
2020,50004,Calcinaia,PI,68,2,41,1,0,44,3,55,4,10,72
2020,50004,Calcinaia,PI,69,3,49,3,3,58,3,48,6,10,67
2020,50004,Calcinaia,PI,70,0,46,2,2,50,2,62,3,18,85
2020,50004,Calcinaia,PI,71,1,57,1,4,63,2,52,3,11,68
2020,50004,Calcinaia,PI,72,4,55,2,3,64,1,51,3,26,81
2020,50004,Calcinaia,PI,73,0,59,2,7,68,1,49,1,16,67
2020,50004,Calcinaia,PI,74,2,65,2,7,76,3,41,3,19,66
2020,50004,Calcinaia,PI,75,3,46,0,5,54,2,35,1,16,54
2020,50004,Calcinaia,PI,76,3,30,1,8,42,2,33,2,20,57
2020,50004,Calcinaia,PI,77,2,43,0,4,49,0,35,0,18,53
2020,50004,Calcinaia,PI,78,2,30,1,3,36,2,29,1,21,53
2020,50004,Calcinaia,PI,79,5,23,0,5,33,1,15,1,26,43
2020,50004,Calcinaia,PI,80,3,47,0,4,54,6,29,0,28,63
2020,50004,Calcinaia,PI,81,0,40,0,11,51,4,26,3,26,59
2020,50004,Calcinaia,PI,82,0,30,0,4,34,2,20,0,26,48
2020,50004,Calcinaia,PI,83,2,24,1,6,33,2,20,1,30,53
2020,50004,Calcinaia,PI,84,1,24,0,5,30,3,8,1,20,32
2020,50004,Calcinaia,PI,85,1,19,0,6,26,0,12,0,17,29
2020,50004,Calcinaia,PI,86,0,17,0,4,21,4,5,0,15,24
2020,50004,Calcinaia,PI,87,0,13,0,6,19,1,5,0,23,29
2020,50004,Calcinaia,PI,88,0,8,0,8,16,1,8,1,24,34
2020,50004,Calcinaia,PI,89,0,13,0,7,20,3,3,1,8,15
2020,50004,Calcinaia,PI,90,0,10,0,4,14,3,3,0,20,26
2020,50004,Calcinaia,PI,91,1,1,0,3,5,2,1,0,15,18
2020,50004,Calcinaia,PI,92,0,5,0,4,9,2,1,0,17,20
2020,50004,Calcinaia,PI,93,0,2,0,1,3,1,0,0,11,12
2020,50004,Calcinaia,PI,94,0,0,0,4,4,1,1,0,5,7
2020,50004,Calcinaia,PI,95,0,1,0,1,2,0,0,0,5,5
2020,50004,Calcinaia,PI,96,0,0,0,0,0,1,0,0,5,6
2020,50004,Calcinaia,PI,97,0,1,0,2,3,0,0,0,3,3
2020,50004,Calcinaia,PI,98,0,0,0,0,0,0,0,0,0,0
2020,50004,Calcinaia,PI,99,0,0,0,0,0,0,0,0,2,2
2020,50004,Calcinaia,PI,100 e più,0,0,0,0,0,0,0,0,3,3
2020,50005,Capannoli,PI,0,24,0,0,0,24,19,0,0,0,19
2020,50005,Capannoli,PI,1,24,0,0,0,24,20,0,0,0,20
2020,50005,Capannoli,PI,2,28,0,0,0,28,27,0,0,0,27
2020,50005,Capannoli,PI,3,42,0,0,0,42,26,0,0,0,26
2020,50005,Capannoli,PI,4,33,0,0,0,33,25,0,0,0,25
2020,50005,Capannoli,PI,5,36,0,0,0,36,25,0,0,0,25
2020,50005,Capannoli,PI,6,30,0,0,0,30,31,0,0,0,31
2020,50005,Capannoli,PI,7,33,0,0,0,33,41,0,0,0,41
2020,50005,Capannoli,PI,8,35,0,0,0,35,26,0,0,0,26
2020,50005,Capannoli,PI,9,33,0,0,0,33,31,0,0,0,31
2020,50005,Capannoli,PI,10,29,0,0,0,29,31,0,0,0,31
2020,50005,Capannoli,PI,11,37,0,0,0,37,34,0,0,0,34
2020,50005,Capannoli,PI,12,39,0,0,0,39,34,0,0,0,34
2020,50005,Capannoli,PI,13,42,0,0,0,42,29,0,0,0,29
2020,50005,Capannoli,PI,14,30,0,0,0,30,20,0,0,0,20
2020,50005,Capannoli,PI,15,36,0,0,0,36,20,0,0,0,20
2020,50005,Capannoli,PI,16,27,0,0,0,27,24,0,0,0,24
2020,50005,Capannoli,PI,17,30,0,0,0,30,26,0,0,0,26
2020,50005,Capannoli,PI,18,35,0,0,0,35,26,0,0,0,26
2020,50005,Capannoli,PI,19,25,0,0,0,25,26,1,0,0,27
2020,50005,Capannoli,PI,20,22,0,0,0,22,24,0,0,0,24
2020,50005,Capannoli,PI,21,19,0,0,0,19,44,0,0,0,44
2020,50005,Capannoli,PI,22,23,1,0,0,24,24,1,0,0,25
2020,50005,Capannoli,PI,23,36,1,0,0,37,27,1,0,0,28
2020,50005,Capannoli,PI,24,30,0,0,0,30,23,2,0,0,25
2020,50005,Capannoli,PI,25,32,1,0,0,33,21,2,0,0,23
2020,50005,Capannoli,PI,26,21,1,0,0,22,18,0,0,0,18
2020,50005,Capannoli,PI,27,30,1,0,0,31,28,1,0,0,29
2020,50005,Capannoli,PI,28,20,1,0,0,21,27,8,0,0,35
2020,50005,Capannoli,PI,29,25,2,0,0,27,26,7,1,0,34
2020,50005,Capannoli,PI,30,23,4,0,0,27,26,18,0,0,44
2020,50005,Capannoli,PI,31,27,6,1,0,34,19,13,1,0,33
2020,50005,Capannoli,PI,32,30,9,0,0,39,21,16,0,0,37
2020,50005,Capannoli,PI,33,20,8,1,0,29,12,15,0,0,27
2020,50005,Capannoli,PI,34,16,17,0,0,33,14,17,0,0,31
2020,50005,Capannoli,PI,35,15,13,0,0,28,10,16,0,0,26
2020,50005,Capannoli,PI,36,14,13,0,0,27,17,28,1,0,46
2020,50005,Capannoli,PI,37,19,19,0,0,38,11,18,0,0,29
2020,50005,Capannoli,PI,38,26,21,0,0,47,9,28,3,0,40
2020,50005,Capannoli,PI,39,18,26,0,0,44,10,29,2,1,42
2020,50005,Capannoli,PI,40,13,22,2,0,37,7,25,3,0,35
2020,50005,Capannoli,PI,41,10,22,1,0,33,14,46,2,0,62
2020,50005,Capannoli,PI,42,12,31,1,0,44,14,31,3,1,49
2020,50005,Capannoli,PI,43,8,39,5,0,52,11,32,4,1,48
2020,50005,Capannoli,PI,44,15,40,0,1,56,15,42,2,2,61
2020,50005,Capannoli,PI,45,20,29,2,0,51,11,44,2,0,57
2020,50005,Capannoli,PI,46,17,34,2,1,54,6,35,4,0,45
2020,50005,Capannoli,PI,47,15,34,5,0,54,9,41,3,1,54
2020,50005,Capannoli,PI,48,16,41,2,0,59,14,39,3,0,56
2020,50005,Capannoli,PI,49,12,39,2,0,53,9,32,3,1,45
2020,50005,Capannoli,PI,50,10,40,1,0,51,6,41,2,0,49
2020,50005,Capannoli,PI,51,4,39,3,0,46,10,31,2,0,43
2020,50005,Capannoli,PI,52,11,36,1,0,48,11,54,4,0,69
2020,50005,Capannoli,PI,53,12,34,6,1,53,4,41,4,0,49
2020,50005,Capannoli,PI,54,10,47,3,0,60,8,49,2,0,59
2020,50005,Capannoli,PI,55,8,50,5,0,63,8,26,5,1,40
2020,50005,Capannoli,PI,56,4,41,4,0,49,8,40,5,2,55
2020,50005,Capannoli,PI,57,4,35,4,0,43,4,37,5,2,48
2020,50005,Capannoli,PI,58,8,45,0,0,53,6,35,0,5,46
2020,50005,Capannoli,PI,59,5,35,3,0,43,4,39,2,6,51
2020,50005,Capannoli,PI,60,0,33,1,1,35,3,38,2,5,48
2020,50005,Capannoli,PI,61,10,33,5,4,52,2,39,2,1,44
2020,50005,Capannoli,PI,62,2,34,3,0,39,4,28,5,2,39
2020,50005,Capannoli,PI,63,3,29,2,0,34,2,28,5,4,39
2020,50005,Capannoli,PI,64,1,33,6,1,41,3,40,5,6,54
2020,50005,Capannoli,PI,65,3,37,2,1,43,4,35,1,3,43
2020,50005,Capannoli,PI,66,1,30,0,1,32,1,33,5,5,44
2020,50005,Capannoli,PI,67,3,22,2,1,28,1,21,1,7,30
2020,50005,Capannoli,PI,68,0,30,1,0,31,0,31,2,2,35
2020,50005,Capannoli,PI,69,4,26,0,1,31,0,28,1,5,34
2020,50005,Capannoli,PI,70,5,32,0,1,38,3,36,0,5,44
2020,50005,Capannoli,PI,71,1,32,0,2,35,0,27,1,12,40
2020,50005,Capannoli,PI,72,1,31,1,2,35,0,20,1,9,30
2020,50005,Capannoli,PI,73,3,33,1,2,39,1,25,0,8,34
2020,50005,Capannoli,PI,74,1,22,1,3,27,2,34,1,11,48
2020,50005,Capannoli,PI,75,2,22,1,2,27,0,16,0,10,26
2020,50005,Capannoli,PI,76,2,19,1,0,22,1,26,1,16,44
2020,50005,Capannoli,PI,77,3,24,0,1,28,0,15,1,12,28
2020,50005,Capannoli,PI,78,1,20,0,2,23,0,21,2,10,33
2020,50005,Capannoli,PI,79,0,22,0,0,22,1,17,1,13,32
2020,50005,Capannoli,PI,80,0,23,1,4,28,1,9,0,22,32
2020,50005,Capannoli,PI,81,2,23,1,4,30,1,18,0,14,33
2020,50005,Capannoli,PI,82,1,21,0,2,24,1,15,0,13,29
2020,50005,Capannoli,PI,83,0,16,0,6,22,1,5,0,11,17
2020,50005,Capannoli,PI,84,2,8,0,2,12,0,4,0,19,23
2020,50005,Capannoli,PI,85,0,16,1,2,19,0,6,0,19,25
2020,50005,Capannoli,PI,86,1,14,0,3,18,0,4,0,18,22
2020,50005,Capannoli,PI,87,0,5,0,2,7,0,0,0,18,18
2020,50005,Capannoli,PI,88,0,8,0,4,12,1,0,0,13,14
2020,50005,Capannoli,PI,89,0,3,0,5,8,0,0,0,11,11
2020,50005,Capannoli,PI,90,0,4,0,5,9,0,0,0,3,3
2020,50005,Capannoli,PI,91,0,0,0,0,0,1,0,0,7,8
2020,50005,Capannoli,PI,92,0,1,0,0,1,0,1,0,10,11
2020,50005,Capannoli,PI,93,0,2,0,1,3,0,1,0,10,11
2020,50005,Capannoli,PI,94,0,0,0,0,0,0,0,0,4,4
2020,50005,Capannoli,PI,95,0,0,0,0,0,0,0,0,6,6
2020,50005,Capannoli,PI,96,0,0,0,0,0,0,0,0,2,2
2020,50005,Capannoli,PI,97,0,0,0,0,0,0,0,0,0,0
2020,50005,Capannoli,PI,98,0,0,0,0,0,0,0,0,2,2
2020,50005,Capannoli,PI,99,0,0,0,0,0,0,0,0,1,1
2020,50005,Capannoli,PI,100 e più,0,0,0,1,1,0,0,0,1,1
2020,50006,Casale Marittimo,PI,0,0,0,0,0,0,4,0,0,0,4
2020,50006,Casale Marittimo,PI,1,4,0,0,0,4,3,0,0,0,3
2020,50006,Casale Marittimo,PI,2,4,0,0,0,4,2,0,0,0,2
2020,50006,Casale Marittimo,PI,3,5,0,0,0,5,5,0,0,0,5
2020,50006,Casale Marittimo,PI,4,5,0,0,0,5,4,0,0,0,4
2020,50006,Casale Marittimo,PI,5,3,0,0,0,3,2,0,0,0,2
2020,50006,Casale Marittimo,PI,6,7,0,0,0,7,3,0,0,0,3
2020,50006,Casale Marittimo,PI,7,3,0,0,0,3,3,0,0,0,3
2020,50006,Casale Marittimo,PI,8,4,0,0,0,4,2,0,0,0,2
2020,50006,Casale Marittimo,PI,9,9,0,0,0,9,5,0,0,0,5
2020,50006,Casale Marittimo,PI,10,5,0,0,0,5,6,0,0,0,6
2020,50006,Casale Marittimo,PI,11,5,0,0,0,5,8,0,0,0,8
2020,50006,Casale Marittimo,PI,12,5,0,0,0,5,7,0,0,0,7
2020,50006,Casale Marittimo,PI,13,6,0,0,0,6,3,0,0,0,3
2020,50006,Casale Marittimo,PI,14,4,0,0,0,4,5,0,0,0,5
2020,50006,Casale Marittimo,PI,15,5,0,0,0,5,0,0,0,0,0
2020,50006,Casale Marittimo,PI,16,2,0,0,0,2,2,0,0,0,2
2020,50006,Casale Marittimo,PI,17,5,0,0,0,5,4,0,0,0,4
2020,50006,Casale Marittimo,PI,18,2,0,0,0,2,5,0,0,0,5
2020,50006,Casale Marittimo,PI,19,2,0,0,0,2,3,0,0,0,3
2020,50006,Casale Marittimo,PI,20,6,0,0,0,6,3,0,0,0,3
2020,50006,Casale Marittimo,PI,21,4,0,0,0,4,5,0,0,0,5
2020,50006,Casale Marittimo,PI,22,4,0,0,0,4,3,1,0,0,4
2020,50006,Casale Marittimo,PI,23,8,0,0,0,8,6,0,0,0,6
2020,50006,Casale Marittimo,PI,24,3,0,0,0,3,8,0,0,0,8
2020,50006,Casale Marittimo,PI,25,1,0,0,0,1,1,0,0,0,1
2020,50006,Casale Marittimo,PI,26,2,0,0,0,2,1,0,0,0,1
2020,50006,Casale Marittimo,PI,27,6,0,0,0,6,2,0,0,0,2
2020,50006,Casale Marittimo,PI,28,6,1,0,0,7,2,0,0,0,2
2020,50006,Casale Marittimo,PI,29,2,0,0,0,2,3,2,0,0,5
2020,50006,Casale Marittimo,PI,30,2,0,0,0,2,4,0,0,0,4
2020,50006,Casale Marittimo,PI,31,2,0,0,0,2,3,0,0,0,3
2020,50006,Casale Marittimo,PI,32,0,0,0,0,0,4,2,0,0,6
2020,50006,Casale Marittimo,PI,33,7,2,0,0,9,4,7,0,0,11
2020,50006,Casale Marittimo,PI,34,6,1,0,0,7,3,1,0,0,4
2020,50006,Casale Marittimo,PI,35,3,0,0,0,3,2,2,0,0,4
2020,50006,Casale Marittimo,PI,36,2,2,0,0,4,3,2,0,0,5
2020,50006,Casale Marittimo,PI,37,4,3,0,0,7,2,5,0,0,7
2020,50006,Casale Marittimo,PI,38,4,0,0,0,4,3,2,0,0,5
2020,50006,Casale Marittimo,PI,39,2,2,0,0,4,3,2,0,0,5
2020,50006,Casale Marittimo,PI,40,2,5,0,0,7,1,4,1,0,6
2020,50006,Casale Marittimo,PI,41,1,3,1,0,5,3,5,0,0,8
2020,50006,Casale Marittimo,PI,42,6,4,0,0,10,4,4,0,0,8
2020,50006,Casale Marittimo,PI,43,1,6,0,0,7,1,2,0,0,3
2020,50006,Casale Marittimo,PI,44,5,7,0,0,12,1,9,0,0,10
2020,50006,Casale Marittimo,PI,45,5,4,0,0,9,2,7,1,0,10
2020,50006,Casale Marittimo,PI,46,5,7,0,0,12,2,6,2,0,10
2020,50006,Casale Marittimo,PI,47,6,6,0,0,12,1,6,2,0,9
2020,50006,Casale Marittimo,PI,48,3,5,2,0,10,1,5,3,0,9
2020,50006,Casale Marittimo,PI,49,3,10,1,0,14,5,8,1,0,14
2020,50006,Casale Marittimo,PI,50,3,4,1,0,8,4,4,2,0,10
2020,50006,Casale Marittimo,PI,51,3,8,1,0,12,1,3,2,0,6
2020,50006,Casale Marittimo,PI,52,3,9,0,0,12,2,9,1,0,12
2020,50006,Casale Marittimo,PI,53,5,6,0,0,11,0,3,1,0,4
2020,50006,Casale Marittimo,PI,54,0,4,0,0,4,2,5,2,0,9
2020,50006,Casale Marittimo,PI,55,2,2,2,0,6,0,5,1,0,6
2020,50006,Casale Marittimo,PI,56,2,6,1,0,9,1,5,0,1,7
2020,50006,Casale Marittimo,PI,57,1,3,0,0,4,1,6,2,0,9
2020,50006,Casale Marittimo,PI,58,0,9,0,1,10,1,10,0,0,11
2020,50006,Casale Marittimo,PI,59,1,1,1,0,3,0,4,0,0,4
2020,50006,Casale Marittimo,PI,60,0,7,2,1,10,0,7,0,0,7
2020,50006,Casale Marittimo,PI,61,2,8,4,0,14,2,6,0,0,8
2020,50006,Casale Marittimo,PI,62,4,4,0,0,8,1,5,0,0,6
2020,50006,Casale Marittimo,PI,63,1,10,1,0,12,0,5,1,0,6
2020,50006,Casale Marittimo,PI,64,0,3,0,0,3,0,1,1,2,4
2020,50006,Casale Marittimo,PI,65,0,7,2,0,9,0,0,0,1,1
2020,50006,Casale Marittimo,PI,66,0,9,0,0,9,0,4,1,1,6
2020,50006,Casale Marittimo,PI,67,1,1,0,0,2,0,12,0,2,14
2020,50006,Casale Marittimo,PI,68,1,2,0,0,3,2,6,0,2,10
2020,50006,Casale Marittimo,PI,69,1,4,0,0,5,0,4,1,0,5
2020,50006,Casale Marittimo,PI,70,0,7,1,0,8,0,5,0,1,6
2020,50006,Casale Marittimo,PI,71,0,3,0,1,4,0,9,0,2,11
2020,50006,Casale Marittimo,PI,72,0,6,0,1,7,0,4,0,1,5
2020,50006,Casale Marittimo,PI,73,0,9,1,2,12,0,5,0,4,9
2020,50006,Casale Marittimo,PI,74,0,4,0,1,5,0,3,1,2,6
2020,50006,Casale Marittimo,PI,75,0,8,0,2,10,1,3,1,3,8
2020,50006,Casale Marittimo,PI,76,0,8,0,1,9,1,6,0,2,9
2020,50006,Casale Marittimo,PI,77,0,6,0,1,7,0,2,0,2,4
2020,50006,Casale Marittimo,PI,78,0,3,1,2,6,0,6,0,3,9
2020,50006,Casale Marittimo,PI,79,0,4,0,0,4,0,2,1,2,5
2020,50006,Casale Marittimo,PI,80,1,4,0,3,8,1,1,1,6,9
2020,50006,Casale Marittimo,PI,81,0,3,0,1,4,1,4,0,1,6
2020,50006,Casale Marittimo,PI,82,0,6,0,0,6,0,0,1,4,5
2020,50006,Casale Marittimo,PI,83,1,2,1,1,5,0,0,1,1,2
2020,50006,Casale Marittimo,PI,84,0,0,0,0,0,0,4,1,2,7
2020,50006,Casale Marittimo,PI,85,0,1,0,0,1,0,0,0,3,3
2020,50006,Casale Marittimo,PI,86,0,3,0,0,3,0,0,0,0,0
2020,50006,Casale Marittimo,PI,87,1,1,0,0,2,0,1,0,1,2
2020,50006,Casale Marittimo,PI,88,0,1,1,1,3,1,0,0,2,3
2020,50006,Casale Marittimo,PI,89,0,0,0,0,0,0,0,0,2,2
2020,50006,Casale Marittimo,PI,90,0,1,0,0,1,0,0,0,3,3
2020,50006,Casale Marittimo,PI,91,0,0,0,1,1,0,1,1,3,5
2020,50006,Casale Marittimo,PI,92,0,0,0,0,0,0,0,0,2,2
2020,50006,Casale Marittimo,PI,93,0,0,0,0,0,0,0,0,1,1
2020,50006,Casale Marittimo,PI,94,0,0,0,0,0,0,0,0,1,1
2020,50006,Casale Marittimo,PI,95,0,0,0,0,0,0,0,0,0,0
2020,50006,Casale Marittimo,PI,96,0,0,0,0,0,0,0,0,1,1
2020,50006,Casale Marittimo,PI,97,0,0,0,0,0,0,0,0,1,1
2020,50006,Casale Marittimo,PI,98,0,0,0,0,0,0,0,0,0,0
2020,50006,Casale Marittimo,PI,99,0,0,0,0,0,0,0,0,1,1
2020,50006,Casale Marittimo,PI,100 e più,0,0,0,0,0,0,0,0,0,0
2020,50008,Cascina,PI,0,157,0,0,0,157,155,0,0,0,155
2020,50008,Cascina,PI,1,164,0,0,0,164,150,0,0,0,150
2020,50008,Cascina,PI,2,148,0,0,0,148,186,0,0,0,186
2020,50008,Cascina,PI,3,197,0,0,0,197,182,0,0,0,182
2020,50008,Cascina,PI,4,172,0,0,0,172,194,0,0,0,194
2020,50008,Cascina,PI,5,209,0,0,0,209,215,0,0,0,215
2020,50008,Cascina,PI,6,216,0,0,0,216,215,0,0,0,215
2020,50008,Cascina,PI,7,205,0,0,0,205,216,0,0,0,216
2020,50008,Cascina,PI,8,236,0,0,0,236,219,0,0,0,219
2020,50008,Cascina,PI,9,217,0,0,0,217,206,0,0,0,206
2020,50008,Cascina,PI,10,242,0,0,0,242,226,0,0,0,226
2020,50008,Cascina,PI,11,238,0,0,0,238,241,0,0,0,241
2020,50008,Cascina,PI,12,247,0,0,0,247,204,0,0,0,204
2020,50008,Cascina,PI,13,219,0,0,0,219,218,0,0,0,218
2020,50008,Cascina,PI,14,215,0,0,0,215,222,0,0,0,222
2020,50008,Cascina,PI,15,235,0,0,0,235,222,0,0,0,222
2020,50008,Cascina,PI,16,229,0,0,0,229,225,0,0,0,225
2020,50008,Cascina,PI,17,220,0,0,0,220,202,0,0,0,202
2020,50008,Cascina,PI,18,220,0,0,0,220,190,1,0,0,191
2020,50008,Cascina,PI,19,205,0,0,0,205,200,0,0,0,200
2020,50008,Cascina,PI,20,200,0,0,0,200,181,0,0,0,181
2020,50008,Cascina,PI,21,204,0,0,0,204,172,3,0,0,175
2020,50008,Cascina,PI,22,192,1,0,0,193,180,5,0,0,185
2020,50008,Cascina,PI,23,193,1,0,0,194,184,5,1,0,190
2020,50008,Cascina,PI,24,211,1,0,0,212,174,7,0,0,181
2020,50008,Cascina,PI,25,205,2,0,0,207,167,13,0,0,180
2020,50008,Cascina,PI,26,182,4,1,0,187,175,22,0,0,197
2020,50008,Cascina,PI,27,194,8,0,0,202,167,29,0,0,196
2020,50008,Cascina,PI,28,179,22,0,1,202,173,37,0,0,210
2020,50008,Cascina,PI,29,177,19,0,0,196,154,43,1,0,198
2020,50008,Cascina,PI,30,196,35,0,0,231,167,65,3,0,236
2020,50008,Cascina,PI,31,158,55,0,0,213,154,91,2,0,247
2020,50008,Cascina,PI,32,171,49,1,0,221,135,102,2,1,240
2020,50008,Cascina,PI,33,167,71,0,0,238,116,104,2,0,222
2020,50008,Cascina,PI,34,151,60,1,0,212,111,122,7,0,240
2020,50008,Cascina,PI,35,161,88,2,0,252,103,122,8,0,234
2020,50008,Cascina,PI,36,134,125,1,0,260,99,145,9,0,253
2020,50008,Cascina,PI,37,120,112,6,0,238,98,131,5,1,237
2020,50008,Cascina,PI,38,117,148,4,1,270,113,139,10,0,262
2020,50008,Cascina,PI,39,124,130,10,0,264,107,159,9,1,277
2020,50008,Cascina,PI,40,116,141,6,0,263,90,191,6,1,288
2020,50008,Cascina,PI,41,132,169,11,0,313,104,209,7,2,322
2020,50008,Cascina,PI,42,122,171,4,0,297,87,224,19,0,330
2020,50008,Cascina,PI,43,117,212,14,2,345,100,200,23,2,326
2020,50008,Cascina,PI,44,134,211,15,1,361,115,255,19,2,391
2020,50008,Cascina,PI,45,112,234,12,0,359,93,252,30,3,378
2020,50008,Cascina,PI,46,129,253,15,0,397,94,289,20,10,414
2020,50008,Cascina,PI,47,88,266,15,1,370,71,288,24,3,387
2020,50008,Cascina,PI,48,105,285,21,2,413,88,254,29,7,379
2020,50008,Cascina,PI,49,101,256,19,1,378,77,302,36,7,423
2020,50008,Cascina,PI,50,106,260,26,0,392,71,270,34,6,381
2020,50008,Cascina,PI,51,84,277,29,3,393,67,295,38,9,409
2020,50008,Cascina,PI,52,79,275,29,1,386,58,266,44,14,383
2020,50008,Cascina,PI,53,57,258,20,1,336,33,305,41,15,396
2020,50008,Cascina,PI,54,61,286,31,7,385,47,314,37,11,411
2020,50008,Cascina,PI,55,66,269,31,2,368,38,272,32,12,354
2020,50008,Cascina,PI,56,42,264,35,8,349,36,300,43,12,391
2020,50008,Cascina,PI,57,41,271,26,8,346,32,289,41,13,376
2020,50008,Cascina,PI,58,29,231,28,6,294,24,254,29,11,319
2020,50008,Cascina,PI,59,28,234,31,3,297,19,285,28,16,348
2020,50008,Cascina,PI,60,44,281,22,7,354,17,238,35,17,307
2020,50008,Cascina,PI,61,38,232,21,5,296,18,233,16,24,291
2020,50008,Cascina,PI,62,24,221,25,5,275,29,227,22,25,303
2020,50008,Cascina,PI,63,17,229,7,6,260,17,207,24,27,275
2020,50008,Cascina,PI,64,17,221,15,9,263,18,204,13,40,276
2020,50008,Cascina,PI,65,21,219,21,5,266,14,239,15,26,294
2020,50008,Cascina,PI,66,13,211,9,6,239,9,217,20,44,290
2020,50008,Cascina,PI,67,16,180,20,10,226,12,185,15,30,242
2020,50008,Cascina,PI,68,12,207,10,9,238,11,199,13,37,260
2020,50008,Cascina,PI,69,7,180,8,14,209,8,165,11,37,221
2020,50008,Cascina,PI,70,13,203,12,16,244,10,197,12,55,275
2020,50008,Cascina,PI,71,10,221,16,10,257,7,210,11,65,293
2020,50008,Cascina,PI,72,11,224,12,19,266,7,218,10,71,306
2020,50008,Cascina,PI,73,7,226,7,19,259,10,212,4,74,300
2020,50008,Cascina,PI,74,8,217,8,15,248,9,186,6,102,304
2020,50008,Cascina,PI,75,9,160,7,27,203,9,148,10,83,250
2020,50008,Cascina,PI,76,7,164,5,21,197,8,131,11,92,242
2020,50008,Cascina,PI,77,13,141,2,23,179,7,106,10,89,212
2020,50008,Cascina,PI,78,8,142,2,23,175,7,131,2,83,223
2020,50008,Cascina,PI,79,6,147,1,19,173,7,108,3,89,207
2020,50008,Cascina,PI,80,5,134,1,24,164,5,108,4,105,222
2020,50008,Cascina,PI,81,4,123,2,22,151,6,93,4,123,226
2020,50008,Cascina,PI,82,7,123,2,32,164,8,75,4,145,232
2020,50008,Cascina,PI,83,6,104,2,28,140,6,65,1,130,202
2020,50008,Cascina,PI,84,5,92,0,23,120,9,44,3,110,166
2020,50008,Cascina,PI,85,3,85,2,34,124,5,40,1,91,137
2020,50008,Cascina,PI,86,1,62,1,13,77,3,27,1,111,142
2020,50008,Cascina,PI,87,4,48,1,24,77,3,20,3,99,125
2020,50008,Cascina,PI,88,5,45,0,16,66,4,17,1,85,107
2020,50008,Cascina,PI,89,0,37,2,13,52,8,6,1,91,106
2020,50008,Cascina,PI,90,1,28,0,17,46,5,4,0,93,102
2020,50008,Cascina,PI,91,3,13,1,9,26,6,1,0,65,72
2020,50008,Cascina,PI,92,0,18,0,14,32,3,6,0,51,60
2020,50008,Cascina,PI,93,0,6,0,16,22,2,1,0,44,47
2020,50008,Cascina,PI,94,2,4,0,8,14,1,0,0,22,23
2020,50008,Cascina,PI,95,0,1,0,1,2,2,0,0,21,23
2020,50008,Cascina,PI,96,0,2,0,4,6,3,0,0,14,17
2020,50008,Cascina,PI,97,0,0,0,4,4,2,1,0,15,18
2020,50008,Cascina,PI,98,0,1,0,1,2,0,0,0,8,8
2020,50008,Cascina,PI,99,0,0,0,2,2,0,0,1,7,8
2020,50008,Cascina,PI,100 e più,0,0,0,1,1,1,0,0,6,7
2020,50009,Castelfranco di Sotto,PI,0,51,0,0,0,51,40,0,0,0,40
2020,50009,Castelfranco di Sotto,PI,1,38,0,0,0,38,50,0,0,0,50
2020,50009,Castelfranco di Sotto,PI,2,51,0,0,0,51,66,0,0,0,66
2020,50009,Castelfranco di Sotto,PI,3,49,0,0,0,49,56,0,0,0,56
2020,50009,Castelfranco di Sotto,PI,4,54,0,0,0,54,57,0,0,0,57
2020,50009,Castelfranco di Sotto,PI,5,58,0,0,0,58,53,0,0,0,53
2020,50009,Castelfranco di Sotto,PI,6,58,0,0,0,58,60,0,0,0,60
2020,50009,Castelfranco di Sotto,PI,7,67,0,0,0,67,68,0,0,0,68
2020,50009,Castelfranco di Sotto,PI,8,62,0,0,0,62,58,0,0,0,58
2020,50009,Castelfranco di Sotto,PI,9,69,0,0,0,69,62,0,0,0,62
2020,50009,Castelfranco di Sotto,PI,10,61,0,0,0,61,72,0,0,0,72
2020,50009,Castelfranco di Sotto,PI,11,72,0,0,0,72,75,0,0,0,75
2020,50009,Castelfranco di Sotto,PI,12,74,0,0,0,74,57,0,0,0,57
2020,50009,Castelfranco di Sotto,PI,13,68,0,0,0,68,75,0,0,0,75
2020,50009,Castelfranco di Sotto,PI,14,66,0,0,0,66,54,0,0,0,54
2020,50009,Castelfranco di Sotto,PI,15,80,0,0,0,80,67,0,0,0,67
2020,50009,Castelfranco di Sotto,PI,16,51,0,0,0,51,69,0,0,0,69
2020,50009,Castelfranco di Sotto,PI,17,80,0,0,0,80,57,0,0,0,57
2020,50009,Castelfranco di Sotto,PI,18,71,0,0,0,71,58,1,0,0,59
2020,50009,Castelfranco di Sotto,PI,19,75,0,0,0,75,63,0,0,0,63
2020,50009,Castelfranco di Sotto,PI,20,84,0,0,0,84,47,1,0,0,48
2020,50009,Castelfranco di Sotto,PI,21,68,0,0,0,68,57,1,0,0,58
2020,50009,Castelfranco di Sotto,PI,22,76,0,0,0,76,50,4,0,0,54
2020,50009,Castelfranco di Sotto,PI,23,86,0,0,0,86,73,13,0,0,86
2020,50009,Castelfranco di Sotto,PI,24,80,0,0,0,80,70,6,0,0,76
2020,50009,Castelfranco di Sotto,PI,25,83,2,0,0,85,46,8,0,0,54
2020,50009,Castelfranco di Sotto,PI,26,82,1,0,0,83,50,13,0,0,63
2020,50009,Castelfranco di Sotto,PI,27,65,8,0,0,73,40,12,0,0,52
2020,50009,Castelfranco di Sotto,PI,28,77,5,1,0,83,48,17,1,0,66
2020,50009,Castelfranco di Sotto,PI,29,55,14,0,0,69,38,24,0,0,62
2020,50009,Castelfranco di Sotto,PI,30,63,15,0,0,78,51,23,1,0,75
2020,50009,Castelfranco di Sotto,PI,31,51,14,0,0,65,48,23,0,0,71
2020,50009,Castelfranco di Sotto,PI,32,76,15,0,0,91,33,39,1,0,73
2020,50009,Castelfranco di Sotto,PI,33,55,17,0,0,72,38,32,1,1,72
2020,50009,Castelfranco di Sotto,PI,34,43,25,0,0,68,21,40,3,0,64
2020,50009,Castelfranco di Sotto,PI,35,50,24,0,0,74,37,36,4,0,77
2020,50009,Castelfranco di Sotto,PI,36,45,18,3,0,66,28,40,1,0,69
2020,50009,Castelfranco di Sotto,PI,37,40,37,0,0,77,26,49,2,0,77
2020,50009,Castelfranco di Sotto,PI,38,46,52,1,0,99,19,51,4,1,75
2020,50009,Castelfranco di Sotto,PI,39,36,46,1,0,83,23,58,2,1,84
2020,50009,Castelfranco di Sotto,PI,40,46,41,2,0,89,30,41,2,2,75
2020,50009,Castelfranco di Sotto,PI,41,36,47,1,0,84,27,63,5,1,96
2020,50009,Castelfranco di Sotto,PI,42,39,46,4,1,90,22,67,7,3,99
2020,50009,Castelfranco di Sotto,PI,43,38,77,5,0,120,17,75,11,1,104
2020,50009,Castelfranco di Sotto,PI,44,31,59,6,0,96,23,63,5,0,91
2020,50009,Castelfranco di Sotto,PI,45,31,69,6,0,106,15,64,11,2,92
2020,50009,Castelfranco di Sotto,PI,46,29,77,2,1,109,29,86,7,1,123
2020,50009,Castelfranco di Sotto,PI,47,30,78,10,0,118,22,75,3,1,101
2020,50009,Castelfranco di Sotto,PI,48,33,65,7,1,106,11,75,9,2,97
2020,50009,Castelfranco di Sotto,PI,49,27,84,6,0,117,16,92,7,1,116
2020,50009,Castelfranco di Sotto,PI,50,18,64,7,0,89,23,75,5,3,106
2020,50009,Castelfranco di Sotto,PI,51,40,74,6,0,120,16,77,10,0,103
2020,50009,Castelfranco di Sotto,PI,52,22,82,3,0,107,11,82,6,4,103
2020,50009,Castelfranco di Sotto,PI,53,17,90,2,0,109,13,77,4,1,95
2020,50009,Castelfranco di Sotto,PI,54,18,84,12,2,116,9,75,13,0,97
2020,50009,Castelfranco di Sotto,PI,55,20,94,5,1,120,12,89,7,3,111
2020,50009,Castelfranco di Sotto,PI,56,17,80,10,0,107,11,82,7,6,106
2020,50009,Castelfranco di Sotto,PI,57,19,84,3,3,109,10,95,6,3,114
2020,50009,Castelfranco di Sotto,PI,58,11,90,5,0,106,7,83,7,5,102
2020,50009,Castelfranco di Sotto,PI,59,7,84,6,1,98,13,61,8,9,91
2020,50009,Castelfranco di Sotto,PI,60,6,93,3,2,104,8,83,4,6,101
2020,50009,Castelfranco di Sotto,PI,61,15,79,6,3,103,4,79,5,8,96
2020,50009,Castelfranco di Sotto,PI,62,10,74,5,2,91,3,71,7,4,85
2020,50009,Castelfranco di Sotto,PI,63,8,58,0,2,68,3,57,3,10,73
2020,50009,Castelfranco di Sotto,PI,64,2,65,7,2,76,7,73,1,17,98
2020,50009,Castelfranco di Sotto,PI,65,7,64,5,1,77,5,59,5,13,82
2020,50009,Castelfranco di Sotto,PI,66,1,75,3,2,81,0,68,5,10,83
2020,50009,Castelfranco di Sotto,PI,67,6,61,1,4,72,5,52,4,8,69
2020,50009,Castelfranco di Sotto,PI,68,3,49,3,4,59,2,52,5,17,76
2020,50009,Castelfranco di Sotto,PI,69,4,38,3,3,48,0,61,2,13,76
2020,50009,Castelfranco di Sotto,PI,70,6,69,2,5,82,4,50,7,14,75
2020,50009,Castelfranco di Sotto,PI,71,5,64,2,2,73,2,53,3,14,72
2020,50009,Castelfranco di Sotto,PI,72,4,70,0,6,80,3,58,2,19,82
2020,50009,Castelfranco di Sotto,PI,73,1,60,1,3,65,2,64,4,20,90
2020,50009,Castelfranco di Sotto,PI,74,5,50,1,8,64,2,48,4,19,73
2020,50009,Castelfranco di Sotto,PI,75,2,54,3,5,64,4,46,5,18,73
2020,50009,Castelfranco di Sotto,PI,76,1,43,2,2,48,1,34,1,23,59
2020,50009,Castelfranco di Sotto,PI,77,0,36,1,0,37,1,35,4,24,64
2020,50009,Castelfranco di Sotto,PI,78,3,35,0,2,40,1,23,1,24,49
2020,50009,Castelfranco di Sotto,PI,79,0,33,1,6,40,4,17,2,16,39
2020,50009,Castelfranco di Sotto,PI,80,2,29,1,8,40,2,29,1,29,61
2020,50009,Castelfranco di Sotto,PI,81,4,41,1,3,49,1,22,2,30,55
2020,50009,Castelfranco di Sotto,PI,82,2,30,1,8,41,1,29,2,37,69
2020,50009,Castelfranco di Sotto,PI,83,4,40,1,6,51,4,21,0,33,58
2020,50009,Castelfranco di Sotto,PI,84,1,23,1,7,32,1,13,0,36,50
2020,50009,Castelfranco di Sotto,PI,85,0,24,1,5,30,1,18,0,35,54
2020,50009,Castelfranco di Sotto,PI,86,2,18,0,3,23,1,8,0,32,41
2020,50009,Castelfranco di Sotto,PI,87,2,10,1,5,18,3,4,0,26,33
2020,50009,Castelfranco di Sotto,PI,88,0,11,1,10,22,1,5,0,25,31
2020,50009,Castelfranco di Sotto,PI,89,0,12,0,3,15,0,4,0,30,34
2020,50009,Castelfranco di Sotto,PI,90,1,9,0,8,18,1,5,0,30,36
2020,50009,Castelfranco di Sotto,PI,91,0,5,0,4,9,1,0,0,27,28
2020,50009,Castelfranco di Sotto,PI,92,0,3,0,1,4,0,5,1,17,23
2020,50009,Castelfranco di Sotto,PI,93,0,5,0,3,8,0,0,0,17,17
2020,50009,Castelfranco di Sotto,PI,94,0,6,0,2,8,1,2,0,13,16
2020,50009,Castelfranco di Sotto,PI,95,0,2,0,1,3,0,0,0,9,9
2020,50009,Castelfranco di Sotto,PI,96,0,0,0,1,1,1,0,0,7,8
2020,50009,Castelfranco di Sotto,PI,97,0,0,0,1,1,0,0,0,5,5
2020,50009,Castelfranco di Sotto,PI,98,0,0,0,0,0,0,0,0,1,1
2020,50009,Castelfranco di Sotto,PI,99,0,0,0,0,0,0,0,0,0,0
2020,50009,Castelfranco di Sotto,PI,100 e più,0,0,0,0,0,2,0,0,1,3
2020,50010,Castellina Marittima,PI,0,3,0,0,0,3,4,0,0,0,4
2020,50010,Castellina Marittima,PI,1,7,0,0,0,7,12,0,0,0,12
2020,50010,Castellina Marittima,PI,2,6,0,0,0,6,6,0,0,0,6
2020,50010,Castellina Marittima,PI,3,6,0,0,0,6,4,0,0,0,4
2020,50010,Castellina Marittima,PI,4,11,0,0,0,11,8,0,0,0,8
2020,50010,Castellina Marittima,PI,5,7,0,0,0,7,5,0,0,0,5
2020,50010,Castellina Marittima,PI,6,9,0,0,0,9,10,0,0,0,10
2020,50010,Castellina Marittima,PI,7,7,0,0,0,7,4,0,0,0,4
2020,50010,Castellina Marittima,PI,8,12,0,0,0,12,6,0,0,0,6
2020,50010,Castellina Marittima,PI,9,7,0,0,0,7,3,0,0,0,3
2020,50010,Castellina Marittima,PI,10,6,0,0,0,6,10,0,0,0,10
2020,50010,Castellina Marittima,PI,11,9,0,0,0,9,7,0,0,0,7
2020,50010,Castellina Marittima,PI,12,8,0,0,0,8,10,0,0,0,10
2020,50010,Castellina Marittima,PI,13,10,0,0,0,10,6,0,0,0,6
2020,50010,Castellina Marittima,PI,14,4,0,0,0,4,9,0,0,0,9
2020,50010,Castellina Marittima,PI,15,7,0,0,0,7,10,0,0,0,10
2020,50010,Castellina Marittima,PI,16,8,0,0,0,8,8,0,0,0,8
2020,50010,Castellina Marittima,PI,17,11,0,0,0,11,4,0,0,0,4
2020,50010,Castellina Marittima,PI,18,6,0,0,0,6,5,0,0,0,5
2020,50010,Castellina Marittima,PI,19,5,0,0,0,5,7,0,0,0,7
2020,50010,Castellina Marittima,PI,20,8,0,0,0,8,7,0,0,0,7
2020,50010,Castellina Marittima,PI,21,7,0,0,0,7,2,0,0,0,2
2020,50010,Castellina Marittima,PI,22,7,0,0,0,7,5,0,0,0,5
2020,50010,Castellina Marittima,PI,23,8,0,0,0,8,6,0,0,0,6
2020,50010,Castellina Marittima,PI,24,10,0,0,0,10,10,0,0,0,10
2020,50010,Castellina Marittima,PI,25,9,0,0,0,9,9,0,0,0,9
2020,50010,Castellina Marittima,PI,26,6,0,0,0,6,4,0,0,0,4
2020,50010,Castellina Marittima,PI,27,12,0,0,0,12,4,2,0,0,6
2020,50010,Castellina Marittima,PI,28,11,0,0,0,11,8,0,0,0,8
2020,50010,Castellina Marittima,PI,29,12,1,0,0,13,4,4,0,0,8
2020,50010,Castellina Marittima,PI,30,13,0,0,0,13,7,1,0,0,8
2020,50010,Castellina Marittima,PI,31,7,0,0,0,7,6,2,0,0,8
2020,50010,Castellina Marittima,PI,32,9,2,0,0,11,7,2,1,0,10
2020,50010,Castellina Marittima,PI,33,11,2,0,0,13,7,6,0,0,13
2020,50010,Castellina Marittima,PI,34,4,0,0,0,4,7,5,0,0,12
2020,50010,Castellina Marittima,PI,35,4,2,0,0,6,8,2,0,0,10
2020,50010,Castellina Marittima,PI,36,6,5,0,0,11,7,4,1,0,12
2020,50010,Castellina Marittima,PI,37,7,3,1,0,11,5,9,0,0,14
2020,50010,Castellina Marittima,PI,38,9,5,0,0,14,2,6,0,0,8
2020,50010,Castellina Marittima,PI,39,8,5,0,0,13,4,5,0,0,9
2020,50010,Castellina Marittima,PI,40,4,7,0,0,11,10,4,1,0,15
2020,50010,Castellina Marittima,PI,41,7,4,1,0,12,8,4,0,0,12
2020,50010,Castellina Marittima,PI,42,7,8,0,0,15,2,6,1,0,9
2020,50010,Castellina Marittima,PI,43,6,9,0,0,15,7,2,1,0,10
2020,50010,Castellina Marittima,PI,44,7,6,1,0,14,5,10,2,0,17
2020,50010,Castellina Marittima,PI,45,12,3,0,0,15,7,9,0,0,16
2020,50010,Castellina Marittima,PI,46,9,8,2,0,19,4,7,2,0,13
2020,50010,Castellina Marittima,PI,47,7,9,1,0,17,7,5,0,0,12
2020,50010,Castellina Marittima,PI,48,2,11,1,1,15,6,12,2,0,20
2020,50010,Castellina Marittima,PI,49,5,12,0,0,17,4,11,0,0,15
2020,50010,Castellina Marittima,PI,50,2,10,2,0,14,1,6,1,1,9
2020,50010,Castellina Marittima,PI,51,5,18,2,0,25,1,8,2,0,11
2020,50010,Castellina Marittima,PI,52,5,10,1,0,16,2,12,0,0,14
2020,50010,Castellina Marittima,PI,53,5,11,4,0,20,2,19,1,0,22
2020,50010,Castellina Marittima,PI,54,3,7,3,0,13,5,10,1,0,16
2020,50010,Castellina Marittima,PI,55,3,11,1,0,15,2,10,2,1,15
2020,50010,Castellina Marittima,PI,56,2,8,3,0,13,3,10,2,1,16
2020,50010,Castellina Marittima,PI,57,3,7,1,0,11,0,14,0,0,14
2020,50010,Castellina Marittima,PI,58,2,11,4,0,17,1,4,1,3,9
2020,50010,Castellina Marittima,PI,59,2,18,0,0,20,3,13,2,0,18
2020,50010,Castellina Marittima,PI,60,2,9,1,0,12,2,14,1,2,19
2020,50010,Castellina Marittima,PI,61,1,8,1,0,10,0,12,2,0,14
2020,50010,Castellina Marittima,PI,62,1,5,0,0,6,1,10,4,0,15
2020,50010,Castellina Marittima,PI,63,3,11,4,0,18,2,7,1,1,11
2020,50010,Castellina Marittima,PI,64,1,13,1,1,16,0,12,1,2,15
2020,50010,Castellina Marittima,PI,65,1,13,0,0,14,2,11,0,0,13
2020,50010,Castellina Marittima,PI,66,1,5,1,0,7,0,10,3,3,16
2020,50010,Castellina Marittima,PI,67,1,11,1,0,13,0,14,0,2,16
2020,50010,Castellina Marittima,PI,68,2,8,0,0,10,1,8,1,3,13
2020,50010,Castellina Marittima,PI,69,3,12,0,0,15,0,9,1,2,12
2020,50010,Castellina Marittima,PI,70,2,12,0,0,14,1,9,1,5,16
2020,50010,Castellina Marittima,PI,71,2,14,1,2,19,0,11,0,1,12
2020,50010,Castellina Marittima,PI,72,0,11,0,1,12,0,10,0,7,17
2020,50010,Castellina Marittima,PI,73,0,5,0,0,5,1,11,0,5,17
2020,50010,Castellina Marittima,PI,74,1,14,0,2,17,1,5,0,5,11
2020,50010,Castellina Marittima,PI,75,2,10,0,2,14,0,5,0,4,9
2020,50010,Castellina Marittima,PI,76,2,4,0,0,6,0,3,0,2,5
2020,50010,Castellina Marittima,PI,77,2,6,1,0,9,0,9,0,4,13
2020,50010,Castellina Marittima,PI,78,2,8,0,1,11,0,6,0,5,11
2020,50010,Castellina Marittima,PI,79,1,10,0,1,12,0,6,0,5,11
2020,50010,Castellina Marittima,PI,80,1,7,0,1,9,0,3,0,1,4
2020,50010,Castellina Marittima,PI,81,1,3,0,2,6,1,4,0,7,12
2020,50010,Castellina Marittima,PI,82,1,5,0,1,7,0,0,0,8,8
2020,50010,Castellina Marittima,PI,83,0,2,0,0,2,0,1,0,4,5
2020,50010,Castellina Marittima,PI,84,2,3,0,2,7,0,1,0,5,6
2020,50010,Castellina Marittima,PI,85,0,4,0,0,4,0,1,0,8,9
2020,50010,Castellina Marittima,PI,86,0,2,0,0,2,0,0,0,2,2
2020,50010,Castellina Marittima,PI,87,0,1,0,0,1,0,1,0,6,7
2020,50010,Castellina Marittima,PI,88,0,1,0,0,1,0,0,0,5,5
2020,50010,Castellina Marittima,PI,89,0,2,0,0,2,0,0,0,5,5
2020,50010,Castellina Marittima,PI,90,0,2,0,3,5,0,0,0,2,2
2020,50010,Castellina Marittima,PI,91,0,0,0,0,0,0,2,0,3,5
2020,50010,Castellina Marittima,PI,92,0,0,0,0,0,0,0,0,2,2
2020,50010,Castellina Marittima,PI,93,0,0,0,0,0,0,0,0,0,0
2020,50010,Castellina Marittima,PI,94,0,0,0,0,0,0,0,0,1,1
2020,50010,Castellina Marittima,PI,95,0,0,0,0,0,0,0,0,0,0
2020,50010,Castellina Marittima,PI,96,0,0,0,1,1,0,0,0,1,1
2020,50010,Castellina Marittima,PI,97,0,0,0,0,0,0,0,0,1,1
2020,50010,Castellina Marittima,PI,98,0,0,0,1,1,0,0,0,0,0
2020,50010,Castellina Marittima,PI,99,0,0,0,0,0,0,0,0,0,0
2020,50010,Castellina Marittima,PI,100 e più,0,0,0,0,0,0,0,0,1,1
2020,50011,Castelnuovo di Val di Cecina,PI,0,7,0,0,0,7,5,0,0,0,5
2020,50011,Castelnuovo di Val di Cecina,PI,1,10,0,0,0,10,5,0,0,0,5
2020,50011,Castelnuovo di Val di Cecina,PI,2,14,0,0,0,14,10,0,0,0,10
2020,50011,Castelnuovo di Val di Cecina,PI,3,6,0,0,0,6,8,0,0,0,8
2020,50011,Castelnuovo di Val di Cecina,PI,4,7,0,0,0,7,7,0,0,0,7
2020,50011,Castelnuovo di Val di Cecina,PI,5,9,0,0,0,9,11,0,0,0,11
2020,50011,Castelnuovo di Val di Cecina,PI,6,5,0,0,0,5,8,0,0,0,8
2020,50011,Castelnuovo di Val di Cecina,PI,7,16,0,0,0,16,8,0,0,0,8
2020,50011,Castelnuovo di Val di Cecina,PI,8,9,0,0,0,9,7,0,0,0,7
2020,50011,Castelnuovo di Val di Cecina,PI,9,6,0,0,0,6,15,0,0,0,15
2020,50011,Castelnuovo di Val di Cecina,PI,10,8,0,0,0,8,8,0,0,0,8
2020,50011,Castelnuovo di Val di Cecina,PI,11,13,0,0,0,13,5,0,0,0,5
2020,50011,Castelnuovo di Val di Cecina,PI,12,9,0,0,0,9,11,0,0,0,11
2020,50011,Castelnuovo di Val di Cecina,PI,13,8,0,0,0,8,8,0,0,0,8
2020,50011,Castelnuovo di Val di Cecina,PI,14,10,0,0,0,10,4,0,0,0,4
2020,50011,Castelnuovo di Val di Cecina,PI,15,3,0,0,0,3,13,0,0,0,13
2020,50011,Castelnuovo di Val di Cecina,PI,16,6,0,0,0,6,6,0,0,0,6
2020,50011,Castelnuovo di Val di Cecina,PI,17,11,0,0,0,11,9,0,0,0,9
2020,50011,Castelnuovo di Val di Cecina,PI,18,9,0,0,0,9,12,0,0,0,12
2020,50011,Castelnuovo di Val di Cecina,PI,19,13,0,0,0,13,8,0,0,0,8
2020,50011,Castelnuovo di Val di Cecina,PI,20,8,0,0,0,8,10,0,0,0,10
2020,50011,Castelnuovo di Val di Cecina,PI,21,13,0,0,0,13,6,1,0,0,7
2020,50011,Castelnuovo di Val di Cecina,PI,22,10,0,0,0,10,7,0,0,0,7
2020,50011,Castelnuovo di Val di Cecina,PI,23,5,0,0,0,5,8,1,0,0,9
2020,50011,Castelnuovo di Val di Cecina,PI,24,8,0,0,0,8,8,0,0,0,8
2020,50011,Castelnuovo di Val di Cecina,PI,25,10,0,0,0,10,4,1,0,0,5
2020,50011,Castelnuovo di Val di Cecina,PI,26,8,1,0,0,9,8,1,0,0,9
2020,50011,Castelnuovo di Val di Cecina,PI,27,9,1,0,0,10,7,6,0,0,13
2020,50011,Castelnuovo di Val di Cecina,PI,28,7,0,0,0,7,6,2,0,0,8
2020,50011,Castelnuovo di Val di Cecina,PI,29,17,1,0,0,18,7,1,0,0,8
2020,50011,Castelnuovo di Val di Cecina,PI,30,13,2,0,0,15,7,4,0,0,11
2020,50011,Castelnuovo di Val di Cecina,PI,31,5,3,0,0,8,10,7,0,0,17
2020,50011,Castelnuovo di Val di Cecina,PI,32,8,2,0,0,10,7,7,1,0,15
2020,50011,Castelnuovo di Val di Cecina,PI,33,9,2,0,0,11,7,4,1,0,12
2020,50011,Castelnuovo di Val di Cecina,PI,34,4,3,1,0,8,4,3,0,0,7
2020,50011,Castelnuovo di Val di Cecina,PI,35,8,6,0,0,14,9,1,0,0,10
2020,50011,Castelnuovo di Val di Cecina,PI,36,11,6,0,0,17,3,4,0,0,7
2020,50011,Castelnuovo di Val di Cecina,PI,37,6,5,1,0,12,6,5,0,1,12
2020,50011,Castelnuovo di Val di Cecina,PI,38,5,4,1,0,10,7,6,0,0,13
2020,50011,Castelnuovo di Val di Cecina,PI,39,7,7,0,0,14,3,8,0,0,11
2020,50011,Castelnuovo di Val di Cecina,PI,40,6,4,0,0,10,2,7,0,0,9
2020,50011,Castelnuovo di Val di Cecina,PI,41,6,6,0,0,12,0,9,0,0,9
2020,50011,Castelnuovo di Val di Cecina,PI,42,5,4,0,0,9,5,5,1,0,11
2020,50011,Castelnuovo di Val di Cecina,PI,43,4,5,0,0,9,3,7,0,0,10
2020,50011,Castelnuovo di Val di Cecina,PI,44,6,12,0,0,18,1,9,2,0,12
2020,50011,Castelnuovo di Val di Cecina,PI,45,7,11,0,0,18,2,3,1,0,6
2020,50011,Castelnuovo di Val di Cecina,PI,46,7,3,0,0,10,5,8,0,0,13
2020,50011,Castelnuovo di Val di Cecina,PI,47,6,8,0,0,14,9,9,2,1,21
2020,50011,Castelnuovo di Val di Cecina,PI,48,5,4,0,0,9,4,8,0,0,12
2020,50011,Castelnuovo di Val di Cecina,PI,49,4,2,4,0,10,5,8,1,1,15
2020,50011,Castelnuovo di Val di Cecina,PI,50,7,13,0,1,21,2,7,0,0,9
2020,50011,Castelnuovo di Val di Cecina,PI,51,3,9,1,0,13,6,9,1,1,17
2020,50011,Castelnuovo di Val di Cecina,PI,52,4,8,1,0,13,4,6,0,1,11
2020,50011,Castelnuovo di Val di Cecina,PI,53,6,6,1,0,13,3,7,1,1,12
2020,50011,Castelnuovo di Val di Cecina,PI,54,2,6,0,0,8,3,12,1,1,17
2020,50011,Castelnuovo di Val di Cecina,PI,55,3,10,1,0,14,4,9,4,0,17
2020,50011,Castelnuovo di Val di Cecina,PI,56,3,9,0,1,13,2,9,1,0,12
2020,50011,Castelnuovo di Val di Cecina,PI,57,6,8,0,0,14,3,11,1,2,17
2020,50011,Castelnuovo di Val di Cecina,PI,58,3,9,1,0,13,8,12,1,2,23
2020,50011,Castelnuovo di Val di Cecina,PI,59,1,12,1,1,15,3,8,2,0,13
2020,50011,Castelnuovo di Val di Cecina,PI,60,0,11,3,0,14,2,12,0,1,15
2020,50011,Castelnuovo di Val di Cecina,PI,61,1,7,2,0,10,3,14,2,1,20
2020,50011,Castelnuovo di Val di Cecina,PI,62,0,6,0,1,7,3,13,0,1,17
2020,50011,Castelnuovo di Val di Cecina,PI,63,2,10,1,1,14,2,8,0,3,13
2020,50011,Castelnuovo di Val di Cecina,PI,64,3,16,1,1,21,1,13,0,2,16
2020,50011,Castelnuovo di Val di Cecina,PI,65,1,16,1,0,18,1,13,0,1,15
2020,50011,Castelnuovo di Val di Cecina,PI,66,2,16,0,1,19,0,9,0,1,10
2020,50011,Castelnuovo di Val di Cecina,PI,67,1,11,0,1,13,3,9,2,0,14
2020,50011,Castelnuovo di Val di Cecina,PI,68,0,13,2,0,15,2,15,2,2,21
2020,50011,Castelnuovo di Val di Cecina,PI,69,4,8,1,0,13,1,12,0,2,15
2020,50011,Castelnuovo di Val di Cecina,PI,70,3,9,1,1,14,0,12,0,2,14
2020,50011,Castelnuovo di Val di Cecina,PI,71,3,19,2,0,24,0,6,1,2,9
2020,50011,Castelnuovo di Val di Cecina,PI,72,0,16,0,3,19,1,8,1,4,14
2020,50011,Castelnuovo di Val di Cecina,PI,73,2,11,2,0,15,0,10,1,5,16
2020,50011,Castelnuovo di Val di Cecina,PI,74,3,11,0,3,17,2,8,0,2,12
2020,50011,Castelnuovo di Val di Cecina,PI,75,1,8,2,0,11,1,7,0,1,9
2020,50011,Castelnuovo di Val di Cecina,PI,76,1,9,1,0,11,0,12,0,6,18
2020,50011,Castelnuovo di Val di Cecina,PI,77,0,7,0,1,8,0,7,0,9,16
2020,50011,Castelnuovo di Val di Cecina,PI,78,1,7,1,1,10,0,7,1,1,9
2020,50011,Castelnuovo di Val di Cecina,PI,79,3,9,0,1,13,0,8,0,11,19
2020,50011,Castelnuovo di Val di Cecina,PI,80,0,9,1,1,11,1,4,0,5,10
2020,50011,Castelnuovo di Val di Cecina,PI,81,2,13,0,0,15,2,12,0,8,22
2020,50011,Castelnuovo di Val di Cecina,PI,82,0,12,0,1,13,0,8,0,5,13
2020,50011,Castelnuovo di Val di Cecina,PI,83,2,5,0,3,10,0,4,0,9,13
2020,50011,Castelnuovo di Val di Cecina,PI,84,0,4,0,3,7,0,5,2,4,11
2020,50011,Castelnuovo di Val di Cecina,PI,85,1,8,0,1,10,0,2,0,6,8
2020,50011,Castelnuovo di Val di Cecina,PI,86,0,9,0,1,10,1,0,0,3,4
2020,50011,Castelnuovo di Val di Cecina,PI,87,2,4,0,0,6,0,3,2,5,10
2020,50011,Castelnuovo di Val di Cecina,PI,88,1,1,0,2,4,0,0,0,3,3
2020,50011,Castelnuovo di Val di Cecina,PI,89,0,4,0,2,6,1,1,0,7,9
2020,50011,Castelnuovo di Val di Cecina,PI,90,0,6,0,3,9,0,0,0,11,11
2020,50011,Castelnuovo di Val di Cecina,PI,91,0,0,0,0,0,0,3,0,3,6
2020,50011,Castelnuovo di Val di Cecina,PI,92,0,1,0,3,4,0,1,0,5,6
2020,50011,Castelnuovo di Val di Cecina,PI,93,0,2,0,1,3,1,1,0,6,8
2020,50011,Castelnuovo di Val di Cecina,PI,94,0,0,0,1,1,0,0,0,7,7
2020,50011,Castelnuovo di Val di Cecina,PI,95,0,1,0,0,1,0,0,0,2,2
2020,50011,Castelnuovo di Val di Cecina,PI,96,0,1,0,1,2,0,0,0,0,0
2020,50011,Castelnuovo di Val di Cecina,PI,97,0,0,0,0,0,0,0,0,1,1
2020,50011,Castelnuovo di Val di Cecina,PI,98,0,0,0,0,0,0,0,0,1,1
2020,50011,Castelnuovo di Val di Cecina,PI,99,0,0,0,0,0,0,0,0,0,0
2020,50011,Castelnuovo di Val di Cecina,PI,100 e più,0,0,0,0,0,0,0,0,1,1
2020,50012,Chianni,PI,0,5,0,0,0,5,2,0,0,0,2
2020,50012,Chianni,PI,1,1,0,0,0,1,3,0,0,0,3
2020,50012,Chianni,PI,2,4,0,0,0,4,2,0,0,0,2
2020,50012,Chianni,PI,3,3,0,0,0,3,3,0,0,0,3
2020,50012,Chianni,PI,4,7,0,0,0,7,4,0,0,0,4
2020,50012,Chianni,PI,5,7,0,0,0,7,2,0,0,0,2
2020,50012,Chianni,PI,6,5,0,0,0,5,3,0,0,0,3
2020,50012,Chianni,PI,7,7,0,0,0,7,3,0,0,0,3
2020,50012,Chianni,PI,8,2,0,0,0,2,1,0,0,0,1
2020,50012,Chianni,PI,9,4,0,0,0,4,2,0,0,0,2
2020,50012,Chianni,PI,10,6,0,0,0,6,1,0,0,0,1
2020,50012,Chianni,PI,11,2,0,0,0,2,5,0,0,0,5
2020,50012,Chianni,PI,12,5,0,0,0,5,6,0,0,0,6
2020,50012,Chianni,PI,13,5,0,0,0,5,3,0,0,0,3
2020,50012,Chianni,PI,14,8,0,0,0,8,4,0,0,0,4
2020,50012,Chianni,PI,15,8,0,0,0,8,8,0,0,0,8
2020,50012,Chianni,PI,16,8,0,0,0,8,1,0,0,0,1
2020,50012,Chianni,PI,17,7,0,0,0,7,5,0,0,0,5
2020,50012,Chianni,PI,18,7,0,0,0,7,5,0,0,0,5
2020,50012,Chianni,PI,19,7,0,0,0,7,4,0,0,0,4
2020,50012,Chianni,PI,20,5,0,0,0,5,4,0,0,0,4
2020,50012,Chianni,PI,21,6,0,0,0,6,6,0,0,0,6
2020,50012,Chianni,PI,22,7,0,0,0,7,5,0,0,0,5
2020,50012,Chianni,PI,23,5,0,0,0,5,7,0,0,0,7
2020,50012,Chianni,PI,24,7,0,0,0,7,10,0,0,0,10
2020,50012,Chianni,PI,25,8,0,0,0,8,5,0,0,0,5
2020,50012,Chianni,PI,26,3,0,0,0,3,3,0,0,0,3
2020,50012,Chianni,PI,27,4,0,0,0,4,2,1,0,0,3
2020,50012,Chianni,PI,28,3,1,0,0,4,8,0,0,0,8
2020,50012,Chianni,PI,29,6,1,0,0,7,2,1,0,0,3
2020,50012,Chianni,PI,30,4,0,0,0,4,3,2,0,0,5
2020,50012,Chianni,PI,31,3,0,0,0,3,2,2,0,0,4
2020,50012,Chianni,PI,32,7,0,0,0,7,5,1,1,0,7
2020,50012,Chianni,PI,33,4,1,0,0,5,1,0,0,0,1
2020,50012,Chianni,PI,34,5,0,0,0,5,2,3,2,0,7
2020,50012,Chianni,PI,35,5,1,0,0,6,2,4,0,1,7
2020,50012,Chianni,PI,36,4,2,0,0,6,4,1,0,0,5
2020,50012,Chianni,PI,37,1,1,0,0,2,3,2,0,0,5
2020,50012,Chianni,PI,38,6,3,1,0,10,4,4,0,0,8
2020,50012,Chianni,PI,39,7,2,0,0,9,4,2,1,0,7
2020,50012,Chianni,PI,40,7,1,0,0,8,1,4,0,0,5
2020,50012,Chianni,PI,41,3,2,0,0,5,2,6,0,0,8
2020,50012,Chianni,PI,42,3,3,0,0,6,1,6,1,0,8
2020,50012,Chianni,PI,43,3,3,0,0,6,5,4,0,0,9
2020,50012,Chianni,PI,44,1,4,0,0,5,1,9,0,0,10
2020,50012,Chianni,PI,45,6,6,1,0,13,1,7,0,0,8
2020,50012,Chianni,PI,46,3,8,1,0,12,5,5,0,0,10
2020,50012,Chianni,PI,47,5,10,0,0,15,1,5,0,0,6
2020,50012,Chianni,PI,48,7,5,1,0,13,2,4,0,0,6
2020,50012,Chianni,PI,49,6,9,1,0,16,2,6,0,0,8
2020,50012,Chianni,PI,50,2,4,0,0,6,1,7,1,0,9
2020,50012,Chianni,PI,51,3,6,0,1,10,2,9,1,0,12
2020,50012,Chianni,PI,52,2,13,0,0,15,0,8,3,0,11
2020,50012,Chianni,PI,53,6,6,0,1,13,3,9,0,0,12
2020,50012,Chianni,PI,54,0,5,0,0,5,2,12,0,0,14
2020,50012,Chianni,PI,55,2,12,3,0,17,2,3,0,0,5
2020,50012,Chianni,PI,56,2,7,3,0,12,2,5,0,1,8
2020,50012,Chianni,PI,57,2,4,1,0,7,3,6,1,1,11
2020,50012,Chianni,PI,58,1,8,2,0,11,0,5,1,1,7
2020,50012,Chianni,PI,59,1,9,0,0,10,1,7,1,0,9
2020,50012,Chianni,PI,60,2,6,2,1,11,5,14,0,1,20
2020,50012,Chianni,PI,61,2,4,3,0,9,1,8,0,1,10
2020,50012,Chianni,PI,62,4,7,1,1,13,1,8,0,1,10
2020,50012,Chianni,PI,63,0,11,1,0,12,2,8,0,0,10
2020,50012,Chianni,PI,64,2,5,0,0,7,1,13,0,0,14
2020,50012,Chianni,PI,65,1,8,2,2,13,4,3,2,2,11
2020,50012,Chianni,PI,66,1,7,0,0,8,1,6,1,2,10
2020,50012,Chianni,PI,67,1,9,1,0,11,0,10,1,0,11
2020,50012,Chianni,PI,68,3,11,1,1,16,1,6,0,2,9
2020,50012,Chianni,PI,69,3,5,1,0,9,1,5,2,4,12
2020,50012,Chianni,PI,70,1,5,1,1,8,1,8,0,1,10
2020,50012,Chianni,PI,71,0,10,0,0,10,0,4,0,3,7
2020,50012,Chianni,PI,72,0,14,0,0,14,0,6,0,2,8
2020,50012,Chianni,PI,73,1,8,0,1,10,1,9,0,3,13
2020,50012,Chianni,PI,74,1,6,1,0,8,0,10,1,2,13
2020,50012,Chianni,PI,75,0,7,0,0,7,0,2,0,3,5
2020,50012,Chianni,PI,76,1,6,0,1,8,0,3,1,3,7
2020,50012,Chianni,PI,77,0,5,0,0,5,0,8,0,4,12
2020,50012,Chianni,PI,78,1,3,0,2,6,0,1,0,5,6
2020,50012,Chianni,PI,79,0,4,0,0,4,1,6,0,5,12
2020,50012,Chianni,PI,80,0,4,0,0,4,0,2,0,5,7
2020,50012,Chianni,PI,81,1,5,0,1,7,0,3,0,6,9
2020,50012,Chianni,PI,82,0,4,0,0,4,0,2,0,12,14
2020,50012,Chianni,PI,83,0,5,0,1,6,0,5,0,4,9
2020,50012,Chianni,PI,84,1,4,0,0,5,0,0,0,6,6
2020,50012,Chianni,PI,85,2,3,0,2,7,0,0,0,5,5
2020,50012,Chianni,PI,86,0,2,0,2,4,0,0,0,7,7
2020,50012,Chianni,PI,87,0,0,0,2,2,0,1,0,3,4
2020,50012,Chianni,PI,88,0,0,0,0,0,0,0,0,4,4
2020,50012,Chianni,PI,89,1,2,0,2,5,0,1,0,3,4
2020,50012,Chianni,PI,90,0,0,0,2,2,0,0,0,4,4
2020,50012,Chianni,PI,91,0,0,0,0,0,0,0,0,5,5
2020,50012,Chianni,PI,92,0,1,0,0,1,0,0,0,3,3
2020,50012,Chianni,PI,93,0,0,0,0,0,0,1,0,2,3
2020,50012,Chianni,PI,94,0,0,0,1,1,0,0,0,1,1
2020,50012,Chianni,PI,95,0,0,0,0,0,0,0,0,0,0
2020,50012,Chianni,PI,96,0,1,0,0,1,0,0,0,1,1
2020,50012,Chianni,PI,97,0,0,0,1,1,1,0,0,1,2
2020,50012,Chianni,PI,98,1,0,0,0,1,0,0,0,0,0
2020,50012,Chianni,PI,99,0,0,0,0,0,0,0,0,1,1
2020,50012,Chianni,PI,100 e più,0,0,0,0,0,0,0,0,0,0
2020,50014,Fauglia,PI,0,19,0,0,0,19,10,0,0,0,10
2020,50014,Fauglia,PI,1,6,0,0,0,6,7,0,0,0,7
2020,50014,Fauglia,PI,2,11,0,0,0,11,10,0,0,0,10
2020,50014,Fauglia,PI,3,7,0,0,0,7,13,0,0,0,13
2020,50014,Fauglia,PI,4,17,0,0,0,17,13,0,0,0,13
2020,50014,Fauglia,PI,5,19,0,0,0,19,12,0,0,0,12
2020,50014,Fauglia,PI,6,13,0,0,0,13,14,0,0,0,14
2020,50014,Fauglia,PI,7,13,0,0,0,13,16,0,0,0,16
2020,50014,Fauglia,PI,8,17,0,0,0,17,13,0,0,0,13
2020,50014,Fauglia,PI,9,17,0,0,0,17,13,0,0,0,13
2020,50014,Fauglia,PI,10,18,0,0,0,18,11,0,0,0,11
2020,50014,Fauglia,PI,11,15,0,0,0,15,9,0,0,0,9
2020,50014,Fauglia,PI,12,19,0,0,0,19,14,0,0,0,14
2020,50014,Fauglia,PI,13,25,0,0,0,25,22,0,0,0,22
2020,50014,Fauglia,PI,14,12,0,0,0,12,13,0,0,0,13
2020,50014,Fauglia,PI,15,13,0,0,0,13,20,0,0,0,20
2020,50014,Fauglia,PI,16,16,0,0,0,16,16,0,0,0,16
2020,50014,Fauglia,PI,17,18,0,0,0,18,21,0,0,0,21
2020,50014,Fauglia,PI,18,16,0,0,0,16,12,0,0,0,12
2020,50014,Fauglia,PI,19,11,0,0,0,11,19,0,0,0,19
2020,50014,Fauglia,PI,20,14,0,0,0,14,18,0,0,0,18
2020,50014,Fauglia,PI,21,12,0,0,0,12,17,0,0,0,17
2020,50014,Fauglia,PI,22,24,0,0,0,24,14,0,0,0,14
2020,50014,Fauglia,PI,23,12,0,0,0,12,7,2,0,0,9
2020,50014,Fauglia,PI,24,15,0,0,0,15,9,1,0,0,10
2020,50014,Fauglia,PI,25,15,0,0,0,15,11,0,0,0,11
2020,50014,Fauglia,PI,26,10,0,0,0,10,10,0,0,0,10
2020,50014,Fauglia,PI,27,23,0,0,0,23,12,1,0,0,13
2020,50014,Fauglia,PI,28,12,0,0,0,12,15,5,0,0,20
2020,50014,Fauglia,PI,29,12,0,0,0,12,10,0,0,0,10
2020,50014,Fauglia,PI,30,16,2,0,0,18,14,1,0,0,15
2020,50014,Fauglia,PI,31,14,3,0,0,17,11,5,0,0,16
2020,50014,Fauglia,PI,32,13,1,0,0,14,15,9,0,0,24
2020,50014,Fauglia,PI,33,16,5,0,0,21,7,3,0,0,10
2020,50014,Fauglia,PI,34,10,7,1,0,18,9,8,0,0,17
2020,50014,Fauglia,PI,35,12,8,0,0,20,14,5,1,0,20
2020,50014,Fauglia,PI,36,18,5,0,0,23,8,13,1,0,22
2020,50014,Fauglia,PI,37,17,4,0,0,21,8,10,2,0,20
2020,50014,Fauglia,PI,38,10,13,0,0,23,14,17,0,0,31
2020,50014,Fauglia,PI,39,13,8,0,0,21,4,9,1,0,14
2020,50014,Fauglia,PI,40,12,9,1,0,22,10,19,1,0,30
2020,50014,Fauglia,PI,41,9,11,0,0,20,9,11,1,0,21
2020,50014,Fauglia,PI,42,10,15,0,0,25,14,15,1,0,30
2020,50014,Fauglia,PI,43,9,12,0,0,21,8,19,1,0,28
2020,50014,Fauglia,PI,44,17,17,1,0,35,3,22,1,0,26
2020,50014,Fauglia,PI,45,11,23,0,0,34,8,22,1,1,32
2020,50014,Fauglia,PI,46,7,15,1,0,23,5,19,4,0,28
2020,50014,Fauglia,PI,47,9,25,1,0,35,11,24,0,0,35
2020,50014,Fauglia,PI,48,11,22,3,0,36,7,23,3,0,33
2020,50014,Fauglia,PI,49,11,17,1,0,29,9,13,2,0,24
2020,50014,Fauglia,PI,50,5,21,0,0,26,7,16,3,0,26
2020,50014,Fauglia,PI,51,11,23,2,0,36,5,17,2,0,24
2020,50014,Fauglia,PI,52,8,21,2,1,32,5,31,3,1,40
2020,50014,Fauglia,PI,53,6,22,3,0,31,3,26,3,1,33
2020,50014,Fauglia,PI,54,6,23,2,0,31,6,19,1,1,27
2020,50014,Fauglia,PI,55,3,21,0,0,24,6,15,0,1,22
2020,50014,Fauglia,PI,56,9,22,1,0,32,4,32,3,0,39
2020,50014,Fauglia,PI,57,6,23,0,0,29,5,27,1,1,34
2020,50014,Fauglia,PI,58,6,11,3,1,21,3,14,2,1,20
2020,50014,Fauglia,PI,59,7,23,3,0,33,3,26,2,1,32
2020,50014,Fauglia,PI,60,1,17,1,0,19,2,23,0,1,26
2020,50014,Fauglia,PI,61,5,23,0,0,28,3,24,1,1,29
2020,50014,Fauglia,PI,62,1,17,2,1,21,4,23,1,2,30
2020,50014,Fauglia,PI,63,4,15,1,1,21,6,26,2,3,37
2020,50014,Fauglia,PI,64,2,24,0,0,26,2,23,1,3,29
2020,50014,Fauglia,PI,65,2,25,1,0,28,3,27,2,3,35
2020,50014,Fauglia,PI,66,4,30,1,0,35,2,21,1,2,26
2020,50014,Fauglia,PI,67,4,27,1,0,32,1,19,1,3,24
2020,50014,Fauglia,PI,68,2,24,1,0,27,2,17,0,4,23
2020,50014,Fauglia,PI,69,3,23,0,0,26,1,17,1,2,21
2020,50014,Fauglia,PI,70,1,20,0,3,24,2,19,0,3,24
2020,50014,Fauglia,PI,71,0,14,1,1,16,4,13,1,1,19
2020,50014,Fauglia,PI,72,2,26,1,1,30,1,16,2,1,20
2020,50014,Fauglia,PI,73,3,18,0,1,22,3,22,2,4,31
2020,50014,Fauglia,PI,74,2,30,1,1,34,1,9,1,7,18
2020,50014,Fauglia,PI,75,2,15,0,2,19,0,14,1,6,21
2020,50014,Fauglia,PI,76,4,13,0,3,20,1,15,0,3,19
2020,50014,Fauglia,PI,77,1,11,0,1,13,0,7,0,5,12
2020,50014,Fauglia,PI,78,0,13,0,1,14,2,12,2,5,21
2020,50014,Fauglia,PI,79,0,9,2,2,13,0,7,0,5,12
2020,50014,Fauglia,PI,80,1,8,2,0,11,1,9,0,7,17
2020,50014,Fauglia,PI,81,1,11,0,3,15,0,10,0,10,20
2020,50014,Fauglia,PI,82,0,11,0,1,12,0,8,0,7,15
2020,50014,Fauglia,PI,83,0,9,0,1,10,2,1,0,8,11
2020,50014,Fauglia,PI,84,1,9,0,3,13,1,2,0,5,8
2020,50014,Fauglia,PI,85,1,10,0,3,14,0,5,0,11,16
2020,50014,Fauglia,PI,86,1,4,0,2,7,1,3,0,10,14
2020,50014,Fauglia,PI,87,2,4,0,0,6,2,2,0,12,16
2020,50014,Fauglia,PI,88,1,3,0,2,6,0,5,0,8,13
2020,50014,Fauglia,PI,89,0,0,0,0,0,0,2,0,7,9
2020,50014,Fauglia,PI,90,0,2,0,1,3,0,0,0,6,6
2020,50014,Fauglia,PI,91,1,3,0,2,6,0,2,0,9,11
2020,50014,Fauglia,PI,92,1,0,0,0,1,0,0,0,8,8
2020,50014,Fauglia,PI,93,1,2,0,0,3,0,0,0,3,3
2020,50014,Fauglia,PI,94,0,1,0,1,2,1,0,0,1,2
2020,50014,Fauglia,PI,95,0,1,0,0,1,0,0,0,5,5
2020,50014,Fauglia,PI,96,0,1,0,0,1,0,0,0,4,4
2020,50014,Fauglia,PI,97,0,0,0,0,0,0,0,0,4,4
2020,50014,Fauglia,PI,98,0,0,0,0,0,1,0,0,1,2
2020,50014,Fauglia,PI,99,0,0,0,0,0,0,0,0,0,0
2020,50014,Fauglia,PI,100 e più,0,0,0,0,0,0,0,0,2,2
2020,50015,Guardistallo,PI,0,5,0,0,0,5,2,0,0,0,2
2020,50015,Guardistallo,PI,1,3,0,0,0,3,0,0,0,0,0
2020,50015,Guardistallo,PI,2,2,0,0,0,2,2,0,0,0,2
2020,50015,Guardistallo,PI,3,5,0,0,0,5,3,0,0,0,3
2020,50015,Guardistallo,PI,4,6,0,0,0,6,4,0,0,0,4
2020,50015,Guardistallo,PI,5,3,0,0,0,3,2,0,0,0,2
2020,50015,Guardistallo,PI,6,4,0,0,0,4,4,0,0,0,4
2020,50015,Guardistallo,PI,7,8,0,0,0,8,6,0,0,0,6
2020,50015,Guardistallo,PI,8,5,0,0,0,5,2,0,0,0,2
2020,50015,Guardistallo,PI,9,5,0,0,0,5,2,0,0,0,2
2020,50015,Guardistallo,PI,10,2,0,0,0,2,5,0,0,0,5
2020,50015,Guardistallo,PI,11,7,0,0,0,7,4,0,0,0,4
2020,50015,Guardistallo,PI,12,6,0,0,0,6,4,0,0,0,4
2020,50015,Guardistallo,PI,13,6,0,0,0,6,8,0,0,0,8
2020,50015,Guardistallo,PI,14,5,0,0,0,5,2,0,0,0,2
2020,50015,Guardistallo,PI,15,3,0,0,0,3,4,0,0,0,4
2020,50015,Guardistallo,PI,16,3,0,0,0,3,2,0,0,0,2
2020,50015,Guardistallo,PI,17,3,0,0,0,3,5,0,0,0,5
2020,50015,Guardistallo,PI,18,1,0,0,0,1,3,0,0,0,3
2020,50015,Guardistallo,PI,19,3,0,0,0,3,2,0,0,0,2
2020,50015,Guardistallo,PI,20,6,0,0,0,6,6,0,0,0,6
2020,50015,Guardistallo,PI,21,4,0,0,0,4,5,0,0,0,5
2020,50015,Guardistallo,PI,22,7,0,0,0,7,5,0,0,0,5
2020,50015,Guardistallo,PI,23,5,0,0,0,5,5,0,0,0,5
2020,50015,Guardistallo,PI,24,8,0,0,0,8,6,1,0,0,7
2020,50015,Guardistallo,PI,25,6,0,0,0,6,5,0,0,0,5
2020,50015,Guardistallo,PI,26,4,1,0,0,5,5,2,0,0,7
2020,50015,Guardistallo,PI,27,6,0,0,0,6,5,1,0,0,6
2020,50015,Guardistallo,PI,28,4,1,0,0,5,5,0,0,0,5
2020,50015,Guardistallo,PI,29,8,2,0,0,10,2,0,0,0,2
2020,50015,Guardistallo,PI,30,7,0,0,0,7,9,2,0,0,11
2020,50015,Guardistallo,PI,31,1,1,0,0,2,3,0,0,0,3
2020,50015,Guardistallo,PI,32,3,1,0,0,4,3,4,0,0,7
2020,50015,Guardistallo,PI,33,7,1,0,0,8,3,1,0,0,4
2020,50015,Guardistallo,PI,34,4,0,0,0,4,3,3,0,0,6
2020,50015,Guardistallo,PI,35,5,3,0,0,8,3,2,0,0,5
2020,50015,Guardistallo,PI,36,3,1,0,0,4,5,4,0,0,9
2020,50015,Guardistallo,PI,37,1,1,0,0,2,4,1,0,0,5
2020,50015,Guardistallo,PI,38,4,2,0,0,6,0,2,0,0,2
2020,50015,Guardistallo,PI,39,3,5,0,0,8,4,4,0,0,8
2020,50015,Guardistallo,PI,40,4,4,0,0,8,2,5,0,0,7
2020,50015,Guardistallo,PI,41,6,4,0,0,10,2,6,0,0,8
2020,50015,Guardistallo,PI,42,2,4,0,0,6,2,3,1,0,6
2020,50015,Guardistallo,PI,43,4,1,2,0,7,2,2,0,0,4
2020,50015,Guardistallo,PI,44,3,3,0,0,6,1,9,1,1,12
2020,50015,Guardistallo,PI,45,5,3,1,0,9,4,9,1,0,14
2020,50015,Guardistallo,PI,46,5,6,0,0,11,4,3,0,0,7
2020,50015,Guardistallo,PI,47,4,2,0,0,6,4,3,5,0,12
2020,50015,Guardistallo,PI,48,6,4,0,0,10,1,3,0,1,5
2020,50015,Guardistallo,PI,49,5,6,0,1,12,3,6,0,0,9
2020,50015,Guardistallo,PI,50,2,8,0,2,12,6,8,0,0,14
2020,50015,Guardistallo,PI,51,0,6,1,0,7,0,3,0,0,3
2020,50015,Guardistallo,PI,52,0,3,0,0,3,0,9,2,0,11
2020,50015,Guardistallo,PI,53,1,8,0,0,9,4,6,1,0,11
2020,50015,Guardistallo,PI,54,4,8,2,0,14,2,3,1,0,6
2020,50015,Guardistallo,PI,55,1,8,2,0,11,3,6,1,0,10
2020,50015,Guardistallo,PI,56,1,9,1,0,11,2,9,2,0,13
2020,50015,Guardistallo,PI,57,0,2,0,0,2,2,6,1,1,10
2020,50015,Guardistallo,PI,58,0,5,0,1,6,2,6,1,0,9
2020,50015,Guardistallo,PI,59,0,5,2,0,7,2,5,1,2,10
2020,50015,Guardistallo,PI,60,1,5,3,1,10,1,6,1,0,8
2020,50015,Guardistallo,PI,61,2,7,1,0,10,1,5,1,2,9
2020,50015,Guardistallo,PI,62,3,7,0,0,10,3,8,0,0,11
2020,50015,Guardistallo,PI,63,1,10,1,0,12,1,6,0,0,7
2020,50015,Guardistallo,PI,64,2,9,3,2,16,4,6,3,1,14
2020,50015,Guardistallo,PI,65,0,10,1,0,11,2,3,0,0,5
2020,50015,Guardistallo,PI,66,2,4,0,0,6,1,9,0,3,13
2020,50015,Guardistallo,PI,67,0,5,0,1,6,1,7,1,1,10
2020,50015,Guardistallo,PI,68,1,8,0,0,9,1,6,0,1,8
2020,50015,Guardistallo,PI,69,0,5,0,0,5,1,2,1,0,4
2020,50015,Guardistallo,PI,70,0,6,0,0,6,2,6,0,3,11
2020,50015,Guardistallo,PI,71,0,2,0,0,2,2,12,0,1,15
2020,50015,Guardistallo,PI,72,2,8,0,2,12,2,3,1,2,8
2020,50015,Guardistallo,PI,73,0,9,0,0,9,2,5,0,0,7
2020,50015,Guardistallo,PI,74,1,4,0,1,6,2,4,0,1,7
2020,50015,Guardistallo,PI,75,0,3,0,1,4,1,4,0,3,8
2020,50015,Guardistallo,PI,76,0,6,0,0,6,2,2,0,3,7
2020,50015,Guardistallo,PI,77,1,9,0,0,10,0,2,2,1,5
2020,50015,Guardistallo,PI,78,0,1,0,0,1,0,5,0,1,6
2020,50015,Guardistallo,PI,79,3,4,0,1,8,2,0,0,4,6
2020,50015,Guardistallo,PI,80,0,3,0,3,6,1,1,0,6,8
2020,50015,Guardistallo,PI,81,0,2,0,0,2,2,3,0,1,6
2020,50015,Guardistallo,PI,82,0,1,0,1,2,1,2,0,4,7
2020,50015,Guardistallo,PI,83,0,4,0,0,4,2,1,0,4,7
2020,50015,Guardistallo,PI,84,0,2,0,0,2,0,0,0,2,2
2020,50015,Guardistallo,PI,85,0,2,0,1,3,0,2,0,3,5
2020,50015,Guardistallo,PI,86,0,1,0,0,1,1,3,0,5,9
2020,50015,Guardistallo,PI,87,0,0,0,1,1,1,3,0,2,6
2020,50015,Guardistallo,PI,88,0,1,0,0,1,0,2,0,1,3
2020,50015,Guardistallo,PI,89,0,2,0,0,2,0,0,0,6,6
2020,50015,Guardistallo,PI,90,0,1,0,1,2,1,0,0,4,5
2020,50015,Guardistallo,PI,91,0,2,0,1,3,0,1,0,2,3
2020,50015,Guardistallo,PI,92,0,4,0,0,4,0,0,0,1,1
2020,50015,Guardistallo,PI,93,0,0,0,0,0,1,0,0,2,3
2020,50015,Guardistallo,PI,94,0,0,0,0,0,0,0,0,1,1
2020,50015,Guardistallo,PI,95,0,0,0,1,1,1,0,0,2,3
2020,50015,Guardistallo,PI,96,1,0,0,0,1,0,0,0,2,2
2020,50015,Guardistallo,PI,97,0,1,0,0,1,0,0,0,0,0
2020,50015,Guardistallo,PI,98,0,0,0,0,0,0,0,0,0,0
2020,50015,Guardistallo,PI,99,0,0,0,0,0,0,0,0,0,0
2020,50015,Guardistallo,PI,100 e più,0,0,0,0,0,0,0,0,0,0
2020,50016,Lajatico,PI,0,7,0,0,0,7,2,0,0,0,2
2020,50016,Lajatico,PI,1,3,0,0,0,3,2,0,0,0,2
2020,50016,Lajatico,PI,2,0,0,0,0,0,4,0,0,0,4
2020,50016,Lajatico,PI,3,1,0,0,0,1,2,0,0,0,2
2020,50016,Lajatico,PI,4,3,0,0,0,3,2,0,0,0,2
2020,50016,Lajatico,PI,5,4,0,0,0,4,7,0,0,0,7
2020,50016,Lajatico,PI,6,4,0,0,0,4,1,0,0,0,1
2020,50016,Lajatico,PI,7,6,0,0,0,6,6,0,0,0,6
2020,50016,Lajatico,PI,8,6,0,0,0,6,3,0,0,0,3
2020,50016,Lajatico,PI,9,4,0,0,0,4,5,0,0,0,5
2020,50016,Lajatico,PI,10,6,0,0,0,6,6,0,0,0,6
2020,50016,Lajatico,PI,11,5,0,0,0,5,4,0,0,0,4
2020,50016,Lajatico,PI,12,5,0,0,0,5,8,0,0,0,8
2020,50016,Lajatico,PI,13,7,0,0,0,7,9,0,0,0,9
2020,50016,Lajatico,PI,14,3,0,0,0,3,3,0,0,0,3
2020,50016,Lajatico,PI,15,7,0,0,0,7,4,0,0,0,4
2020,50016,Lajatico,PI,16,8,0,0,0,8,4,0,0,0,4
2020,50016,Lajatico,PI,17,4,0,0,0,4,3,0,0,0,3
2020,50016,Lajatico,PI,18,8,0,0,0,8,5,0,0,0,5
2020,50016,Lajatico,PI,19,6,0,0,0,6,5,0,0,0,5
2020,50016,Lajatico,PI,20,4,0,0,0,4,7,0,0,0,7
2020,50016,Lajatico,PI,21,10,0,0,0,10,3,0,0,0,3
2020,50016,Lajatico,PI,22,12,0,0,0,12,5,0,0,0,5
2020,50016,Lajatico,PI,23,4,0,0,0,4,7,0,0,0,7
2020,50016,Lajatico,PI,24,7,0,0,0,7,2,0,0,0,2
2020,50016,Lajatico,PI,25,10,0,0,0,10,3,0,0,0,3
2020,50016,Lajatico,PI,26,8,0,0,0,8,3,0,0,0,3
2020,50016,Lajatico,PI,27,5,0,0,0,5,6,0,0,0,6
2020,50016,Lajatico,PI,28,4,0,0,0,4,5,0,0,0,5
2020,50016,Lajatico,PI,29,3,0,0,0,3,5,0,0,0,5
2020,50016,Lajatico,PI,30,2,0,0,0,2,3,1,0,0,4
2020,50016,Lajatico,PI,31,3,2,0,0,5,4,1,0,0,5
2020,50016,Lajatico,PI,32,4,0,0,0,4,3,2,0,0,5
2020,50016,Lajatico,PI,33,3,1,0,0,4,5,1,0,0,6
2020,50016,Lajatico,PI,34,5,1,0,0,6,3,6,0,0,9
2020,50016,Lajatico,PI,35,1,0,0,0,1,1,4,0,0,5
2020,50016,Lajatico,PI,36,4,4,0,0,8,2,5,0,0,7
2020,50016,Lajatico,PI,37,1,1,0,0,2,1,3,1,0,5
2020,50016,Lajatico,PI,38,2,5,0,0,7,4,3,0,0,7
2020,50016,Lajatico,PI,39,3,2,0,0,5,4,3,0,0,7
2020,50016,Lajatico,PI,40,3,2,0,0,5,1,2,0,0,3
2020,50016,Lajatico,PI,41,1,4,1,0,6,2,1,0,0,3
2020,50016,Lajatico,PI,42,3,3,0,0,6,2,5,0,0,7
2020,50016,Lajatico,PI,43,9,4,0,0,13,6,5,0,0,11
2020,50016,Lajatico,PI,44,2,4,0,0,6,1,6,0,0,7
2020,50016,Lajatico,PI,45,6,4,0,0,10,1,5,1,0,7
2020,50016,Lajatico,PI,46,1,7,0,0,8,3,6,0,0,9
2020,50016,Lajatico,PI,47,5,3,1,0,9,3,6,2,1,12
2020,50016,Lajatico,PI,48,0,7,1,0,8,3,6,2,0,11
2020,50016,Lajatico,PI,49,6,10,0,0,16,2,11,0,0,13
2020,50016,Lajatico,PI,50,4,5,0,0,9,1,6,2,0,9
2020,50016,Lajatico,PI,51,2,1,2,0,5,1,6,3,0,10
2020,50016,Lajatico,PI,52,1,4,0,0,5,1,9,0,0,10
2020,50016,Lajatico,PI,53,1,8,0,0,9,4,6,2,0,12
2020,50016,Lajatico,PI,54,1,7,1,0,9,1,5,2,0,8
2020,50016,Lajatico,PI,55,1,6,1,0,8,1,5,0,0,6
2020,50016,Lajatico,PI,56,1,10,0,0,11,0,14,0,0,14
2020,50016,Lajatico,PI,57,2,8,2,0,12,0,7,1,0,8
2020,50016,Lajatico,PI,58,1,5,2,0,8,0,7,1,0,8
2020,50016,Lajatico,PI,59,1,10,0,0,11,1,11,1,0,13
2020,50016,Lajatico,PI,60,1,9,1,0,11,0,11,0,0,11
2020,50016,Lajatico,PI,61,1,14,1,1,17,0,6,2,0,8
2020,50016,Lajatico,PI,62,0,6,1,0,7,0,12,0,1,13
2020,50016,Lajatico,PI,63,1,3,2,0,6,1,7,0,1,9
2020,50016,Lajatico,PI,64,1,7,0,0,8,1,8,0,1,10
2020,50016,Lajatico,PI,65,1,8,0,0,9,0,9,0,2,11
2020,50016,Lajatico,PI,66,0,7,0,2,9,0,4,2,1,7
2020,50016,Lajatico,PI,67,1,10,1,1,13,0,3,0,2,5
2020,50016,Lajatico,PI,68,0,5,0,3,8,0,7,0,2,9
2020,50016,Lajatico,PI,69,0,5,1,1,7,0,8,1,2,11
2020,50016,Lajatico,PI,70,2,5,0,0,7,0,6,0,5,11
2020,50016,Lajatico,PI,71,0,16,0,1,17,0,7,0,2,9
2020,50016,Lajatico,PI,72,2,9,0,0,11,0,8,0,6,14
2020,50016,Lajatico,PI,73,0,6,0,1,7,1,9,0,1,11
2020,50016,Lajatico,PI,74,1,9,0,0,10,1,10,1,2,14
2020,50016,Lajatico,PI,75,0,3,0,0,3,0,3,0,0,3
2020,50016,Lajatico,PI,76,0,8,0,0,8,0,1,0,0,1
2020,50016,Lajatico,PI,77,0,6,0,0,6,0,2,0,4,6
2020,50016,Lajatico,PI,78,1,6,0,0,7,1,8,0,3,12
2020,50016,Lajatico,PI,79,0,2,1,0,3,0,4,1,0,5
2020,50016,Lajatico,PI,80,1,9,0,0,10,0,6,0,3,9
2020,50016,Lajatico,PI,81,0,5,0,0,5,0,3,0,4,7
2020,50016,Lajatico,PI,82,1,10,0,1,12,0,5,0,6,11
2020,50016,Lajatico,PI,83,1,7,0,1,9,0,4,0,5,9
2020,50016,Lajatico,PI,84,1,3,0,1,5,0,2,0,3,5
2020,50016,Lajatico,PI,85,1,1,0,1,3,0,3,0,10,13
2020,50016,Lajatico,PI,86,0,6,0,1,7,0,3,0,7,10
2020,50016,Lajatico,PI,87,0,5,0,2,7,1,0,0,5,6
2020,50016,Lajatico,PI,88,1,1,0,0,2,0,0,0,5,5
2020,50016,Lajatico,PI,89,0,2,0,0,2,2,3,0,4,9
2020,50016,Lajatico,PI,90,0,2,0,0,2,0,1,0,3,4
2020,50016,Lajatico,PI,91,0,1,0,1,2,0,0,0,2,2
2020,50016,Lajatico,PI,92,1,0,0,0,1,0,0,0,0,0
2020,50016,Lajatico,PI,93,0,2,0,0,2,0,0,0,2,2
2020,50016,Lajatico,PI,94,0,0,0,0,0,0,0,0,1,1
2020,50016,Lajatico,PI,95,0,0,0,0,0,0,0,0,2,2
2020,50016,Lajatico,PI,96,0,0,0,0,0,0,0,0,0,0
2020,50016,Lajatico,PI,97,0,0,0,0,0,0,0,0,0,0
2020,50016,Lajatico,PI,98,0,0,0,0,0,0,0,0,0,0
2020,50016,Lajatico,PI,99,0,0,0,0,0,0,0,0,0,0
2020,50016,Lajatico,PI,100 e più,0,0,0,0,0,0,0,0,0,0
2020,50019,Montecatini Val di Cecina,PI,0,6,0,0,0,6,4,0,0,0,4
2020,50019,Montecatini Val di Cecina,PI,1,4,0,0,0,4,5,0,0,0,5
2020,50019,Montecatini Val di Cecina,PI,2,7,0,0,0,7,9,0,0,0,9
2020,50019,Montecatini Val di Cecina,PI,3,5,0,0,0,5,7,0,0,0,7
2020,50019,Montecatini Val di Cecina,PI,4,7,0,0,0,7,5,0,0,0,5
2020,50019,Montecatini Val di Cecina,PI,5,12,0,0,0,12,8,0,0,0,8
2020,50019,Montecatini Val di Cecina,PI,6,9,0,0,0,9,5,0,0,0,5
2020,50019,Montecatini Val di Cecina,PI,7,6,0,0,0,6,6,0,0,0,6
2020,50019,Montecatini Val di Cecina,PI,8,5,0,0,0,5,7,0,0,0,7
2020,50019,Montecatini Val di Cecina,PI,9,4,0,0,0,4,12,0,0,0,12
2020,50019,Montecatini Val di Cecina,PI,10,8,0,0,0,8,7,0,0,0,7
2020,50019,Montecatini Val di Cecina,PI,11,7,0,0,0,7,3,0,0,0,3
2020,50019,Montecatini Val di Cecina,PI,12,7,0,0,0,7,6,0,0,0,6
2020,50019,Montecatini Val di Cecina,PI,13,6,0,0,0,6,7,0,0,0,7
2020,50019,Montecatini Val di Cecina,PI,14,8,0,0,0,8,5,0,0,0,5
2020,50019,Montecatini Val di Cecina,PI,15,9,0,0,0,9,2,0,0,0,2
2020,50019,Montecatini Val di Cecina,PI,16,9,0,0,0,9,4,0,0,0,4
2020,50019,Montecatini Val di Cecina,PI,17,5,0,0,0,5,6,0,0,0,6
2020,50019,Montecatini Val di Cecina,PI,18,3,0,0,0,3,7,0,0,0,7
2020,50019,Montecatini Val di Cecina,PI,19,8,0,0,0,8,8,0,0,0,8
2020,50019,Montecatini Val di Cecina,PI,20,9,0,0,0,9,3,0,0,0,3
2020,50019,Montecatini Val di Cecina,PI,21,2,0,0,0,2,2,0,1,0,3
2020,50019,Montecatini Val di Cecina,PI,22,5,0,0,0,5,3,0,0,0,3
2020,50019,Montecatini Val di Cecina,PI,23,5,0,0,0,5,2,0,0,0,2
2020,50019,Montecatini Val di Cecina,PI,24,3,1,0,0,4,4,1,0,0,5
2020,50019,Montecatini Val di Cecina,PI,25,9,0,0,0,9,5,0,0,0,5
2020,50019,Montecatini Val di Cecina,PI,26,3,1,0,0,4,5,0,0,0,5
2020,50019,Montecatini Val di Cecina,PI,27,9,0,0,0,9,8,0,0,0,8
2020,50019,Montecatini Val di Cecina,PI,28,8,0,0,0,8,5,0,0,0,5
2020,50019,Montecatini Val di Cecina,PI,29,6,0,0,0,6,4,3,0,0,7
2020,50019,Montecatini Val di Cecina,PI,30,6,1,0,0,7,3,1,0,0,4
2020,50019,Montecatini Val di Cecina,PI,31,5,0,0,0,5,3,1,0,0,4
2020,50019,Montecatini Val di Cecina,PI,32,10,1,0,0,11,5,3,0,0,8
2020,50019,Montecatini Val di Cecina,PI,33,8,0,0,0,8,5,2,0,0,7
2020,50019,Montecatini Val di Cecina,PI,34,2,5,0,0,7,5,4,0,0,9
2020,50019,Montecatini Val di Cecina,PI,35,2,3,0,0,5,4,3,0,0,7
2020,50019,Montecatini Val di Cecina,PI,36,4,1,0,0,5,4,9,0,0,13
2020,50019,Montecatini Val di Cecina,PI,37,4,5,0,0,9,6,4,0,0,10
2020,50019,Montecatini Val di Cecina,PI,38,6,5,0,0,11,10,5,0,0,15
2020,50019,Montecatini Val di Cecina,PI,39,7,3,0,0,10,2,3,0,0,5
2020,50019,Montecatini Val di Cecina,PI,40,5,5,0,0,10,6,4,1,0,11
2020,50019,Montecatini Val di Cecina,PI,41,8,4,0,0,12,3,4,0,0,7
2020,50019,Montecatini Val di Cecina,PI,42,7,4,0,0,11,8,9,1,0,18
2020,50019,Montecatini Val di Cecina,PI,43,5,4,0,0,9,7,8,1,0,16
2020,50019,Montecatini Val di Cecina,PI,44,7,1,0,0,8,4,6,1,0,11
2020,50019,Montecatini Val di Cecina,PI,45,8,9,0,0,17,4,6,0,1,11
2020,50019,Montecatini Val di Cecina,PI,46,10,3,0,0,13,4,4,0,0,8
2020,50019,Montecatini Val di Cecina,PI,47,8,12,1,0,21,5,11,2,1,19
2020,50019,Montecatini Val di Cecina,PI,48,7,11,0,0,18,1,6,1,1,9
2020,50019,Montecatini Val di Cecina,PI,49,6,4,1,0,11,2,6,1,1,10
2020,50019,Montecatini Val di Cecina,PI,50,8,6,1,0,15,2,7,0,0,9
2020,50019,Montecatini Val di Cecina,PI,51,5,4,0,0,9,2,6,3,0,11
2020,50019,Montecatini Val di Cecina,PI,52,7,9,1,0,17,3,10,1,0,14
2020,50019,Montecatini Val di Cecina,PI,53,5,10,1,0,16,3,6,4,1,14
2020,50019,Montecatini Val di Cecina,PI,54,3,11,0,0,14,3,12,0,2,17
2020,50019,Montecatini Val di Cecina,PI,55,6,10,0,0,16,4,5,0,0,9
2020,50019,Montecatini Val di Cecina,PI,56,3,8,1,0,12,3,10,0,0,13
2020,50019,Montecatini Val di Cecina,PI,57,4,10,1,0,15,1,11,0,1,13
2020,50019,Montecatini Val di Cecina,PI,58,3,9,1,0,13,0,12,1,0,13
2020,50019,Montecatini Val di Cecina,PI,59,5,8,0,1,14,3,7,1,0,11
2020,50019,Montecatini Val di Cecina,PI,60,0,6,2,1,9,3,11,0,1,15
2020,50019,Montecatini Val di Cecina,PI,61,2,6,2,1,11,3,9,1,2,15
2020,50019,Montecatini Val di Cecina,PI,62,2,11,2,0,15,0,8,0,0,8
2020,50019,Montecatini Val di Cecina,PI,63,0,8,1,0,9,1,7,1,3,12
2020,50019,Montecatini Val di Cecina,PI,64,1,8,0,0,9,1,11,1,1,14
2020,50019,Montecatini Val di Cecina,PI,65,1,6,0,1,8,0,10,1,2,13
2020,50019,Montecatini Val di Cecina,PI,66,1,13,1,0,15,0,9,0,1,10
2020,50019,Montecatini Val di Cecina,PI,67,2,13,2,1,18,1,13,0,5,19
2020,50019,Montecatini Val di Cecina,PI,68,1,8,2,0,11,0,8,1,5,14
2020,50019,Montecatini Val di Cecina,PI,69,0,8,0,0,8,2,8,0,2,12
2020,50019,Montecatini Val di Cecina,PI,70,0,15,0,1,16,0,5,0,1,6
2020,50019,Montecatini Val di Cecina,PI,71,1,8,0,1,10,0,5,0,4,9
2020,50019,Montecatini Val di Cecina,PI,72,4,8,0,1,13,1,7,0,3,11
2020,50019,Montecatini Val di Cecina,PI,73,2,12,0,2,16,0,4,0,3,7
2020,50019,Montecatini Val di Cecina,PI,74,1,9,2,0,12,0,7,0,3,10
2020,50019,Montecatini Val di Cecina,PI,75,1,7,0,0,8,2,8,0,2,12
2020,50019,Montecatini Val di Cecina,PI,76,0,8,1,0,9,0,7,2,2,11
2020,50019,Montecatini Val di Cecina,PI,77,0,2,0,3,5,0,4,1,3,8
2020,50019,Montecatini Val di Cecina,PI,78,3,7,0,0,10,1,5,1,7,14
2020,50019,Montecatini Val di Cecina,PI,79,1,5,0,2,8,1,8,1,8,18
2020,50019,Montecatini Val di Cecina,PI,80,3,7,0,1,11,0,3,0,9,12
2020,50019,Montecatini Val di Cecina,PI,81,1,8,1,2,12,0,4,1,10,15
2020,50019,Montecatini Val di Cecina,PI,82,1,9,0,1,11,2,6,0,5,13
2020,50019,Montecatini Val di Cecina,PI,83,1,5,0,1,7,0,1,0,6,7
2020,50019,Montecatini Val di Cecina,PI,84,0,4,0,2,6,1,2,0,6,9
2020,50019,Montecatini Val di Cecina,PI,85,1,3,0,1,5,0,1,0,7,8
2020,50019,Montecatini Val di Cecina,PI,86,0,2,0,2,4,0,1,0,3,4
2020,50019,Montecatini Val di Cecina,PI,87,0,4,0,3,7,1,1,0,3,5
2020,50019,Montecatini Val di Cecina,PI,88,0,1,0,1,2,0,0,0,4,4
2020,50019,Montecatini Val di Cecina,PI,89,0,2,0,3,5,1,1,0,5,7
2020,50019,Montecatini Val di Cecina,PI,90,1,1,0,0,2,0,2,0,3,5
2020,50019,Montecatini Val di Cecina,PI,91,0,1,0,1,2,0,1,1,7,9
2020,50019,Montecatini Val di Cecina,PI,92,0,0,0,0,0,0,0,0,2,2
2020,50019,Montecatini Val di Cecina,PI,93,0,1,0,1,2,0,0,0,2,2
2020,50019,Montecatini Val di Cecina,PI,94,0,0,0,0,0,0,0,0,3,3
2020,50019,Montecatini Val di Cecina,PI,95,0,0,0,0,0,1,0,0,0,1
2020,50019,Montecatini Val di Cecina,PI,96,0,0,0,0,0,0,0,0,0,0
2020,50019,Montecatini Val di Cecina,PI,97,0,0,0,0,0,0,0,0,1,1
2020,50019,Montecatini Val di Cecina,PI,98,0,0,0,0,0,0,0,0,0,0
2020,50019,Montecatini Val di Cecina,PI,99,0,0,0,0,0,0,0,0,0,0
2020,50019,Montecatini Val di Cecina,PI,100 e più,0,0,0,0,0,0,0,0,2,2
2020,50020,Montescudaio,PI,0,7,0,0,0,7,6,0,0,0,6
2020,50020,Montescudaio,PI,1,10,0,0,0,10,5,0,0,0,5
2020,50020,Montescudaio,PI,2,8,0,0,0,8,6,0,0,0,6
2020,50020,Montescudaio,PI,3,10,0,0,0,10,4,0,0,0,4
2020,50020,Montescudaio,PI,4,9,0,0,0,9,13,0,0,0,13
2020,50020,Montescudaio,PI,5,8,0,0,0,8,8,0,0,0,8
2020,50020,Montescudaio,PI,6,12,0,0,0,12,10,0,0,0,10
2020,50020,Montescudaio,PI,7,17,0,0,0,17,17,0,0,0,17
2020,50020,Montescudaio,PI,8,7,0,0,0,7,16,0,0,0,16
2020,50020,Montescudaio,PI,9,11,0,0,0,11,15,0,0,0,15
2020,50020,Montescudaio,PI,10,8,0,0,0,8,8,0,0,0,8
2020,50020,Montescudaio,PI,11,13,0,0,0,13,15,0,0,0,15
2020,50020,Montescudaio,PI,12,13,0,0,0,13,10,0,0,0,10
2020,50020,Montescudaio,PI,13,13,0,0,0,13,5,0,0,0,5
2020,50020,Montescudaio,PI,14,12,0,0,0,12,11,0,0,0,11
2020,50020,Montescudaio,PI,15,12,0,0,0,12,9,0,0,0,9
2020,50020,Montescudaio,PI,16,4,0,0,0,4,6,0,0,0,6
2020,50020,Montescudaio,PI,17,8,0,0,0,8,12,0,0,0,12
2020,50020,Montescudaio,PI,18,7,0,0,0,7,9,0,0,0,9
2020,50020,Montescudaio,PI,19,4,0,0,0,4,4,0,0,0,4
2020,50020,Montescudaio,PI,20,8,0,0,0,8,12,0,0,0,12
2020,50020,Montescudaio,PI,21,7,0,0,0,7,10,1,0,0,11
2020,50020,Montescudaio,PI,22,5,0,0,0,5,8,0,0,0,8
2020,50020,Montescudaio,PI,23,6,0,0,0,6,6,1,0,0,7
2020,50020,Montescudaio,PI,24,8,0,0,0,8,2,0,0,0,2
2020,50020,Montescudaio,PI,25,8,0,0,0,8,9,0,0,0,9
2020,50020,Montescudaio,PI,26,12,0,0,0,12,13,0,0,0,13
2020,50020,Montescudaio,PI,27,7,0,0,0,7,14,0,0,0,14
2020,50020,Montescudaio,PI,28,12,2,0,0,14,8,3,0,0,11
2020,50020,Montescudaio,PI,29,10,0,0,0,10,7,3,0,0,10
2020,50020,Montescudaio,PI,30,5,0,0,0,5,10,3,0,0,13
2020,50020,Montescudaio,PI,31,5,3,0,0,8,9,4,0,0,13
2020,50020,Montescudaio,PI,32,6,0,0,0,6,4,2,0,0,6
2020,50020,Montescudaio,PI,33,10,2,0,0,12,6,4,0,0,10
2020,50020,Montescudaio,PI,34,7,5,0,0,12,6,5,0,0,11
2020,50020,Montescudaio,PI,35,4,4,0,0,8,10,3,0,0,13
2020,50020,Montescudaio,PI,36,6,4,0,0,10,5,4,0,0,9
2020,50020,Montescudaio,PI,37,5,6,1,0,12,5,8,0,0,13
2020,50020,Montescudaio,PI,38,8,5,1,0,14,5,8,0,0,13
2020,50020,Montescudaio,PI,39,12,12,0,0,24,5,7,0,0,12
2020,50020,Montescudaio,PI,40,7,4,0,0,11,7,9,0,0,16
2020,50020,Montescudaio,PI,41,7,8,0,0,15,9,12,3,1,25
2020,50020,Montescudaio,PI,42,7,7,2,0,16,9,12,3,0,24
2020,50020,Montescudaio,PI,43,12,8,0,0,20,3,10,1,0,14
2020,50020,Montescudaio,PI,44,7,10,2,0,19,7,14,2,0,23
2020,50020,Montescudaio,PI,45,8,15,0,0,23,9,8,2,0,19
2020,50020,Montescudaio,PI,46,13,3,0,0,16,4,9,4,0,17
2020,50020,Montescudaio,PI,47,3,15,3,0,21,4,6,2,0,12
2020,50020,Montescudaio,PI,48,7,14,4,0,25,3,8,4,0,15
2020,50020,Montescudaio,PI,49,9,6,0,0,15,4,10,0,1,15
2020,50020,Montescudaio,PI,50,9,11,0,0,20,1,14,3,0,18
2020,50020,Montescudaio,PI,51,8,17,0,0,25,3,10,6,0,19
2020,50020,Montescudaio,PI,52,4,5,0,0,9,2,11,3,0,16
2020,50020,Montescudaio,PI,53,8,13,1,0,22,4,8,2,0,14
2020,50020,Montescudaio,PI,54,5,7,4,0,16,1,9,6,0,16
2020,50020,Montescudaio,PI,55,1,5,2,0,8,0,11,2,1,14
2020,50020,Montescudaio,PI,56,2,11,2,0,15,3,17,0,1,21
2020,50020,Montescudaio,PI,57,3,18,1,1,23,4,20,2,1,27
2020,50020,Montescudaio,PI,58,1,14,1,0,16,0,15,1,2,18
2020,50020,Montescudaio,PI,59,1,12,2,0,15,2,15,4,4,25
2020,50020,Montescudaio,PI,60,4,13,0,1,18,2,7,3,1,13
2020,50020,Montescudaio,PI,61,4,10,1,1,16,1,13,3,1,18
2020,50020,Montescudaio,PI,62,0,11,4,0,15,1,11,2,0,14
2020,50020,Montescudaio,PI,63,1,7,1,0,9,0,11,2,0,13
2020,50020,Montescudaio,PI,64,0,8,3,1,12,0,8,1,2,11
2020,50020,Montescudaio,PI,65,2,16,3,0,21,0,11,1,3,15
2020,50020,Montescudaio,PI,66,2,12,1,3,18,2,9,1,3,15
2020,50020,Montescudaio,PI,67,0,13,2,0,15,0,7,0,3,10
2020,50020,Montescudaio,PI,68,3,10,1,0,14,0,19,2,2,23
2020,50020,Montescudaio,PI,69,5,16,3,2,26,0,9,3,0,12
2020,50020,Montescudaio,PI,70,0,5,0,1,6,2,5,0,0,7
2020,50020,Montescudaio,PI,71,0,13,0,1,14,1,6,1,1,9
2020,50020,Montescudaio,PI,72,1,9,1,0,11,1,9,0,3,13
2020,50020,Montescudaio,PI,73,0,14,2,2,18,0,6,1,3,10
2020,50020,Montescudaio,PI,74,0,7,1,0,8,1,15,0,5,21
2020,50020,Montescudaio,PI,75,0,10,0,1,11,0,5,0,6,11
2020,50020,Montescudaio,PI,76,0,5,0,1,6,0,4,1,3,8
2020,50020,Montescudaio,PI,77,1,7,1,4,13,0,5,0,3,8
2020,50020,Montescudaio,PI,78,1,3,0,0,4,2,3,0,4,9
2020,50020,Montescudaio,PI,79,0,7,0,0,7,0,2,1,0,3
2020,50020,Montescudaio,PI,80,0,3,1,4,8,0,3,0,1,4
2020,50020,Montescudaio,PI,81,0,7,0,0,7,0,1,0,2,3
2020,50020,Montescudaio,PI,82,0,2,0,0,2,0,4,0,6,10
2020,50020,Montescudaio,PI,83,1,1,0,0,2,0,2,0,8,10
2020,50020,Montescudaio,PI,84,1,3,0,1,5,0,1,0,2,3
2020,50020,Montescudaio,PI,85,0,3,0,2,5,1,0,0,4,5
2020,50020,Montescudaio,PI,86,0,1,0,2,3,0,2,0,3,5
2020,50020,Montescudaio,PI,87,0,0,0,1,1,0,0,0,8,8
2020,50020,Montescudaio,PI,88,0,2,0,1,3,0,0,0,4,4
2020,50020,Montescudaio,PI,89,0,0,0,2,2,1,0,0,3,4
2020,50020,Montescudaio,PI,90,1,1,0,0,2,0,0,0,5,5
2020,50020,Montescudaio,PI,91,0,0,0,1,1,1,0,0,4,5
2020,50020,Montescudaio,PI,92,0,1,0,2,3,0,0,0,4,4
2020,50020,Montescudaio,PI,93,0,0,0,0,0,0,0,0,1,1
2020,50020,Montescudaio,PI,94,0,0,0,0,0,0,0,0,0,0
2020,50020,Montescudaio,PI,95,0,0,0,0,0,0,0,0,3,3
2020,50020,Montescudaio,PI,96,0,0,0,0,0,0,0,0,1,1
2020,50020,Montescudaio,PI,97,0,0,0,0,0,0,0,0,1,1
2020,50020,Montescudaio,PI,98,0,0,0,0,0,0,0,0,0,0
2020,50020,Montescudaio,PI,99,0,0,0,0,0,0,0,0,2,2
2020,50020,Montescudaio,PI,100 e più,0,0,0,0,0,0,0,0,1,1
2020,50021,Monteverdi Marittimo,PI,0,2,0,0,0,2,2,0,0,0,2
2020,50021,Monteverdi Marittimo,PI,1,3,0,0,0,3,1,0,0,0,1
2020,50021,Monteverdi Marittimo,PI,2,2,0,0,0,2,4,0,0,0,4
2020,50021,Monteverdi Marittimo,PI,3,2,0,0,0,2,4,0,0,0,4
2020,50021,Monteverdi Marittimo,PI,4,1,0,0,0,1,3,0,0,0,3
2020,50021,Monteverdi Marittimo,PI,5,4,0,0,0,4,2,0,0,0,2
2020,50021,Monteverdi Marittimo,PI,6,2,0,0,0,2,2,0,0,0,2
2020,50021,Monteverdi Marittimo,PI,7,3,0,0,0,3,4,0,0,0,4
2020,50021,Monteverdi Marittimo,PI,8,3,0,0,0,3,1,0,0,0,1
2020,50021,Monteverdi Marittimo,PI,9,3,0,0,0,3,1,0,0,0,1
2020,50021,Monteverdi Marittimo,PI,10,2,0,0,0,2,3,0,0,0,3
2020,50021,Monteverdi Marittimo,PI,11,5,0,0,0,5,4,0,0,0,4
2020,50021,Monteverdi Marittimo,PI,12,2,0,0,0,2,5,0,0,0,5
2020,50021,Monteverdi Marittimo,PI,13,1,0,0,0,1,5,0,0,0,5
2020,50021,Monteverdi Marittimo,PI,14,3,0,0,0,3,3,0,0,0,3
2020,50021,Monteverdi Marittimo,PI,15,3,0,0,0,3,3,0,0,0,3
2020,50021,Monteverdi Marittimo,PI,16,6,0,0,0,6,3,0,0,0,3
2020,50021,Monteverdi Marittimo,PI,17,1,0,0,0,1,3,0,0,0,3
2020,50021,Monteverdi Marittimo,PI,18,1,0,0,0,1,3,0,0,0,3
2020,50021,Monteverdi Marittimo,PI,19,5,0,0,0,5,4,0,0,0,4
2020,50021,Monteverdi Marittimo,PI,20,1,0,0,0,1,3,0,0,0,3
2020,50021,Monteverdi Marittimo,PI,21,1,0,0,0,1,1,0,0,0,1
2020,50021,Monteverdi Marittimo,PI,22,7,0,0,0,7,2,0,0,0,2
2020,50021,Monteverdi Marittimo,PI,23,1,0,0,0,1,5,0,0,0,5
2020,50021,Monteverdi Marittimo,PI,24,4,0,0,0,4,3,0,0,0,3
2020,50021,Monteverdi Marittimo,PI,25,5,0,0,0,5,1,1,0,0,2
2020,50021,Monteverdi Marittimo,PI,26,7,0,0,0,7,3,1,0,0,4
2020,50021,Monteverdi Marittimo,PI,27,1,1,0,0,2,2,0,0,0,2
2020,50021,Monteverdi Marittimo,PI,28,2,0,0,0,2,3,1,0,0,4
2020,50021,Monteverdi Marittimo,PI,29,3,0,0,0,3,1,2,0,0,3
2020,50021,Monteverdi Marittimo,PI,30,3,0,0,0,3,3,0,0,0,3
2020,50021,Monteverdi Marittimo,PI,31,5,0,0,0,5,6,1,0,0,7
2020,50021,Monteverdi Marittimo,PI,32,1,0,0,0,1,1,1,0,0,2
2020,50021,Monteverdi Marittimo,PI,33,0,0,0,0,0,2,3,0,0,5
2020,50021,Monteverdi Marittimo,PI,34,3,1,0,0,4,1,2,0,0,3
2020,50021,Monteverdi Marittimo,PI,35,2,1,0,0,3,1,1,0,0,2
2020,50021,Monteverdi Marittimo,PI,36,5,1,0,0,6,1,2,0,0,3
2020,50021,Monteverdi Marittimo,PI,37,3,1,0,0,4,0,2,0,0,2
2020,50021,Monteverdi Marittimo,PI,38,1,0,0,0,1,2,0,0,0,2
2020,50021,Monteverdi Marittimo,PI,39,2,1,0,0,3,1,0,0,0,1
2020,50021,Monteverdi Marittimo,PI,40,0,3,0,0,3,0,2,0,0,2
2020,50021,Monteverdi Marittimo,PI,41,1,1,0,0,2,2,2,0,0,4
2020,50021,Monteverdi Marittimo,PI,42,3,0,0,0,3,0,3,0,0,3
2020,50021,Monteverdi Marittimo,PI,43,1,3,0,0,4,1,2,0,0,3
2020,50021,Monteverdi Marittimo,PI,44,5,1,0,0,6,3,7,1,0,11
2020,50021,Monteverdi Marittimo,PI,45,4,5,0,0,9,2,4,0,0,6
2020,50021,Monteverdi Marittimo,PI,46,3,7,0,1,11,2,4,0,0,6
2020,50021,Monteverdi Marittimo,PI,47,2,2,1,0,5,4,4,0,0,8
2020,50021,Monteverdi Marittimo,PI,48,1,5,1,0,7,2,5,0,0,7
2020,50021,Monteverdi Marittimo,PI,49,2,4,0,0,6,0,7,0,0,7
2020,50021,Monteverdi Marittimo,PI,50,0,6,0,0,6,0,5,0,0,5
2020,50021,Monteverdi Marittimo,PI,51,0,8,0,0,8,0,5,0,1,6
2020,50021,Monteverdi Marittimo,PI,52,1,2,0,0,3,0,3,0,0,3
2020,50021,Monteverdi Marittimo,PI,53,2,5,0,1,8,1,1,0,0,2
2020,50021,Monteverdi Marittimo,PI,54,1,6,0,0,7,2,1,0,0,3
2020,50021,Monteverdi Marittimo,PI,55,3,6,2,0,11,1,6,0,0,7
2020,50021,Monteverdi Marittimo,PI,56,0,3,0,0,3,2,4,0,1,7
2020,50021,Monteverdi Marittimo,PI,57,2,3,2,0,7,1,4,0,0,5
2020,50021,Monteverdi Marittimo,PI,58,1,7,2,0,10,6,3,0,1,10
2020,50021,Monteverdi Marittimo,PI,59,3,4,0,0,7,1,3,0,1,5
2020,50021,Monteverdi Marittimo,PI,60,1,1,1,0,3,2,2,0,0,4
2020,50021,Monteverdi Marittimo,PI,61,1,8,0,0,9,2,4,1,0,7
2020,50021,Monteverdi Marittimo,PI,62,1,2,0,0,3,2,4,0,1,7
2020,50021,Monteverdi Marittimo,PI,63,1,1,0,0,2,2,4,1,0,7
2020,50021,Monteverdi Marittimo,PI,64,0,4,0,0,4,1,3,0,2,6
2020,50021,Monteverdi Marittimo,PI,65,1,5,0,0,6,2,4,0,1,7
2020,50021,Monteverdi Marittimo,PI,66,2,4,0,1,7,1,6,0,0,7
2020,50021,Monteverdi Marittimo,PI,67,2,1,0,0,3,0,4,0,2,6
2020,50021,Monteverdi Marittimo,PI,68,0,9,0,0,9,0,3,0,0,3
2020,50021,Monteverdi Marittimo,PI,69,1,4,0,0,5,0,10,0,0,10
2020,50021,Monteverdi Marittimo,PI,70,1,8,1,2,12,0,2,0,0,2
2020,50021,Monteverdi Marittimo,PI,71,0,3,0,0,3,3,1,0,3,7
2020,50021,Monteverdi Marittimo,PI,72,1,6,0,0,7,0,4,1,2,7
2020,50021,Monteverdi Marittimo,PI,73,1,1,1,0,3,1,4,0,2,7
2020,50021,Monteverdi Marittimo,PI,74,0,3,0,1,4,0,2,0,2,4
2020,50021,Monteverdi Marittimo,PI,75,2,2,1,0,5,0,1,0,0,1
2020,50021,Monteverdi Marittimo,PI,76,1,3,0,0,4,0,2,0,1,3
2020,50021,Monteverdi Marittimo,PI,77,1,2,0,0,3,1,4,0,0,5
2020,50021,Monteverdi Marittimo,PI,78,0,4,0,0,4,0,3,0,0,3
2020,50021,Monteverdi Marittimo,PI,79,0,2,0,0,2,0,2,0,2,4
2020,50021,Monteverdi Marittimo,PI,80,2,4,0,2,8,1,1,0,0,2
2020,50021,Monteverdi Marittimo,PI,81,1,1,0,0,2,0,3,0,1,4
2020,50021,Monteverdi Marittimo,PI,82,0,3,0,1,4,0,1,0,1,2
2020,50021,Monteverdi Marittimo,PI,83,0,1,0,0,1,0,3,0,4,7
2020,50021,Monteverdi Marittimo,PI,84,0,4,0,0,4,0,1,0,1,2
2020,50021,Monteverdi Marittimo,PI,85,1,2,0,0,3,0,1,0,6,7
2020,50021,Monteverdi Marittimo,PI,86,0,1,0,1,2,0,0,0,4,4
2020,50021,Monteverdi Marittimo,PI,87,0,2,0,1,3,0,0,0,1,1
2020,50021,Monteverdi Marittimo,PI,88,0,1,0,2,3,0,0,0,0,0
2020,50021,Monteverdi Marittimo,PI,89,0,0,0,0,0,1,1,0,1,3
2020,50021,Monteverdi Marittimo,PI,90,0,2,0,0,2,0,1,0,0,1
2020,50021,Monteverdi Marittimo,PI,91,0,2,0,0,2,0,0,0,1,1
2020,50021,Monteverdi Marittimo,PI,92,0,0,0,0,0,0,0,0,0,0
2020,50021,Monteverdi Marittimo,PI,93,0,0,0,0,0,0,0,0,0,0
2020,50021,Monteverdi Marittimo,PI,94,0,0,0,0,0,0,0,0,0,0
2020,50021,Monteverdi Marittimo,PI,95,0,0,0,0,0,0,0,0,2,2
2020,50021,Monteverdi Marittimo,PI,96,0,0,0,0,0,0,0,0,0,0
2020,50021,Monteverdi Marittimo,PI,97,0,0,0,0,0,0,0,0,0,0
2020,50021,Monteverdi Marittimo,PI,98,0,0,0,0,0,0,0,0,0,0
2020,50021,Monteverdi Marittimo,PI,99,0,0,0,0,0,0,0,0,0,0
2020,50021,Monteverdi Marittimo,PI,100 e più,0,0,0,0,0,0,0,0,0,0
2020,50022,Montopoli in Val d'Arno,PI,0,46,0,0,0,46,31,0,0,0,31
2020,50022,Montopoli in Val d'Arno,PI,1,49,0,0,0,49,31,0,0,0,31
2020,50022,Montopoli in Val d'Arno,PI,2,51,0,0,0,51,46,0,0,0,46
2020,50022,Montopoli in Val d'Arno,PI,3,43,0,0,0,43,37,0,0,0,37
2020,50022,Montopoli in Val d'Arno,PI,4,43,0,0,0,43,62,0,0,0,62
2020,50022,Montopoli in Val d'Arno,PI,5,48,0,0,0,48,54,0,0,0,54
2020,50022,Montopoli in Val d'Arno,PI,6,48,0,0,0,48,51,0,0,0,51
2020,50022,Montopoli in Val d'Arno,PI,7,65,0,0,0,65,73,0,0,0,73
2020,50022,Montopoli in Val d'Arno,PI,8,53,0,0,0,53,34,0,0,0,34
2020,50022,Montopoli in Val d'Arno,PI,9,52,0,0,0,52,60,0,0,0,60
2020,50022,Montopoli in Val d'Arno,PI,10,41,0,0,0,41,49,0,0,0,49
2020,50022,Montopoli in Val d'Arno,PI,11,55,0,0,0,55,56,0,0,0,56
2020,50022,Montopoli in Val d'Arno,PI,12,67,0,0,0,67,63,0,0,0,63
2020,50022,Montopoli in Val d'Arno,PI,13,54,0,0,0,54,55,0,0,0,55
2020,50022,Montopoli in Val d'Arno,PI,14,69,0,0,0,69,46,0,0,0,46
2020,50022,Montopoli in Val d'Arno,PI,15,63,0,0,0,63,54,0,0,0,54
2020,50022,Montopoli in Val d'Arno,PI,16,53,0,0,0,53,54,0,0,0,54
2020,50022,Montopoli in Val d'Arno,PI,17,57,0,0,0,57,50,0,0,0,50
2020,50022,Montopoli in Val d'Arno,PI,18,58,0,0,0,58,47,0,0,0,47
2020,50022,Montopoli in Val d'Arno,PI,19,52,0,0,0,52,43,0,0,0,43
2020,50022,Montopoli in Val d'Arno,PI,20,49,0,0,0,49,55,0,0,0,55
2020,50022,Montopoli in Val d'Arno,PI,21,50,0,0,0,50,51,0,0,0,51
2020,50022,Montopoli in Val d'Arno,PI,22,62,0,0,0,62,42,4,0,0,46
2020,50022,Montopoli in Val d'Arno,PI,23,66,0,0,0,66,52,2,0,0,54
2020,50022,Montopoli in Val d'Arno,PI,24,49,1,0,0,50,54,3,0,0,57
2020,50022,Montopoli in Val d'Arno,PI,25,51,2,0,0,53,46,5,0,0,51
2020,50022,Montopoli in Val d'Arno,PI,26,61,0,0,0,61,45,3,0,0,48
2020,50022,Montopoli in Val d'Arno,PI,27,40,6,0,0,46,48,6,0,0,54
2020,50022,Montopoli in Val d'Arno,PI,28,46,5,0,0,51,43,14,0,0,57
2020,50022,Montopoli in Val d'Arno,PI,29,33,7,0,0,40,41,12,0,0,53
2020,50022,Montopoli in Val d'Arno,PI,30,58,12,1,0,71,29,22,1,0,52
2020,50022,Montopoli in Val d'Arno,PI,31,37,12,0,0,49,29,22,0,0,51
2020,50022,Montopoli in Val d'Arno,PI,32,40,10,0,0,50,24,26,0,0,50
2020,50022,Montopoli in Val d'Arno,PI,33,39,16,0,0,55,30,22,1,1,54
2020,50022,Montopoli in Val d'Arno,PI,34,40,15,0,0,55,27,41,1,0,69
2020,50022,Montopoli in Val d'Arno,PI,35,39,20,0,0,59,19,32,0,0,51
2020,50022,Montopoli in Val d'Arno,PI,36,36,23,0,0,59,27,44,2,0,73
2020,50022,Montopoli in Val d'Arno,PI,37,24,29,2,0,55,31,39,0,0,70
2020,50022,Montopoli in Val d'Arno,PI,38,27,38,2,0,67,16,40,1,0,57
2020,50022,Montopoli in Val d'Arno,PI,39,35,38,0,0,73,15,42,0,0,57
2020,50022,Montopoli in Val d'Arno,PI,40,40,42,2,0,84,13,49,3,0,65
2020,50022,Montopoli in Val d'Arno,PI,41,42,56,2,0,100,17,55,3,0,75
2020,50022,Montopoli in Val d'Arno,PI,42,27,50,6,0,83,21,62,3,0,86
2020,50022,Montopoli in Val d'Arno,PI,43,26,48,6,0,80,24,46,5,1,76
2020,50022,Montopoli in Val d'Arno,PI,44,24,67,6,0,97,25,71,4,0,100
2020,50022,Montopoli in Val d'Arno,PI,45,31,59,6,0,96,16,44,5,1,66
2020,50022,Montopoli in Val d'Arno,PI,46,23,56,6,0,85,21,69,5,1,96
2020,50022,Montopoli in Val d'Arno,PI,47,25,60,8,0,93,18,70,2,0,90
2020,50022,Montopoli in Val d'Arno,PI,48,25,69,3,0,97,12,69,5,2,88
2020,50022,Montopoli in Val d'Arno,PI,49,15,77,3,0,95,22,81,7,7,117
2020,50022,Montopoli in Val d'Arno,PI,50,15,56,4,0,75,14,61,7,1,83
2020,50022,Montopoli in Val d'Arno,PI,51,24,71,5,1,101,13,87,6,1,107
2020,50022,Montopoli in Val d'Arno,PI,52,16,72,6,0,94,14,68,10,5,97
2020,50022,Montopoli in Val d'Arno,PI,53,24,72,8,0,104,8,67,3,3,81
2020,50022,Montopoli in Val d'Arno,PI,54,7,67,7,1,82,10,76,7,2,95
2020,50022,Montopoli in Val d'Arno,PI,55,8,55,8,2,73,8,62,11,2,83
2020,50022,Montopoli in Val d'Arno,PI,56,16,71,4,0,91,11,74,8,4,97
2020,50022,Montopoli in Val d'Arno,PI,57,10,72,10,1,93,8,73,3,5,89
2020,50022,Montopoli in Val d'Arno,PI,58,11,63,1,1,76,10,67,4,2,83
2020,50022,Montopoli in Val d'Arno,PI,59,11,65,3,1,80,3,66,7,4,80
2020,50022,Montopoli in Val d'Arno,PI,60,5,58,4,2,69,6,52,4,4,66
2020,50022,Montopoli in Val d'Arno,PI,61,5,64,7,0,76,2,70,6,4,82
2020,50022,Montopoli in Val d'Arno,PI,62,8,60,4,2,74,3,66,4,4,77
2020,50022,Montopoli in Val d'Arno,PI,63,4,56,5,2,67,2,50,3,3,58
2020,50022,Montopoli in Val d'Arno,PI,64,8,58,6,1,73,2,59,4,7,72
2020,50022,Montopoli in Val d'Arno,PI,65,9,60,3,1,73,4,71,0,12,87
2020,50022,Montopoli in Val d'Arno,PI,66,8,63,1,1,73,0,52,3,6,61
2020,50022,Montopoli in Val d'Arno,PI,67,6,54,3,3,66,1,48,4,10,63
2020,50022,Montopoli in Val d'Arno,PI,68,2,50,1,1,54,0,43,0,6,49
2020,50022,Montopoli in Val d'Arno,PI,69,1,53,0,3,57,2,44,1,9,56
2020,50022,Montopoli in Val d'Arno,PI,70,1,45,1,5,52,0,60,1,13,74
2020,50022,Montopoli in Val d'Arno,PI,71,2,53,1,4,60,1,44,2,12,59
2020,50022,Montopoli in Val d'Arno,PI,72,2,52,0,1,55,1,49,2,19,71
2020,50022,Montopoli in Val d'Arno,PI,73,4,54,2,4,64,1,58,3,9,71
2020,50022,Montopoli in Val d'Arno,PI,74,0,59,0,1,60,1,32,3,17,53
2020,50022,Montopoli in Val d'Arno,PI,75,1,50,0,9,60,1,33,0,16,50
2020,50022,Montopoli in Val d'Arno,PI,76,3,29,2,4,38,1,36,1,12,50
2020,50022,Montopoli in Val d'Arno,PI,77,3,37,1,3,44,2,28,0,17,47
2020,50022,Montopoli in Val d'Arno,PI,78,1,41,1,8,51,3,24,0,17,44
2020,50022,Montopoli in Val d'Arno,PI,79,0,23,0,3,26,2,27,0,18,47
2020,50022,Montopoli in Val d'Arno,PI,80,2,36,0,7,45,1,22,1,28,52
2020,50022,Montopoli in Val d'Arno,PI,81,0,21,0,5,26,2,14,0,18,34
2020,50022,Montopoli in Val d'Arno,PI,82,1,34,1,10,46,0,25,0,30,55
2020,50022,Montopoli in Val d'Arno,PI,83,0,24,0,8,32,2,23,0,28,53
2020,50022,Montopoli in Val d'Arno,PI,84,1,23,0,5,29,0,14,0,26,40
2020,50022,Montopoli in Val d'Arno,PI,85,0,26,0,4,30,0,8,0,16,24
2020,50022,Montopoli in Val d'Arno,PI,86,3,14,0,2,19,3,4,0,28,35
2020,50022,Montopoli in Val d'Arno,PI,87,0,17,0,6,23,0,6,0,26,32
2020,50022,Montopoli in Val d'Arno,PI,88,1,11,0,1,13,1,5,0,21,27
2020,50022,Montopoli in Val d'Arno,PI,89,1,11,0,10,22,1,2,0,15,18
2020,50022,Montopoli in Val d'Arno,PI,90,0,4,0,3,7,1,2,1,14,18
2020,50022,Montopoli in Val d'Arno,PI,91,0,5,0,5,10,1,2,0,13,16
2020,50022,Montopoli in Val d'Arno,PI,92,0,6,0,4,10,1,5,0,12,18
2020,50022,Montopoli in Val d'Arno,PI,93,0,2,0,3,5,0,1,0,9,10
2020,50022,Montopoli in Val d'Arno,PI,94,0,1,0,2,3,0,1,0,8,9
2020,50022,Montopoli in Val d'Arno,PI,95,0,1,0,2,3,1,1,0,4,6
2020,50022,Montopoli in Val d'Arno,PI,96,0,1,0,2,3,1,0,0,5,6
2020,50022,Montopoli in Val d'Arno,PI,97,0,0,0,3,3,0,0,0,8,8
2020,50022,Montopoli in Val d'Arno,PI,98,0,1,0,0,1,1,0,0,7,8
2020,50022,Montopoli in Val d'Arno,PI,99,0,0,0,1,1,0,0,0,2,2
2020,50022,Montopoli in Val d'Arno,PI,100 e più,0,0,0,0,0,0,0,0,2,2
2020,50023,Orciano Pisano,PI,0,1,0,0,0,1,0,0,0,0,0
2020,50023,Orciano Pisano,PI,1,1,0,0,0,1,4,0,0,0,4
2020,50023,Orciano Pisano,PI,2,0,0,0,0,0,1,0,0,0,1
2020,50023,Orciano Pisano,PI,3,2,0,0,0,2,2,0,0,0,2
2020,50023,Orciano Pisano,PI,4,5,0,0,0,5,6,0,0,0,6
2020,50023,Orciano Pisano,PI,5,1,0,0,0,1,1,0,0,0,1
2020,50023,Orciano Pisano,PI,6,0,0,0,0,0,1,0,0,0,1
2020,50023,Orciano Pisano,PI,7,0,0,0,0,0,4,0,0,0,4
2020,50023,Orciano Pisano,PI,8,3,0,0,0,3,3,0,0,0,3
2020,50023,Orciano Pisano,PI,9,2,0,0,0,2,1,0,0,0,1
2020,50023,Orciano Pisano,PI,10,4,0,0,0,4,1,0,0,0,1
2020,50023,Orciano Pisano,PI,11,0,0,0,0,0,2,0,0,0,2
2020,50023,Orciano Pisano,PI,12,4,0,0,0,4,6,0,0,0,6
2020,50023,Orciano Pisano,PI,13,4,0,0,0,4,1,0,0,0,1
2020,50023,Orciano Pisano,PI,14,1,0,0,0,1,4,0,0,0,4
2020,50023,Orciano Pisano,PI,15,2,0,0,0,2,0,0,0,0,0
2020,50023,Orciano Pisano,PI,16,1,0,0,0,1,3,0,0,0,3
2020,50023,Orciano Pisano,PI,17,0,0,0,0,0,1,0,0,0,1
2020,50023,Orciano Pisano,PI,18,4,0,0,0,4,5,0,0,0,5
2020,50023,Orciano Pisano,PI,19,3,0,0,0,3,1,0,0,0,1
2020,50023,Orciano Pisano,PI,20,1,0,0,0,1,2,0,0,0,2
2020,50023,Orciano Pisano,PI,21,2,0,0,0,2,2,0,0,0,2
2020,50023,Orciano Pisano,PI,22,3,0,0,0,3,0,0,0,0,0
2020,50023,Orciano Pisano,PI,23,3,0,0,0,3,1,0,0,0,1
2020,50023,Orciano Pisano,PI,24,0,0,0,0,0,2,1,0,0,3
2020,50023,Orciano Pisano,PI,25,3,0,0,0,3,3,0,0,0,3
2020,50023,Orciano Pisano,PI,26,3,0,0,0,3,1,0,0,0,1
2020,50023,Orciano Pisano,PI,27,2,0,0,0,2,2,1,0,0,3
2020,50023,Orciano Pisano,PI,28,8,0,1,0,9,2,0,0,0,2
2020,50023,Orciano Pisano,PI,29,1,1,0,0,2,4,1,0,0,5
2020,50023,Orciano Pisano,PI,30,2,0,0,0,2,3,1,0,0,4
2020,50023,Orciano Pisano,PI,31,2,1,0,0,3,2,0,0,0,2
2020,50023,Orciano Pisano,PI,32,1,1,0,0,2,1,1,0,0,2
2020,50023,Orciano Pisano,PI,33,1,0,0,0,1,2,1,0,0,3
2020,50023,Orciano Pisano,PI,34,2,2,0,0,4,1,0,0,0,1
2020,50023,Orciano Pisano,PI,35,1,1,0,0,2,0,1,0,0,1
2020,50023,Orciano Pisano,PI,36,3,0,0,0,3,2,1,0,0,3
2020,50023,Orciano Pisano,PI,37,2,2,0,0,4,5,1,0,0,6
2020,50023,Orciano Pisano,PI,38,3,0,0,0,3,2,2,0,0,4
2020,50023,Orciano Pisano,PI,39,2,1,0,0,3,3,0,0,0,3
2020,50023,Orciano Pisano,PI,40,1,4,0,0,5,0,5,0,0,5
2020,50023,Orciano Pisano,PI,41,1,2,0,0,3,2,2,0,0,4
2020,50023,Orciano Pisano,PI,42,3,1,0,0,4,0,2,1,0,3
2020,50023,Orciano Pisano,PI,43,2,4,0,0,6,0,3,0,0,3
2020,50023,Orciano Pisano,PI,44,4,2,1,0,7,2,4,0,0,6
2020,50023,Orciano Pisano,PI,45,2,3,0,0,5,1,5,0,0,6
2020,50023,Orciano Pisano,PI,46,2,3,0,0,5,0,5,0,1,6
2020,50023,Orciano Pisano,PI,47,2,5,0,0,7,0,4,0,0,4
2020,50023,Orciano Pisano,PI,48,1,2,0,0,3,1,6,0,1,8
2020,50023,Orciano Pisano,PI,49,1,4,1,0,6,0,4,0,0,4
2020,50023,Orciano Pisano,PI,50,1,6,0,0,7,1,1,1,0,3
2020,50023,Orciano Pisano,PI,51,1,2,2,0,5,1,3,0,0,4
2020,50023,Orciano Pisano,PI,52,2,3,0,0,5,3,3,0,0,6
2020,50023,Orciano Pisano,PI,53,1,4,0,0,5,1,7,1,1,10
2020,50023,Orciano Pisano,PI,54,0,1,1,0,2,3,3,0,0,6
2020,50023,Orciano Pisano,PI,55,2,3,0,0,5,1,7,1,0,9
2020,50023,Orciano Pisano,PI,56,1,3,0,0,4,1,3,0,0,4
2020,50023,Orciano Pisano,PI,57,1,7,0,0,8,0,3,0,0,3
2020,50023,Orciano Pisano,PI,58,1,3,1,1,6,0,6,1,0,7
2020,50023,Orciano Pisano,PI,59,0,5,1,0,6,0,6,1,0,7
2020,50023,Orciano Pisano,PI,60,0,3,4,0,7,0,3,0,0,3
2020,50023,Orciano Pisano,PI,61,0,6,0,0,6,0,3,0,1,4
2020,50023,Orciano Pisano,PI,62,0,2,0,0,2,0,1,0,0,1
2020,50023,Orciano Pisano,PI,63,0,4,1,0,5,0,4,1,0,5
2020,50023,Orciano Pisano,PI,64,0,1,0,0,1,1,2,0,1,4
2020,50023,Orciano Pisano,PI,65,1,2,1,0,4,0,3,0,1,4
2020,50023,Orciano Pisano,PI,66,2,6,0,0,8,1,5,0,0,6
2020,50023,Orciano Pisano,PI,67,0,4,1,0,5,0,4,2,1,7
2020,50023,Orciano Pisano,PI,68,0,4,1,0,5,0,4,0,0,4
2020,50023,Orciano Pisano,PI,69,0,2,0,0,2,0,3,0,4,7
2020,50023,Orciano Pisano,PI,70,0,7,0,1,8,0,2,0,2,4
2020,50023,Orciano Pisano,PI,71,1,1,0,0,2,0,6,1,0,7
2020,50023,Orciano Pisano,PI,72,0,4,0,0,4,0,1,0,2,3
2020,50023,Orciano Pisano,PI,73,0,4,0,0,4,0,3,0,1,4
2020,50023,Orciano Pisano,PI,74,0,2,1,0,3,0,3,0,1,4
2020,50023,Orciano Pisano,PI,75,0,4,0,1,5,0,0,0,2,2
2020,50023,Orciano Pisano,PI,76,0,1,0,0,1,1,0,0,0,1
2020,50023,Orciano Pisano,PI,77,1,3,0,0,4,0,0,0,3,3
2020,50023,Orciano Pisano,PI,78,0,1,0,1,2,0,3,0,1,4
2020,50023,Orciano Pisano,PI,79,1,2,0,0,3,0,2,0,3,5
2020,50023,Orciano Pisano,PI,80,0,0,0,0,0,1,0,0,3,4
2020,50023,Orciano Pisano,PI,81,0,1,0,0,1,0,0,0,2,2
2020,50023,Orciano Pisano,PI,82,0,2,0,0,2,0,4,0,2,6
2020,50023,Orciano Pisano,PI,83,1,5,0,0,6,0,0,0,1,1
2020,50023,Orciano Pisano,PI,84,0,1,0,0,1,0,1,0,0,1
2020,50023,Orciano Pisano,PI,85,0,1,0,2,3,0,0,0,2,2
2020,50023,Orciano Pisano,PI,86,0,1,0,1,2,0,1,0,1,2
2020,50023,Orciano Pisano,PI,87,0,1,0,1,2,0,1,1,2,4
2020,50023,Orciano Pisano,PI,88,0,2,0,0,2,0,0,0,5,5
2020,50023,Orciano Pisano,PI,89,0,0,0,0,0,0,0,0,1,1
2020,50023,Orciano Pisano,PI,90,0,0,0,0,0,0,0,0,1,1
2020,50023,Orciano Pisano,PI,91,0,0,0,1,1,1,1,0,3,5
2020,50023,Orciano Pisano,PI,92,0,0,0,0,0,0,0,0,1,1
2020,50023,Orciano Pisano,PI,93,0,1,0,0,1,0,1,0,2,3
2020,50023,Orciano Pisano,PI,94,0,0,0,0,0,0,1,0,0,1
2020,50023,Orciano Pisano,PI,95,0,0,0,0,0,0,0,0,0,0
2020,50023,Orciano Pisano,PI,96,0,1,0,0,1,0,0,0,0,0
2020,50023,Orciano Pisano,PI,97,0,0,0,0,0,0,0,0,0,0
2020,50023,Orciano Pisano,PI,98,0,0,0,0,0,0,0,0,1,1
2020,50023,Orciano Pisano,PI,99,0,0,0,0,0,0,0,0,0,0
2020,50023,Orciano Pisano,PI,100 e più,0,1,0,0,1,0,0,0,0,0
2020,50024,Palaia,PI,0,15,0,0,0,15,19,0,0,0,19
2020,50024,Palaia,PI,1,12,0,0,0,12,12,0,0,0,12
2020,50024,Palaia,PI,2,10,0,0,0,10,14,0,0,0,14
2020,50024,Palaia,PI,3,9,0,0,0,9,20,0,0,0,20
2020,50024,Palaia,PI,4,16,0,0,0,16,13,0,0,0,13
2020,50024,Palaia,PI,5,14,0,0,0,14,20,0,0,0,20
2020,50024,Palaia,PI,6,17,0,0,0,17,26,0,0,0,26
2020,50024,Palaia,PI,7,21,0,0,0,21,24,0,0,0,24
2020,50024,Palaia,PI,8,26,0,0,0,26,13,0,0,0,13
2020,50024,Palaia,PI,9,19,0,0,0,19,21,0,0,0,21
2020,50024,Palaia,PI,10,19,0,0,0,19,16,0,0,0,16
2020,50024,Palaia,PI,11,16,0,0,0,16,33,0,0,0,33
2020,50024,Palaia,PI,12,25,0,0,0,25,19,0,0,0,19
2020,50024,Palaia,PI,13,23,0,0,0,23,21,0,0,0,21
2020,50024,Palaia,PI,14,26,0,0,0,26,22,0,0,0,22
2020,50024,Palaia,PI,15,19,0,0,0,19,18,0,0,0,18
2020,50024,Palaia,PI,16,18,0,0,0,18,20,0,0,0,20
2020,50024,Palaia,PI,17,17,0,0,0,17,21,0,0,0,21
2020,50024,Palaia,PI,18,21,0,0,0,21,22,0,0,0,22
2020,50024,Palaia,PI,19,25,0,0,0,25,20,0,0,0,20
2020,50024,Palaia,PI,20,22,0,0,0,22,25,0,0,0,25
2020,50024,Palaia,PI,21,19,0,0,0,19,26,0,0,0,26
2020,50024,Palaia,PI,22,21,0,0,0,21,20,1,0,0,21
2020,50024,Palaia,PI,23,29,0,0,0,29,18,0,0,0,18
2020,50024,Palaia,PI,24,11,0,0,0,11,18,0,0,0,18
2020,50024,Palaia,PI,25,16,1,0,0,17,13,0,0,0,13
2020,50024,Palaia,PI,26,21,0,0,0,21,20,2,0,0,22
2020,50024,Palaia,PI,27,18,1,0,0,19,10,1,0,0,11
2020,50024,Palaia,PI,28,11,4,0,0,15,17,1,0,0,18
2020,50024,Palaia,PI,29,18,1,0,0,19,12,3,0,0,15
2020,50024,Palaia,PI,30,17,3,0,0,20,14,3,0,0,17
2020,50024,Palaia,PI,31,19,1,0,0,20,16,11,0,0,27
2020,50024,Palaia,PI,32,16,5,0,0,21,12,5,1,0,18
2020,50024,Palaia,PI,33,12,7,0,0,19,14,9,0,0,23
2020,50024,Palaia,PI,34,12,7,0,0,19,9,10,1,0,20
2020,50024,Palaia,PI,35,6,6,0,0,12,12,9,0,0,21
2020,50024,Palaia,PI,36,17,9,0,0,26,19,10,0,0,29
2020,50024,Palaia,PI,37,13,11,1,0,25,14,14,0,0,28
2020,50024,Palaia,PI,38,16,11,0,0,27,8,16,0,0,24
2020,50024,Palaia,PI,39,19,20,2,0,41,20,18,1,0,39
2020,50024,Palaia,PI,40,10,11,0,0,21,7,15,1,0,23
2020,50024,Palaia,PI,41,11,9,1,0,21,8,19,1,0,28
2020,50024,Palaia,PI,42,14,20,0,0,34,20,20,3,1,44
2020,50024,Palaia,PI,43,19,20,2,0,41,15,32,0,1,48
2020,50024,Palaia,PI,44,16,20,2,0,38,11,19,1,0,31
2020,50024,Palaia,PI,45,10,21,1,0,32,9,29,2,1,41
2020,50024,Palaia,PI,46,23,21,2,0,46,12,27,1,0,40
2020,50024,Palaia,PI,47,10,30,1,1,42,8,27,1,0,36
2020,50024,Palaia,PI,48,14,21,3,0,38,13,30,4,2,49
2020,50024,Palaia,PI,49,10,22,1,1,34,6,27,0,2,35
2020,50024,Palaia,PI,50,4,29,2,0,35,8,29,1,0,38
2020,50024,Palaia,PI,51,9,24,1,0,34,4,27,3,0,34
2020,50024,Palaia,PI,52,6,25,1,2,34,5,24,2,1,32
2020,50024,Palaia,PI,53,7,24,3,0,34,0,27,5,1,33
2020,50024,Palaia,PI,54,7,39,3,0,49,5,34,4,3,46
2020,50024,Palaia,PI,55,8,27,2,0,37,4,26,3,1,34
2020,50024,Palaia,PI,56,2,35,2,0,39,3,32,2,1,38
2020,50024,Palaia,PI,57,5,34,3,1,43,1,21,4,1,27
2020,50024,Palaia,PI,58,5,19,4,0,28,3,24,3,2,32
2020,50024,Palaia,PI,59,2,30,0,0,32,4,26,2,3,35
2020,50024,Palaia,PI,60,4,21,2,1,28,2,29,4,2,37
2020,50024,Palaia,PI,61,5,28,3,2,38,3,25,0,1,29
2020,50024,Palaia,PI,62,2,18,2,0,22,1,24,2,2,29
2020,50024,Palaia,PI,63,4,31,3,1,39,0,26,0,5,31
2020,50024,Palaia,PI,64,3,16,0,2,21,0,22,2,4,28
2020,50024,Palaia,PI,65,3,25,3,0,31,2,25,1,4,32
2020,50024,Palaia,PI,66,3,20,0,1,24,2,17,0,6,25
2020,50024,Palaia,PI,67,3,18,1,2,24,2,21,1,4,28
2020,50024,Palaia,PI,68,0,17,0,3,20,1,30,1,3,35
2020,50024,Palaia,PI,69,1,19,0,0,20,2,28,0,3,33
2020,50024,Palaia,PI,70,1,24,1,1,27,0,23,3,5,31
2020,50024,Palaia,PI,71,2,27,2,2,33,1,17,0,9,27
2020,50024,Palaia,PI,72,2,33,0,1,36,2,24,0,3,29
2020,50024,Palaia,PI,73,0,28,2,1,31,1,28,0,8,37
2020,50024,Palaia,PI,74,3,12,3,1,19,1,18,0,12,31
2020,50024,Palaia,PI,75,1,20,0,2,23,1,11,1,8,21
2020,50024,Palaia,PI,76,3,12,1,1,17,2,17,1,11,31
2020,50024,Palaia,PI,77,0,12,0,3,15,4,19,1,7,31
2020,50024,Palaia,PI,78,1,16,0,2,19,2,15,0,8,25
2020,50024,Palaia,PI,79,2,16,0,0,18,0,11,1,14,26
2020,50024,Palaia,PI,80,2,21,1,2,26,1,9,0,7,17
2020,50024,Palaia,PI,81,2,17,0,3,22,1,11,0,10,22
2020,50024,Palaia,PI,82,1,13,0,0,14,1,8,1,19,29
2020,50024,Palaia,PI,83,1,13,2,0,16,2,5,0,16,23
2020,50024,Palaia,PI,84,1,11,0,4,16,0,6,0,5,11
2020,50024,Palaia,PI,85,1,7,0,1,9,0,3,0,8,11
2020,50024,Palaia,PI,86,1,10,0,3,14,0,1,0,14,15
2020,50024,Palaia,PI,87,0,4,0,1,5,0,2,0,11,13
2020,50024,Palaia,PI,88,1,4,0,4,9,0,3,0,7,10
2020,50024,Palaia,PI,89,0,1,0,2,3,0,1,0,7,8
2020,50024,Palaia,PI,90,2,0,0,3,5,1,1,0,4,6
2020,50024,Palaia,PI,91,0,1,0,3,4,0,1,0,8,9
2020,50024,Palaia,PI,92,0,1,0,1,2,1,0,0,9,10
2020,50024,Palaia,PI,93,0,1,0,2,3,0,0,0,6,6
2020,50024,Palaia,PI,94,0,0,0,1,1,0,1,0,5,6
2020,50024,Palaia,PI,95,0,1,0,2,3,0,0,0,5,5
2020,50024,Palaia,PI,96,0,0,0,0,0,0,0,0,6,6
2020,50024,Palaia,PI,97,0,0,0,1,1,0,0,0,2,2
2020,50024,Palaia,PI,98,0,1,0,0,1,0,0,0,0,0
2020,50024,Palaia,PI,99,0,0,0,0,0,0,0,0,0,0
2020,50024,Palaia,PI,100 e più,0,0,0,0,0,0,0,0,1,1
2020,50025,Peccioli,PI,0,10,0,0,0,10,16,0,0,0,16
2020,50025,Peccioli,PI,1,15,0,0,0,15,15,0,0,0,15
2020,50025,Peccioli,PI,2,21,0,0,0,21,17,0,0,0,17
2020,50025,Peccioli,PI,3,13,0,0,0,13,16,0,0,0,16
2020,50025,Peccioli,PI,4,21,0,0,0,21,15,0,0,0,15
2020,50025,Peccioli,PI,5,15,0,0,0,15,12,0,0,0,12
2020,50025,Peccioli,PI,6,20,0,0,0,20,19,0,0,0,19
2020,50025,Peccioli,PI,7,15,0,0,0,15,23,0,0,0,23
2020,50025,Peccioli,PI,8,14,0,0,0,14,20,0,0,0,20
2020,50025,Peccioli,PI,9,22,0,0,0,22,15,0,0,0,15
2020,50025,Peccioli,PI,10,27,0,0,0,27,16,0,0,0,16
2020,50025,Peccioli,PI,11,19,0,0,0,19,24,0,0,0,24
2020,50025,Peccioli,PI,12,24,0,0,0,24,26,0,0,0,26
2020,50025,Peccioli,PI,13,30,0,0,0,30,25,0,0,0,25
2020,50025,Peccioli,PI,14,18,0,0,0,18,24,0,0,0,24
2020,50025,Peccioli,PI,15,26,0,0,0,26,22,0,0,0,22
2020,50025,Peccioli,PI,16,23,0,0,0,23,19,0,0,0,19
2020,50025,Peccioli,PI,17,23,0,0,0,23,26,0,0,0,26
2020,50025,Peccioli,PI,18,25,0,0,0,25,23,0,0,0,23
2020,50025,Peccioli,PI,19,19,0,0,0,19,17,0,0,0,17
2020,50025,Peccioli,PI,20,28,0,0,0,28,22,0,0,0,22
2020,50025,Peccioli,PI,21,20,0,0,0,20,6,0,0,0,6
2020,50025,Peccioli,PI,22,20,0,0,0,20,19,1,0,0,20
2020,50025,Peccioli,PI,23,22,0,0,0,22,20,0,0,0,20
2020,50025,Peccioli,PI,24,15,0,0,0,15,18,1,0,0,19
2020,50025,Peccioli,PI,25,16,1,0,0,17,14,0,0,0,14
2020,50025,Peccioli,PI,26,26,0,0,0,26,14,2,0,0,16
2020,50025,Peccioli,PI,27,21,0,0,0,21,15,4,1,0,20
2020,50025,Peccioli,PI,28,18,5,0,0,23,13,3,0,0,16
2020,50025,Peccioli,PI,29,21,0,0,0,21,16,7,0,0,23
2020,50025,Peccioli,PI,30,20,3,0,0,23,16,3,0,0,19
2020,50025,Peccioli,PI,31,15,6,0,0,21,19,5,0,0,24
2020,50025,Peccioli,PI,32,13,7,0,0,20,15,8,0,0,23
2020,50025,Peccioli,PI,33,14,5,0,0,19,10,6,1,0,17
2020,50025,Peccioli,PI,34,13,4,0,0,17,9,13,0,0,22
2020,50025,Peccioli,PI,35,9,6,0,0,15,8,14,1,0,23
2020,50025,Peccioli,PI,36,12,10,0,0,22,7,13,1,0,21
2020,50025,Peccioli,PI,37,11,6,0,0,17,8,9,0,1,18
2020,50025,Peccioli,PI,38,8,8,0,0,16,8,7,2,0,17
2020,50025,Peccioli,PI,39,14,18,0,0,32,14,20,0,0,34
2020,50025,Peccioli,PI,40,8,6,4,0,18,10,18,0,0,28
2020,50025,Peccioli,PI,41,13,16,1,0,30,12,19,0,0,31
2020,50025,Peccioli,PI,42,15,11,3,0,29,9,21,2,0,32
2020,50025,Peccioli,PI,43,9,21,0,0,30,10,19,2,0,31
2020,50025,Peccioli,PI,44,9,14,0,0,23,11,25,1,0,37
2020,50025,Peccioli,PI,45,15,16,2,0,33,17,23,1,1,42
2020,50025,Peccioli,PI,46,13,22,1,0,36,10,16,1,0,27
2020,50025,Peccioli,PI,47,13,20,1,0,34,14,26,2,2,44
2020,50025,Peccioli,PI,48,12,20,2,0,34,4,28,1,0,33
2020,50025,Peccioli,PI,49,14,35,2,0,51,6,35,2,0,43
2020,50025,Peccioli,PI,50,15,25,5,0,45,5,32,3,0,40
2020,50025,Peccioli,PI,51,7,21,0,0,28,5,28,3,0,36
2020,50025,Peccioli,PI,52,15,29,1,1,46,6,28,3,2,39
2020,50025,Peccioli,PI,53,6,33,3,0,42,6,26,2,0,34
2020,50025,Peccioli,PI,54,10,30,0,2,42,6,31,6,2,45
2020,50025,Peccioli,PI,55,7,27,3,0,37,8,33,2,2,45
2020,50025,Peccioli,PI,56,11,19,1,0,31,5,30,1,1,37
2020,50025,Peccioli,PI,57,7,25,1,0,33,4,35,3,0,42
2020,50025,Peccioli,PI,58,8,34,2,1,45,7,29,0,3,39
2020,50025,Peccioli,PI,59,5,37,0,1,43,6,32,3,3,44
2020,50025,Peccioli,PI,60,6,34,2,2,44,2,26,1,1,30
2020,50025,Peccioli,PI,61,5,28,2,0,35,5,21,2,0,28
2020,50025,Peccioli,PI,62,2,23,1,0,26,1,19,2,3,25
2020,50025,Peccioli,PI,63,2,18,1,3,24,2,27,1,2,32
2020,50025,Peccioli,PI,64,2,25,0,0,27,0,18,1,3,22
2020,50025,Peccioli,PI,65,6,16,4,1,27,0,32,2,4,38
2020,50025,Peccioli,PI,66,4,26,2,2,34,2,23,3,4,32
2020,50025,Peccioli,PI,67,2,21,2,1,26,0,23,0,2,25
2020,50025,Peccioli,PI,68,3,17,2,2,24,2,17,0,4,23
2020,50025,Peccioli,PI,69,2,27,0,1,30,2,26,0,4,32
2020,50025,Peccioli,PI,70,4,29,0,2,35,3,24,1,7,35
2020,50025,Peccioli,PI,71,2,27,0,1,30,0,26,1,3,30
2020,50025,Peccioli,PI,72,1,24,0,1,26,1,19,0,6,26
2020,50025,Peccioli,PI,73,0,21,0,2,23,0,24,1,7,32
2020,50025,Peccioli,PI,74,0,28,0,1,29,1,29,0,9,39
2020,50025,Peccioli,PI,75,1,19,1,4,25,0,25,1,6,32
2020,50025,Peccioli,PI,76,3,24,1,1,29,2,8,0,8,18
2020,50025,Peccioli,PI,77,1,22,1,2,26,1,14,0,14,29
2020,50025,Peccioli,PI,78,3,18,0,3,24,0,9,0,13,22
2020,50025,Peccioli,PI,79,4,11,0,1,16,0,10,1,11,22
2020,50025,Peccioli,PI,80,3,17,0,2,22,1,11,0,16,28
2020,50025,Peccioli,PI,81,2,17,0,7,26,2,10,0,26,38
2020,50025,Peccioli,PI,82,0,13,0,3,16,0,14,0,15,29
2020,50025,Peccioli,PI,83,0,10,1,0,11,2,9,0,19,30
2020,50025,Peccioli,PI,84,1,11,0,3,15,0,5,0,16,21
2020,50025,Peccioli,PI,85,0,12,0,2,14,0,9,0,15,24
2020,50025,Peccioli,PI,86,1,12,1,0,14,0,3,0,18,21
2020,50025,Peccioli,PI,87,0,8,0,5,13,0,1,0,16,17
2020,50025,Peccioli,PI,88,0,3,1,1,5,1,1,0,17,19
2020,50025,Peccioli,PI,89,0,4,0,0,4,1,1,0,16,18
2020,50025,Peccioli,PI,90,0,3,0,2,5,1,1,0,12,14
2020,50025,Peccioli,PI,91,0,2,0,0,2,0,0,0,9,9
2020,50025,Peccioli,PI,92,0,1,0,0,1,0,0,0,9,9
2020,50025,Peccioli,PI,93,0,0,0,0,0,2,0,0,7,9
2020,50025,Peccioli,PI,94,1,0,0,2,3,1,0,0,3,4
2020,50025,Peccioli,PI,95,0,0,0,2,2,0,0,0,3,3
2020,50025,Peccioli,PI,96,0,0,0,0,0,0,0,0,6,6
2020,50025,Peccioli,PI,97,0,0,0,1,1,2,0,0,2,4
2020,50025,Peccioli,PI,98,0,0,0,0,0,0,0,0,0,0
2020,50025,Peccioli,PI,99,0,0,0,0,0,0,0,0,1,1
2020,50025,Peccioli,PI,100 e più,0,0,0,0,0,0,0,0,1,1
2020,50026,Pisa,PI,0,289,0,0,0,289,269,0,0,0,269
2020,50026,Pisa,PI,1,278,0,0,0,278,279,0,0,0,279
2020,50026,Pisa,PI,2,292,0,0,0,292,269,0,0,0,269
2020,50026,Pisa,PI,3,319,0,0,0,319,331,0,0,0,331
2020,50026,Pisa,PI,4,333,0,0,0,333,311,0,0,0,311
2020,50026,Pisa,PI,5,314,0,0,0,314,295,0,0,0,295
2020,50026,Pisa,PI,6,345,0,0,0,345,336,0,0,0,336
2020,50026,Pisa,PI,7,319,0,0,0,319,328,0,0,0,328
2020,50026,Pisa,PI,8,337,0,0,0,337,340,0,0,0,340
2020,50026,Pisa,PI,9,325,0,0,0,325,349,0,0,0,349
2020,50026,Pisa,PI,10,347,0,0,0,347,355,0,0,0,355
2020,50026,Pisa,PI,11,346,0,0,0,346,330,0,0,0,330
2020,50026,Pisa,PI,12,368,0,0,0,368,364,0,0,0,364
2020,50026,Pisa,PI,13,365,0,0,0,365,344,0,0,0,344
2020,50026,Pisa,PI,14,332,0,0,0,332,343,0,0,0,343
2020,50026,Pisa,PI,15,362,0,0,0,362,325,0,0,0,325
2020,50026,Pisa,PI,16,364,0,0,0,364,362,0,0,0,362
2020,50026,Pisa,PI,17,369,0,0,0,369,316,0,0,0,316
2020,50026,Pisa,PI,18,341,0,0,0,341,346,0,0,0,346
2020,50026,Pisa,PI,19,378,0,0,0,378,349,4,0,0,353
2020,50026,Pisa,PI,20,405,1,0,0,406,372,5,0,0,377
2020,50026,Pisa,PI,21,501,4,0,0,505,422,12,0,0,434
2020,50026,Pisa,PI,22,497,5,0,0,502,418,16,1,0,435
2020,50026,Pisa,PI,23,477,1,0,0,479,397,27,0,0,424
2020,50026,Pisa,PI,24,497,4,0,0,501,411,31,0,0,443
2020,50026,Pisa,PI,25,471,15,0,0,486,438,57,2,0,497
2020,50026,Pisa,PI,26,510,19,0,0,529,420,52,0,1,473
2020,50026,Pisa,PI,27,502,25,0,0,529,457,52,0,0,509
2020,50026,Pisa,PI,28,619,47,0,0,666,453,97,0,0,550
2020,50026,Pisa,PI,29,593,56,1,0,650,449,109,5,1,564
2020,50026,Pisa,PI,30,560,54,1,0,616,473,125,1,0,599
2020,50026,Pisa,PI,31,565,87,0,0,654,417,136,3,0,556
2020,50026,Pisa,PI,32,554,113,1,1,669,386,191,7,2,586
2020,50026,Pisa,PI,33,488,135,4,0,629,341,183,4,1,530
2020,50026,Pisa,PI,34,389,142,2,0,535,338,208,8,0,554
2020,50026,Pisa,PI,35,400,202,3,0,610,316,249,9,0,577
2020,50026,Pisa,PI,36,413,218,5,0,637,286,253,9,2,550
2020,50026,Pisa,PI,37,335,240,4,0,581,274,259,12,1,546
2020,50026,Pisa,PI,38,356,246,8,0,612,243,285,18,0,548
2020,50026,Pisa,PI,39,344,265,12,0,624,245,286,20,3,554
2020,50026,Pisa,PI,40,308,287,6,0,605,214,311,20,1,546
2020,50026,Pisa,PI,41,289,290,14,0,596,255,294,15,5,569
2020,50026,Pisa,PI,42,312,318,13,2,646,210,331,26,5,575
2020,50026,Pisa,PI,43,280,289,20,0,595,252,297,16,4,569
2020,50026,Pisa,PI,44,318,309,17,1,649,213,366,27,5,613
2020,50026,Pisa,PI,45,270,369,19,0,660,228,366,37,7,638
2020,50026,Pisa,PI,46,265,384,27,4,682,227,476,52,4,759
2020,50026,Pisa,PI,47,263,367,32,2,665,231,390,49,8,679
2020,50026,Pisa,PI,48,255,411,21,3,692,216,460,53,6,735
2020,50026,Pisa,PI,49,249,404,28,1,682,206,461,54,11,732
2020,50026,Pisa,PI,50,244,365,40,1,652,187,430,57,7,681
2020,50026,Pisa,PI,51,205,407,54,3,670,167,413,62,13,656
2020,50026,Pisa,PI,52,198,408,39,2,648,160,429,55,13,660
2020,50026,Pisa,PI,53,188,418,50,5,664,180,458,90,21,752
2020,50026,Pisa,PI,54,180,422,43,3,649,122,458,75,19,674
2020,50026,Pisa,PI,55,192,435,54,6,690,138,470,88,21,717
2020,50026,Pisa,PI,56,132,437,73,7,652,118,491,80,27,716
2020,50026,Pisa,PI,57,121,433,49,5,608,132,447,77,31,687
2020,50026,Pisa,PI,58,101,396,51,8,556,102,473,57,39,672
2020,50026,Pisa,PI,59,89,437,49,9,586,104,450,78,30,662
2020,50026,Pisa,PI,60,102,402,49,9,564,90,411,82,27,610
2020,50026,Pisa,PI,61,79,395,35,12,521,85,419,52,44,601
2020,50026,Pisa,PI,62,81,407,50,11,551,78,375,49,42,545
2020,50026,Pisa,PI,63,63,362,34,16,476,90,414,60,58,622
2020,50026,Pisa,PI,64,66,416,33,13,529,74,403,62,55,595
2020,50026,Pisa,PI,65,74,354,28,16,472,60,337,63,60,520
2020,50026,Pisa,PI,66,50,371,26,16,464,62,419,47,54,582
2020,50026,Pisa,PI,67,47,363,26,20,457,64,403,56,62,587
2020,50026,Pisa,PI,68,35,344,28,17,424,51,356,51,69,527
2020,50026,Pisa,PI,69,34,363,28,20,446,37,347,46,68,500
2020,50026,Pisa,PI,70,46,367,18,19,451,63,403,54,89,609
2020,50026,Pisa,PI,71,43,419,27,27,517,62,382,58,103,605
2020,50026,Pisa,PI,72,40,386,26,43,495,52,373,45,130,600
2020,50026,Pisa,PI,73,40,393,16,35,484,49,412,46,122,630
2020,50026,Pisa,PI,74,34,451,22,43,550,49,438,54,180,721
2020,50026,Pisa,PI,75,24,343,12,32,411,50,300,28,129,507
2020,50026,Pisa,PI,76,23,328,9,40,400,39,294,25,177,536
2020,50026,Pisa,PI,77,15,307,11,35,368,32,293,27,192,544
2020,50026,Pisa,PI,78,16,285,14,45,361,31,261,15,180,487
2020,50026,Pisa,PI,79,19,279,12,34,344,28,230,21,221,500
2020,50026,Pisa,PI,80,11,309,8,38,366,46,256,27,267,596
2020,50026,Pisa,PI,81,19,250,7,53,330,31,223,17,235,506
2020,50026,Pisa,PI,82,18,235,7,46,306,35,185,16,252,488
2020,50026,Pisa,PI,83,17,227,8,53,305,29,153,15,275,472
2020,50026,Pisa,PI,84,9,183,5,56,253,25,118,8,237,388
2020,50026,Pisa,PI,85,7,199,5,48,259,35,97,5,234,371
2020,50026,Pisa,PI,86,11,147,3,44,205,31,73,14,228,346
2020,50026,Pisa,PI,87,5,133,6,35,179,19,58,9,223,309
2020,50026,Pisa,PI,88,8,105,2,44,159,15,41,4,227,287
2020,50026,Pisa,PI,89,5,87,0,33,126,25,34,6,175,240
2020,50026,Pisa,PI,90,7,66,2,38,113,17,30,3,207,257
2020,50026,Pisa,PI,91,3,46,0,30,79,18,24,3,165,210
2020,50026,Pisa,PI,92,2,43,2,27,74,13,17,2,127,159
2020,50026,Pisa,PI,93,2,20,0,32,54,13,8,2,115,138
2020,50026,Pisa,PI,94,1,19,0,21,41,9,4,4,104,121
2020,50026,Pisa,PI,95,0,14,0,15,29,8,5,2,79,94
2020,50026,Pisa,PI,96,2,11,1,14,28,7,1,0,54,62
2020,50026,Pisa,PI,97,1,1,0,6,8,6,1,1,43,51
2020,50026,Pisa,PI,98,0,4,0,6,10,2,1,0,33,36
2020,50026,Pisa,PI,99,0,2,0,3,5,3,0,0,25,28
2020,50026,Pisa,PI,100 e più,1,3,0,5,9,1,1,0,24,26
2020,50027,Pomarance,PI,0,18,0,0,0,18,11,0,0,0,11
2020,50027,Pomarance,PI,1,16,0,0,0,16,20,0,0,0,20
2020,50027,Pomarance,PI,2,21,0,0,0,21,17,0,0,0,17
2020,50027,Pomarance,PI,3,23,0,0,0,23,23,0,0,0,23
2020,50027,Pomarance,PI,4,19,0,0,0,19,22,0,0,0,22
2020,50027,Pomarance,PI,5,13,0,0,0,13,18,0,0,0,18
2020,50027,Pomarance,PI,6,17,0,0,0,17,12,0,0,0,12
2020,50027,Pomarance,PI,7,21,0,0,0,21,17,0,0,0,17
2020,50027,Pomarance,PI,8,17,0,0,0,17,24,0,0,0,24
2020,50027,Pomarance,PI,9,17,0,0,0,17,24,0,0,0,24
2020,50027,Pomarance,PI,10,23,0,0,0,23,10,0,0,0,10
2020,50027,Pomarance,PI,11,25,0,0,0,25,21,0,0,0,21
2020,50027,Pomarance,PI,12,25,0,0,0,25,22,0,0,0,22
2020,50027,Pomarance,PI,13,28,0,0,0,28,18,0,0,0,18
2020,50027,Pomarance,PI,14,26,0,0,0,26,15,0,0,0,15
2020,50027,Pomarance,PI,15,17,0,0,0,17,23,0,0,0,23
2020,50027,Pomarance,PI,16,23,0,0,0,23,21,0,0,0,21
2020,50027,Pomarance,PI,17,19,0,0,0,19,22,0,0,0,22
2020,50027,Pomarance,PI,18,27,0,0,0,27,13,0,0,0,13
2020,50027,Pomarance,PI,19,18,0,0,0,18,21,0,0,0,21
2020,50027,Pomarance,PI,20,22,0,0,0,22,21,0,0,0,21
2020,50027,Pomarance,PI,21,20,0,0,0,20,20,1,0,0,21
2020,50027,Pomarance,PI,22,25,0,0,0,25,18,2,0,0,20
2020,50027,Pomarance,PI,23,27,0,0,0,27,15,1,0,0,16
2020,50027,Pomarance,PI,24,19,0,0,0,19,28,2,0,0,30
2020,50027,Pomarance,PI,25,24,1,0,0,25,26,1,0,0,27
2020,50027,Pomarance,PI,26,22,0,0,0,22,17,5,0,0,22
2020,50027,Pomarance,PI,27,24,2,0,0,26,18,7,0,0,25
2020,50027,Pomarance,PI,28,19,4,0,0,23,21,4,0,0,25
2020,50027,Pomarance,PI,29,14,2,0,0,16,18,2,1,0,21
2020,50027,Pomarance,PI,30,24,3,0,0,27,17,4,1,0,22
2020,50027,Pomarance,PI,31,19,5,0,0,24,13,10,0,0,23
2020,50027,Pomarance,PI,32,22,2,0,0,24,13,8,0,0,21
2020,50027,Pomarance,PI,33,15,7,0,0,22,9,9,0,0,18
2020,50027,Pomarance,PI,34,28,11,0,0,39,13,12,0,0,25
2020,50027,Pomarance,PI,35,16,13,0,0,29,8,11,0,0,19
2020,50027,Pomarance,PI,36,18,11,0,0,29,11,12,0,0,23
2020,50027,Pomarance,PI,37,17,3,0,0,20,4,13,0,0,17
2020,50027,Pomarance,PI,38,14,19,0,0,33,6,17,1,0,24
2020,50027,Pomarance,PI,39,25,13,1,0,39,11,15,1,0,27
2020,50027,Pomarance,PI,40,14,6,0,0,20,8,15,1,0,24
2020,50027,Pomarance,PI,41,10,11,1,0,22,8,21,1,0,30
2020,50027,Pomarance,PI,42,17,18,0,0,35,14,18,1,0,33
2020,50027,Pomarance,PI,43,15,18,3,0,36,4,12,2,0,18
2020,50027,Pomarance,PI,44,7,21,4,0,32,14,22,1,1,38
2020,50027,Pomarance,PI,45,10,18,4,0,32,11,22,2,0,35
2020,50027,Pomarance,PI,46,22,19,0,0,41,8,27,3,0,38
2020,50027,Pomarance,PI,47,18,19,1,0,38,10,20,3,1,34
2020,50027,Pomarance,PI,48,10,26,1,0,37,9,25,2,0,36
2020,50027,Pomarance,PI,49,11,16,0,0,27,5,24,1,0,30
2020,50027,Pomarance,PI,50,9,27,4,1,41,4,22,1,0,27
2020,50027,Pomarance,PI,51,8,21,2,1,32,4,31,2,2,39
2020,50027,Pomarance,PI,52,11,24,1,0,36,7,31,1,0,39
2020,50027,Pomarance,PI,53,9,18,3,0,30,9,32,0,3,44
2020,50027,Pomarance,PI,54,7,36,3,0,46,6,38,0,1,45
2020,50027,Pomarance,PI,55,8,43,1,0,52,4,33,4,2,43
2020,50027,Pomarance,PI,56,5,30,1,0,36,8,39,1,1,49
2020,50027,Pomarance,PI,57,2,32,2,1,37,2,39,5,0,46
2020,50027,Pomarance,PI,58,7,30,2,0,39,3,42,2,4,51
2020,50027,Pomarance,PI,59,5,36,4,0,45,5,38,7,3,53
2020,50027,Pomarance,PI,60,5,42,0,0,47,1,39,3,2,45
2020,50027,Pomarance,PI,61,3,47,5,0,55,2,38,5,5,50
2020,50027,Pomarance,PI,62,5,32,7,0,44,5,37,3,4,49
2020,50027,Pomarance,PI,63,7,40,3,1,51,3,29,2,3,37
2020,50027,Pomarance,PI,64,5,29,2,0,36,0,27,1,6,34
2020,50027,Pomarance,PI,65,4,29,2,2,37,1,29,1,2,33
2020,50027,Pomarance,PI,66,3,25,4,0,32,1,34,2,6,43
2020,50027,Pomarance,PI,67,2,32,5,2,41,1,40,1,4,46
2020,50027,Pomarance,PI,68,6,25,1,2,34,3,22,1,2,28
2020,50027,Pomarance,PI,69,1,39,2,1,43,2,28,4,8,42
2020,50027,Pomarance,PI,70,3,34,2,1,40,2,33,4,8,47
2020,50027,Pomarance,PI,71,9,29,3,2,43,4,32,1,8,45
2020,50027,Pomarance,PI,72,3,40,2,3,48,2,39,3,8,52
2020,50027,Pomarance,PI,73,0,31,1,1,33,1,35,2,10,48
2020,50027,Pomarance,PI,74,4,31,2,0,37,1,32,0,10,43
2020,50027,Pomarance,PI,75,5,34,0,1,40,0,25,1,9,35
2020,50027,Pomarance,PI,76,0,19,1,1,21,1,15,2,7,25
2020,50027,Pomarance,PI,77,1,28,0,3,32,0,11,0,18,29
2020,50027,Pomarance,PI,78,2,29,0,5,36,1,26,1,6,34
2020,50027,Pomarance,PI,79,2,25,1,5,33,1,12,0,15,28
2020,50027,Pomarance,PI,80,4,23,0,2,29,2,18,0,17,37
2020,50027,Pomarance,PI,81,1,29,0,0,30,1,14,1,14,30
2020,50027,Pomarance,PI,82,5,26,1,6,38,0,16,0,25,41
2020,50027,Pomarance,PI,83,4,23,0,6,33,1,12,0,21,34
2020,50027,Pomarance,PI,84,2,15,0,6,23,0,8,0,24,32
2020,50027,Pomarance,PI,85,1,11,0,10,22,0,10,0,18,28
2020,50027,Pomarance,PI,86,1,10,0,4,15,0,5,1,10,16
2020,50027,Pomarance,PI,87,0,12,1,5,18,2,7,0,31,40
2020,50027,Pomarance,PI,88,3,9,0,5,17,2,5,0,22,29
2020,50027,Pomarance,PI,89,1,7,0,3,11,0,0,0,18,18
2020,50027,Pomarance,PI,90,0,7,0,2,9,2,1,0,19,22
2020,50027,Pomarance,PI,91,0,1,0,4,5,2,2,0,11,15
2020,50027,Pomarance,PI,92,2,3,0,3,8,1,0,0,17,18
2020,50027,Pomarance,PI,93,0,3,0,4,7,2,3,0,9,14
2020,50027,Pomarance,PI,94,1,1,0,2,4,0,0,0,7,7
2020,50027,Pomarance,PI,95,1,2,0,3,6,0,0,0,9,9
2020,50027,Pomarance,PI,96,1,0,0,0,1,0,0,0,8,8
2020,50027,Pomarance,PI,97,0,2,0,0,2,0,1,0,4,5
2020,50027,Pomarance,PI,98,0,0,0,0,0,0,0,0,4,4
2020,50027,Pomarance,PI,99,0,0,0,0,0,0,0,0,1,1
2020,50027,Pomarance,PI,100 e più,0,0,0,0,0,0,0,0,0,0
2020,50028,Ponsacco,PI,0,54,0,0,0,54,51,0,0,0,51
2020,50028,Ponsacco,PI,1,54,0,0,0,54,57,0,0,0,57
2020,50028,Ponsacco,PI,2,59,0,0,0,59,57,0,0,0,57
2020,50028,Ponsacco,PI,3,70,0,0,0,70,65,0,0,0,65
2020,50028,Ponsacco,PI,4,86,0,0,0,86,65,0,0,0,65
2020,50028,Ponsacco,PI,5,82,0,0,0,82,57,0,0,0,57
2020,50028,Ponsacco,PI,6,71,0,0,0,71,86,0,0,0,86
2020,50028,Ponsacco,PI,7,81,0,0,0,81,90,0,0,0,90
2020,50028,Ponsacco,PI,8,83,0,0,0,83,62,0,0,0,62
2020,50028,Ponsacco,PI,9,84,0,0,0,84,84,0,0,0,84
2020,50028,Ponsacco,PI,10,89,0,0,0,89,93,0,0,0,93
2020,50028,Ponsacco,PI,11,111,0,0,0,111,83,0,0,0,83
2020,50028,Ponsacco,PI,12,97,0,0,0,97,103,0,0,0,103
2020,50028,Ponsacco,PI,13,86,0,0,0,86,77,0,0,0,77
2020,50028,Ponsacco,PI,14,87,0,0,0,87,65,0,0,0,65
2020,50028,Ponsacco,PI,15,98,0,0,0,98,62,0,0,0,62
2020,50028,Ponsacco,PI,16,76,0,0,0,76,72,0,0,0,72
2020,50028,Ponsacco,PI,17,76,0,0,0,76,78,0,0,0,78
2020,50028,Ponsacco,PI,18,72,0,0,0,72,76,0,0,0,76
2020,50028,Ponsacco,PI,19,59,0,0,0,59,67,1,0,0,68
2020,50028,Ponsacco,PI,20,86,0,0,0,86,59,1,0,0,60
2020,50028,Ponsacco,PI,21,86,1,0,0,87,66,1,0,0,67
2020,50028,Ponsacco,PI,22,57,0,0,0,57,70,0,0,0,70
2020,50028,Ponsacco,PI,23,69,1,0,0,70,65,6,0,0,71
2020,50028,Ponsacco,PI,24,64,1,0,0,65,59,1,0,0,60
2020,50028,Ponsacco,PI,25,81,3,0,0,84,68,8,0,0,76
2020,50028,Ponsacco,PI,26,59,2,0,0,61,60,6,0,0,66
2020,50028,Ponsacco,PI,27,60,6,0,0,66,65,16,0,0,81
2020,50028,Ponsacco,PI,28,83,4,0,0,87,58,15,0,0,73
2020,50028,Ponsacco,PI,29,61,8,0,0,69,60,24,1,0,85
2020,50028,Ponsacco,PI,30,53,14,0,0,67,41,30,1,0,72
2020,50028,Ponsacco,PI,31,67,18,1,0,86,61,25,1,0,87
2020,50028,Ponsacco,PI,32,59,18,0,0,77,52,42,1,0,95
2020,50028,Ponsacco,PI,33,49,29,1,0,79,31,46,1,0,78
2020,50028,Ponsacco,PI,34,46,33,2,0,81,44,56,4,0,104
2020,50028,Ponsacco,PI,35,59,41,1,0,101,25,45,2,0,72
2020,50028,Ponsacco,PI,36,46,57,1,0,104,42,60,1,0,103
2020,50028,Ponsacco,PI,37,38,48,3,0,89,43,49,1,0,93
2020,50028,Ponsacco,PI,38,38,51,0,0,89,32,61,2,1,96
2020,50028,Ponsacco,PI,39,39,56,5,1,101,33,82,1,0,116
2020,50028,Ponsacco,PI,40,41,55,6,0,102,36,71,1,0,108
2020,50028,Ponsacco,PI,41,42,63,2,0,107,26,89,8,0,123
2020,50028,Ponsacco,PI,42,52,85,3,0,140,33,79,9,1,122
2020,50028,Ponsacco,PI,43,34,63,2,0,99,32,82,8,1,123
2020,50028,Ponsacco,PI,44,43,86,5,0,134,33,114,8,2,157
2020,50028,Ponsacco,PI,45,39,96,10,0,145,32,80,8,2,122
2020,50028,Ponsacco,PI,46,31,92,2,0,125,32,113,6,1,152
2020,50028,Ponsacco,PI,47,40,131,5,0,176,27,135,10,2,174
2020,50028,Ponsacco,PI,48,34,111,8,0,153,21,89,12,3,125
2020,50028,Ponsacco,PI,49,33,116,13,2,164,19,108,11,2,140
2020,50028,Ponsacco,PI,50,21,89,18,0,128,18,81,11,1,111
2020,50028,Ponsacco,PI,51,20,102,6,1,129,16,93,12,1,122
2020,50028,Ponsacco,PI,52,22,90,10,0,122,13,84,15,0,112
2020,50028,Ponsacco,PI,53,17,86,9,0,112,12,90,8,3,113
2020,50028,Ponsacco,PI,54,17,97,10,1,125,15,90,8,2,115
2020,50028,Ponsacco,PI,55,21,99,12,2,134,14,78,8,2,102
2020,50028,Ponsacco,PI,56,14,94,9,1,118,13,99,11,3,126
2020,50028,Ponsacco,PI,57,14,87,3,0,104,10,78,9,0,97
2020,50028,Ponsacco,PI,58,10,80,3,0,93,9,94,8,2,113
2020,50028,Ponsacco,PI,59,4,68,4,1,77,8,97,6,5,116
2020,50028,Ponsacco,PI,60,5,79,5,3,92,11,69,17,15,112
2020,50028,Ponsacco,PI,61,4,76,3,3,86,6,82,4,4,96
2020,50028,Ponsacco,PI,62,6,73,5,1,85,4,66,7,5,82
2020,50028,Ponsacco,PI,63,8,75,1,3,87,4,67,3,13,87
2020,50028,Ponsacco,PI,64,7,69,3,0,79,4,69,4,13,90
2020,50028,Ponsacco,PI,65,5,71,6,3,85,0,72,9,7,88
2020,50028,Ponsacco,PI,66,7,68,0,3,78,1,58,4,14,77
2020,50028,Ponsacco,PI,67,4,59,5,5,73,3,57,5,11,76
2020,50028,Ponsacco,PI,68,9,63,4,3,79,3,79,4,11,97
2020,50028,Ponsacco,PI,69,4,58,3,5,70,2,47,4,13,66
2020,50028,Ponsacco,PI,70,0,63,3,2,68,3,76,3,21,103
2020,50028,Ponsacco,PI,71,5,63,5,4,77,3,77,8,14,102
2020,50028,Ponsacco,PI,72,2,55,3,6,66,1,72,7,21,101
2020,50028,Ponsacco,PI,73,4,74,3,0,81,1,65,4,21,91
2020,50028,Ponsacco,PI,74,5,54,0,5,64,1,65,4,32,102
2020,50028,Ponsacco,PI,75,4,56,0,6,66,1,43,2,18,64
2020,50028,Ponsacco,PI,76,2,58,1,4,65,0,37,1,31,69
2020,50028,Ponsacco,PI,77,1,51,1,10,63,1,34,0,38,73
2020,50028,Ponsacco,PI,78,2,41,1,6,50,0,40,1,31,72
2020,50028,Ponsacco,PI,79,2,35,0,4,41,0,33,1,30,64
2020,50028,Ponsacco,PI,80,3,59,0,3,65,1,27,3,38,69
2020,50028,Ponsacco,PI,81,3,50,1,8,62,1,30,0,37,68
2020,50028,Ponsacco,PI,82,3,32,1,7,43,1,29,0,41,71
2020,50028,Ponsacco,PI,83,3,29,0,6,38,4,17,0,41,62
2020,50028,Ponsacco,PI,84,0,32,0,9,41,0,13,0,47,60
2020,50028,Ponsacco,PI,85,3,30,0,10,43,0,14,1,33,48
2020,50028,Ponsacco,PI,86,2,20,1,6,29,1,8,0,36,45
2020,50028,Ponsacco,PI,87,0,16,0,7,23,0,6,0,27,33
2020,50028,Ponsacco,PI,88,3,21,1,1,26,2,4,0,26,32
2020,50028,Ponsacco,PI,89,0,10,0,3,13,1,2,0,24,27
2020,50028,Ponsacco,PI,90,0,9,0,0,9,2,4,0,28,34
2020,50028,Ponsacco,PI,91,1,4,0,1,6,0,0,0,26,26
2020,50028,Ponsacco,PI,92,0,4,0,3,7,3,2,0,17,22
2020,50028,Ponsacco,PI,93,1,5,0,3,9,1,0,0,17,18
2020,50028,Ponsacco,PI,94,1,4,0,2,7,0,0,0,10,10
2020,50028,Ponsacco,PI,95,0,0,0,2,2,0,0,0,8,8
2020,50028,Ponsacco,PI,96,0,0,0,3,3,0,1,0,5,6
2020,50028,Ponsacco,PI,97,0,0,0,0,0,1,0,0,4,5
2020,50028,Ponsacco,PI,98,0,0,0,0,0,0,0,0,2,2
2020,50028,Ponsacco,PI,99,0,1,0,2,3,0,0,0,2,2
2020,50028,Ponsacco,PI,100 e più,0,1,0,2,3,0,0,0,2,2
2020,50029,Pontedera,PI,0,115,0,0,0,115,87,0,0,0,87
2020,50029,Pontedera,PI,1,121,0,0,0,121,112,0,0,0,112
2020,50029,Pontedera,PI,2,119,0,0,0,119,93,0,0,0,93
2020,50029,Pontedera,PI,3,132,0,0,0,132,118,0,0,0,118
2020,50029,Pontedera,PI,4,142,0,0,0,142,131,0,0,0,131
2020,50029,Pontedera,PI,5,139,0,0,0,139,141,0,0,0,141
2020,50029,Pontedera,PI,6,139,0,0,0,139,126,0,0,0,126
2020,50029,Pontedera,PI,7,127,0,0,0,127,130,0,0,0,130
2020,50029,Pontedera,PI,8,159,0,0,0,159,125,0,0,0,125
2020,50029,Pontedera,PI,9,127,0,0,0,127,147,0,0,0,147
2020,50029,Pontedera,PI,10,136,0,0,0,136,130,0,0,0,130
2020,50029,Pontedera,PI,11,152,0,0,0,152,132,0,0,0,132
2020,50029,Pontedera,PI,12,136,0,0,0,136,126,0,0,0,126
2020,50029,Pontedera,PI,13,163,0,0,0,163,150,0,0,0,150
2020,50029,Pontedera,PI,14,150,0,0,0,150,108,0,0,0,108
2020,50029,Pontedera,PI,15,107,0,0,0,107,114,0,0,0,114
2020,50029,Pontedera,PI,16,168,0,0,0,168,112,0,0,0,112
2020,50029,Pontedera,PI,17,123,0,0,0,123,116,0,0,0,116
2020,50029,Pontedera,PI,18,149,0,0,0,149,140,0,0,0,140
2020,50029,Pontedera,PI,19,137,0,0,0,137,128,2,0,0,130
2020,50029,Pontedera,PI,20,167,0,0,0,167,129,2,0,0,131
2020,50029,Pontedera,PI,21,157,0,0,0,157,126,5,0,0,131
2020,50029,Pontedera,PI,22,152,3,0,0,155,120,6,0,0,126
2020,50029,Pontedera,PI,23,151,1,0,0,152,124,16,0,0,140
2020,50029,Pontedera,PI,24,134,1,0,0,135,113,19,0,0,132
2020,50029,Pontedera,PI,25,142,3,0,0,146,133,17,0,0,150
2020,50029,Pontedera,PI,26,126,3,0,0,129,130,14,0,0,144
2020,50029,Pontedera,PI,27,132,5,0,0,137,109,29,0,0,139
2020,50029,Pontedera,PI,28,150,7,0,0,157,123,23,0,0,146
2020,50029,Pontedera,PI,29,131,14,1,0,146,88,29,0,0,117
2020,50029,Pontedera,PI,30,138,23,1,0,163,109,40,0,0,149
2020,50029,Pontedera,PI,31,113,29,1,0,143,107,49,3,0,159
2020,50029,Pontedera,PI,32,117,49,2,0,168,95,54,0,1,150
2020,50029,Pontedera,PI,33,129,39,2,0,170,73,59,2,1,135
2020,50029,Pontedera,PI,34,100,50,2,0,152,96,69,3,0,168
2020,50029,Pontedera,PI,35,100,60,2,0,162,84,102,6,0,194
2020,50029,Pontedera,PI,36,107,68,3,0,179,81,82,7,0,170
2020,50029,Pontedera,PI,37,87,76,2,0,165,58,108,2,0,168
2020,50029,Pontedera,PI,38,89,98,5,0,192,46,110,5,0,161
2020,50029,Pontedera,PI,39,89,82,3,0,175,55,103,3,0,161
2020,50029,Pontedera,PI,40,94,116,1,1,212,59,113,9,3,184
2020,50029,Pontedera,PI,41,98,133,10,0,241,53,136,10,0,199
2020,50029,Pontedera,PI,42,75,119,9,1,204,69,139,13,2,224
2020,50029,Pontedera,PI,43,91,135,7,0,233,49,169,13,1,232
2020,50029,Pontedera,PI,44,78,138,4,1,221,43,147,5,4,199
2020,50029,Pontedera,PI,45,88,141,5,0,234,67,177,11,2,257
2020,50029,Pontedera,PI,46,101,144,13,0,258,53,194,22,1,270
2020,50029,Pontedera,PI,47,82,179,18,1,281,50,180,11,2,243
2020,50029,Pontedera,PI,48,80,186,10,1,277,38,158,25,3,224
2020,50029,Pontedera,PI,49,65,168,8,0,242,42,174,19,3,239
2020,50029,Pontedera,PI,50,50,149,15,1,215,40,154,18,3,215
2020,50029,Pontedera,PI,51,51,162,19,0,232,39,175,25,7,247
2020,50029,Pontedera,PI,52,37,172,12,0,221,31,163,22,3,219
2020,50029,Pontedera,PI,53,47,159,19,2,227,27,147,21,10,205
2020,50029,Pontedera,PI,54,34,171,19,2,226,29,165,17,8,219
2020,50029,Pontedera,PI,55,37,165,15,2,219,23,178,25,10,236
2020,50029,Pontedera,PI,56,27,175,17,4,223,14,174,28,8,226
2020,50029,Pontedera,PI,57,35,137,11,1,185,24,153,23,11,211
2020,50029,Pontedera,PI,58,27,156,12,1,196,20,152,29,12,213
2020,50029,Pontedera,PI,59,26,156,25,0,207,17,128,20,14,180
2020,50029,Pontedera,PI,60,25,162,12,3,202,19,165,23,15,222
2020,50029,Pontedera,PI,61,21,170,11,6,208,15,149,21,14,199
2020,50029,Pontedera,PI,62,17,134,10,0,162,20,136,16,17,189
2020,50029,Pontedera,PI,63,16,152,9,3,180,21,134,20,23,198
2020,50029,Pontedera,PI,64,20,130,10,5,165,10,138,7,20,175
2020,50029,Pontedera,PI,65,12,166,12,3,193,9,156,16,17,198
2020,50029,Pontedera,PI,66,12,133,6,6,157,19,126,11,18,174
2020,50029,Pontedera,PI,67,16,133,5,10,164,12,130,9,29,180
2020,50029,Pontedera,PI,68,7,104,11,7,129,6,140,14,24,184
2020,50029,Pontedera,PI,69,15,140,9,5,169,8,116,9,24,157
2020,50029,Pontedera,PI,70,6,128,6,5,145,13,118,10,31,174
2020,50029,Pontedera,PI,71,9,109,7,15,140,6,128,10,40,184
2020,50029,Pontedera,PI,72,7,140,6,11,164,7,100,7,50,164
2020,50029,Pontedera,PI,73,8,118,7,7,140,10,124,13,40,187
2020,50029,Pontedera,PI,74,6,116,9,11,142,8,128,7,49,192
2020,50029,Pontedera,PI,75,5,98,5,18,126,3,99,11,48,161
2020,50029,Pontedera,PI,76,2,104,2,15,123,2,73,7,56,138
2020,50029,Pontedera,PI,77,4,95,2,8,109,4,86,5,52,147
2020,50029,Pontedera,PI,78,6,94,2,9,111,3,76,5,54,138
2020,50029,Pontedera,PI,79,8,88,5,12,113,2,71,3,62,138
2020,50029,Pontedera,PI,80,5,88,2,10,105,6,69,3,66,144
2020,50029,Pontedera,PI,81,5,96,3,11,115,4,70,1,77,152
2020,50029,Pontedera,PI,82,5,108,1,16,130,9,61,4,90,164
2020,50029,Pontedera,PI,83,1,68,0,16,85,5,43,3,61,112
2020,50029,Pontedera,PI,84,3,51,0,15,69,6,30,2,69,107
2020,50029,Pontedera,PI,85,4,47,0,17,68,3,21,1,69,94
2020,50029,Pontedera,PI,86,6,41,1,12,60,1,25,1,73,100
2020,50029,Pontedera,PI,87,3,39,0,17,59,5,14,0,75,94
2020,50029,Pontedera,PI,88,1,31,0,20,52,2,13,1,76,92
2020,50029,Pontedera,PI,89,2,31,1,11,45,2,15,0,73,90
2020,50029,Pontedera,PI,90,2,23,0,10,35,1,11,1,58,71
2020,50029,Pontedera,PI,91,2,19,1,5,27,1,7,0,59,67
2020,50029,Pontedera,PI,92,1,5,1,9,16,3,0,1,57,61
2020,50029,Pontedera,PI,93,0,10,0,10,20,1,1,0,33,35
2020,50029,Pontedera,PI,94,0,12,0,3,15,2,0,0,27,29
2020,50029,Pontedera,PI,95,0,2,0,1,3,0,0,0,25,25
2020,50029,Pontedera,PI,96,0,1,0,5,6,2,1,0,18,21
2020,50029,Pontedera,PI,97,0,1,0,4,5,0,0,0,9,9
2020,50029,Pontedera,PI,98,0,0,0,2,2,0,0,1,4,5
2020,50029,Pontedera,PI,99,0,0,0,0,0,1,0,0,8,9
2020,50029,Pontedera,PI,100 e più,0,0,0,2,2,0,0,0,3,3
2020,50030,Riparbella,PI,0,5,0,0,0,5,6,0,0,0,6
2020,50030,Riparbella,PI,1,3,0,0,0,3,8,0,0,0,8
2020,50030,Riparbella,PI,2,3,0,0,0,3,5,0,0,0,5
2020,50030,Riparbella,PI,3,7,0,0,0,7,7,0,0,0,7
2020,50030,Riparbella,PI,4,3,0,0,0,3,8,0,0,0,8
2020,50030,Riparbella,PI,5,7,0,0,0,7,4,0,0,0,4
2020,50030,Riparbella,PI,6,4,0,0,0,4,6,0,0,0,6
2020,50030,Riparbella,PI,7,7,0,0,0,7,3,0,0,0,3
2020,50030,Riparbella,PI,8,5,0,0,0,5,4,0,0,0,4
2020,50030,Riparbella,PI,9,7,0,0,0,7,8,0,0,0,8
2020,50030,Riparbella,PI,10,10,0,0,0,10,8,0,0,0,8
2020,50030,Riparbella,PI,11,11,0,0,0,11,8,0,0,0,8
2020,50030,Riparbella,PI,12,6,0,0,0,6,8,0,0,0,8
2020,50030,Riparbella,PI,13,9,0,0,0,9,9,0,0,0,9
2020,50030,Riparbella,PI,14,5,0,0,0,5,7,0,0,0,7
2020,50030,Riparbella,PI,15,11,0,0,0,11,6,0,0,0,6
2020,50030,Riparbella,PI,16,3,0,0,0,3,5,0,0,0,5
2020,50030,Riparbella,PI,17,6,0,0,0,6,6,0,0,0,6
2020,50030,Riparbella,PI,18,5,0,0,0,5,5,0,0,0,5
2020,50030,Riparbella,PI,19,8,0,0,0,8,5,0,0,0,5
2020,50030,Riparbella,PI,20,8,0,0,0,8,9,0,0,0,9
2020,50030,Riparbella,PI,21,3,0,0,0,3,10,0,0,0,10
2020,50030,Riparbella,PI,22,11,0,0,0,11,6,0,0,0,6
2020,50030,Riparbella,PI,23,11,0,0,0,11,5,0,0,0,5
2020,50030,Riparbella,PI,24,7,0,0,0,7,8,0,0,0,8
2020,50030,Riparbella,PI,25,10,0,0,0,10,4,0,0,0,4
2020,50030,Riparbella,PI,26,9,0,0,1,10,3,3,0,0,6
2020,50030,Riparbella,PI,27,5,0,0,0,5,6,3,0,0,9
2020,50030,Riparbella,PI,28,10,0,0,0,10,6,2,0,0,8
2020,50030,Riparbella,PI,29,8,1,0,0,9,6,1,0,0,7
2020,50030,Riparbella,PI,30,14,0,0,0,14,3,2,0,0,5
2020,50030,Riparbella,PI,31,9,5,0,0,14,6,4,0,0,10
2020,50030,Riparbella,PI,32,4,4,0,0,8,1,7,0,0,8
2020,50030,Riparbella,PI,33,5,2,0,0,7,4,6,0,0,10
2020,50030,Riparbella,PI,34,6,1,0,0,7,4,2,0,0,6
2020,50030,Riparbella,PI,35,5,2,0,0,7,5,3,1,0,9
2020,50030,Riparbella,PI,36,6,4,0,0,10,2,8,0,0,10
2020,50030,Riparbella,PI,37,5,7,0,0,12,1,2,1,0,4
2020,50030,Riparbella,PI,38,9,1,1,0,11,4,9,0,0,13
2020,50030,Riparbella,PI,39,5,7,1,0,13,4,4,0,0,8
2020,50030,Riparbella,PI,40,4,4,1,0,9,3,6,1,0,10
2020,50030,Riparbella,PI,41,3,4,0,0,7,4,10,0,0,14
2020,50030,Riparbella,PI,42,6,5,0,0,11,2,6,0,0,8
2020,50030,Riparbella,PI,43,4,10,0,0,14,1,6,2,0,9
2020,50030,Riparbella,PI,44,5,7,0,1,13,4,5,1,1,11
2020,50030,Riparbella,PI,45,3,8,0,0,11,5,6,0,0,11
2020,50030,Riparbella,PI,46,4,9,0,0,13,4,9,0,0,13
2020,50030,Riparbella,PI,47,2,5,0,0,7,4,10,3,0,17
2020,50030,Riparbella,PI,48,6,7,1,0,14,3,7,2,2,14
2020,50030,Riparbella,PI,49,3,9,1,0,13,3,6,0,0,9
2020,50030,Riparbella,PI,50,4,11,0,0,15,3,5,1,0,9
2020,50030,Riparbella,PI,51,4,8,0,1,13,2,10,2,2,16
2020,50030,Riparbella,PI,52,2,4,2,0,8,1,11,2,1,15
2020,50030,Riparbella,PI,53,1,8,2,0,11,3,8,0,0,11
2020,50030,Riparbella,PI,54,7,9,0,0,16,3,8,2,2,15
2020,50030,Riparbella,PI,55,3,15,2,0,20,2,10,0,2,14
2020,50030,Riparbella,PI,56,3,11,0,0,14,2,9,0,1,12
2020,50030,Riparbella,PI,57,4,9,3,0,16,1,9,0,1,11
2020,50030,Riparbella,PI,58,2,11,2,0,15,0,8,3,0,11
2020,50030,Riparbella,PI,59,0,7,1,0,8,3,10,2,2,17
2020,50030,Riparbella,PI,60,0,7,3,0,10,3,7,1,2,13
2020,50030,Riparbella,PI,61,0,11,0,0,11,0,5,1,0,6
2020,50030,Riparbella,PI,62,0,10,1,0,11,0,6,2,1,9
2020,50030,Riparbella,PI,63,1,1,0,0,2,3,9,1,0,13
2020,50030,Riparbella,PI,64,2,10,0,0,12,0,10,1,1,12
2020,50030,Riparbella,PI,65,0,5,0,0,5,0,4,0,0,4
2020,50030,Riparbella,PI,66,0,2,1,2,5,1,6,0,1,8
2020,50030,Riparbella,PI,67,1,8,0,3,12,0,6,0,2,8
2020,50030,Riparbella,PI,68,1,11,1,0,13,0,3,0,1,4
2020,50030,Riparbella,PI,69,1,10,1,0,12,1,1,1,1,4
2020,50030,Riparbella,PI,70,3,8,1,0,12,1,10,0,2,13
2020,50030,Riparbella,PI,71,1,6,0,0,7,0,10,2,1,13
2020,50030,Riparbella,PI,72,1,5,0,0,6,0,8,1,2,11
2020,50030,Riparbella,PI,73,0,3,1,1,5,0,9,1,2,12
2020,50030,Riparbella,PI,74,2,6,1,0,9,1,5,1,2,9
2020,50030,Riparbella,PI,75,0,7,1,0,8,0,1,0,2,3
2020,50030,Riparbella,PI,76,0,7,0,1,8,0,2,0,2,4
2020,50030,Riparbella,PI,77,0,5,0,1,6,0,8,0,3,11
2020,50030,Riparbella,PI,78,2,5,0,1,8,0,5,1,1,7
2020,50030,Riparbella,PI,79,0,6,0,1,7,1,5,0,4,10
2020,50030,Riparbella,PI,80,0,6,0,2,8,0,3,0,6,9
2020,50030,Riparbella,PI,81,1,4,0,1,6,0,1,1,6,8
2020,50030,Riparbella,PI,82,0,4,0,3,7,0,2,0,3,5
2020,50030,Riparbella,PI,83,0,2,0,3,5,0,1,1,7,9
2020,50030,Riparbella,PI,84,0,0,1,1,2,0,1,0,4,5
2020,50030,Riparbella,PI,85,0,2,0,2,4,0,1,0,4,5
2020,50030,Riparbella,PI,86,0,3,0,1,4,0,0,0,6,6
2020,50030,Riparbella,PI,87,0,3,0,0,3,0,0,0,5,5
2020,50030,Riparbella,PI,88,1,0,0,2,3,0,2,0,1,3
2020,50030,Riparbella,PI,89,0,2,0,2,4,0,1,0,3,4
2020,50030,Riparbella,PI,90,0,1,0,1,2,0,1,0,0,1
2020,50030,Riparbella,PI,91,0,0,0,1,1,0,0,0,3,3
2020,50030,Riparbella,PI,92,0,0,0,0,0,0,0,0,2,2
2020,50030,Riparbella,PI,93,0,1,0,0,1,0,0,0,1,1
2020,50030,Riparbella,PI,94,0,0,0,1,1,0,1,0,0,1
2020,50030,Riparbella,PI,95,0,0,0,0,0,1,0,0,0,1
2020,50030,Riparbella,PI,96,0,0,0,0,0,0,0,0,1,1
2020,50030,Riparbella,PI,97,0,0,0,1,1,0,0,0,0,0
2020,50030,Riparbella,PI,98,0,0,0,0,0,0,0,0,1,1
2020,50030,Riparbella,PI,99,0,0,0,0,0,0,0,0,1,1
2020,50030,Riparbella,PI,100 e più,0,0,0,0,0,0,0,0,0,0
2020,50031,San Giuliano Terme,PI,0,71,0,0,0,71,83,0,0,0,83
2020,50031,San Giuliano Terme,PI,1,67,0,0,0,67,103,0,0,0,103
2020,50031,San Giuliano Terme,PI,2,99,0,0,0,99,90,0,0,0,90
2020,50031,San Giuliano Terme,PI,3,100,0,0,0,100,92,0,0,0,92
2020,50031,San Giuliano Terme,PI,4,133,0,0,0,133,97,0,0,0,97
2020,50031,San Giuliano Terme,PI,5,128,0,0,0,128,90,0,0,0,90
2020,50031,San Giuliano Terme,PI,6,114,0,0,0,114,117,0,0,0,117
2020,50031,San Giuliano Terme,PI,7,130,0,0,0,130,114,0,0,0,114
2020,50031,San Giuliano Terme,PI,8,154,0,0,0,154,129,0,0,0,129
2020,50031,San Giuliano Terme,PI,9,166,0,0,0,166,112,0,0,0,112
2020,50031,San Giuliano Terme,PI,10,146,0,0,0,146,146,0,0,0,146
2020,50031,San Giuliano Terme,PI,11,136,0,0,0,136,136,0,0,0,136
2020,50031,San Giuliano Terme,PI,12,149,0,0,0,149,139,0,0,0,139
2020,50031,San Giuliano Terme,PI,13,161,0,0,0,161,145,0,0,0,145
2020,50031,San Giuliano Terme,PI,14,159,0,0,0,159,137,0,0,0,137
2020,50031,San Giuliano Terme,PI,15,163,0,0,0,163,135,0,0,0,135
2020,50031,San Giuliano Terme,PI,16,162,0,0,0,162,146,0,0,0,146
2020,50031,San Giuliano Terme,PI,17,149,0,0,0,149,131,0,0,0,131
2020,50031,San Giuliano Terme,PI,18,149,0,0,0,149,141,0,0,0,141
2020,50031,San Giuliano Terme,PI,19,140,0,0,0,140,142,0,0,0,142
2020,50031,San Giuliano Terme,PI,20,150,0,0,0,150,133,0,0,0,133
2020,50031,San Giuliano Terme,PI,21,146,0,0,0,146,138,2,0,0,140
2020,50031,San Giuliano Terme,PI,22,167,0,0,0,167,112,0,0,0,112
2020,50031,San Giuliano Terme,PI,23,175,2,0,0,177,108,2,0,0,110
2020,50031,San Giuliano Terme,PI,24,160,2,0,0,162,109,2,0,0,111
2020,50031,San Giuliano Terme,PI,25,132,2,0,0,134,135,1,0,0,136
2020,50031,San Giuliano Terme,PI,26,168,2,0,0,170,111,7,0,0,119
2020,50031,San Giuliano Terme,PI,27,147,1,0,0,148,107,16,0,1,125
2020,50031,San Giuliano Terme,PI,28,140,8,0,0,148,133,17,1,0,151
2020,50031,San Giuliano Terme,PI,29,139,8,0,0,147,116,20,0,0,136
2020,50031,San Giuliano Terme,PI,30,136,8,0,0,144,122,28,1,0,151
2020,50031,San Giuliano Terme,PI,31,127,20,0,0,147,113,42,0,0,155
2020,50031,San Giuliano Terme,PI,32,115,29,1,0,145,98,46,0,0,144
2020,50031,San Giuliano Terme,PI,33,116,31,0,0,147,74,54,1,0,129
2020,50031,San Giuliano Terme,PI,34,104,42,0,0,146,67,67,1,0,135
2020,50031,San Giuliano Terme,PI,35,93,54,0,0,147,80,64,3,0,147
2020,50031,San Giuliano Terme,PI,36,95,55,1,1,152,86,77,3,1,167
2020,50031,San Giuliano Terme,PI,37,96,70,1,0,167,78,98,6,0,182
2020,50031,San Giuliano Terme,PI,38,108,71,3,0,182,79,83,2,0,164
2020,50031,San Giuliano Terme,PI,39,89,63,3,0,155,44,84,8,0,136
2020,50031,San Giuliano Terme,PI,40,95,79,3,0,178,84,101,8,2,197
2020,50031,San Giuliano Terme,PI,41,81,76,6,0,164,64,105,10,0,180
2020,50031,San Giuliano Terme,PI,42,81,83,5,0,169,77,110,6,0,195
2020,50031,San Giuliano Terme,PI,43,97,107,6,0,211,77,121,15,1,215
2020,50031,San Giuliano Terme,PI,44,86,121,9,1,219,65,152,9,1,227
2020,50031,San Giuliano Terme,PI,45,80,108,10,0,198,66,136,15,1,218
2020,50031,San Giuliano Terme,PI,46,89,147,5,0,241,58,180,11,3,252
2020,50031,San Giuliano Terme,PI,47,70,160,14,0,244,53,190,16,1,260
2020,50031,San Giuliano Terme,PI,48,74,167,18,0,259,60,191,30,6,287
2020,50031,San Giuliano Terme,PI,49,64,172,17,2,255,50,186,19,1,256
2020,50031,San Giuliano Terme,PI,50,75,168,20,3,266,50,193,22,8,273
2020,50031,San Giuliano Terme,PI,51,55,178,19,2,254,35,195,20,4,254
2020,50031,San Giuliano Terme,PI,52,60,160,20,2,242,39,182,30,3,254
2020,50031,San Giuliano Terme,PI,53,55,178,12,2,248,50,212,27,9,298
2020,50031,San Giuliano Terme,PI,54,43,161,21,2,227,27,193,30,9,259
2020,50031,San Giuliano Terme,PI,55,50,165,28,1,244,25,197,28,8,258
2020,50031,San Giuliano Terme,PI,56,45,202,23,0,270,39,224,24,7,295
2020,50031,San Giuliano Terme,PI,57,36,182,15,5,238,34,192,29,9,264
2020,50031,San Giuliano Terme,PI,58,36,202,19,3,260,22,201,38,12,273
2020,50031,San Giuliano Terme,PI,59,25,205,12,4,246,21,202,23,17,263
2020,50031,San Giuliano Terme,PI,60,28,164,12,2,206,16,197,17,9,239
2020,50031,San Giuliano Terme,PI,61,13,175,15,6,210,12,166,16,12,207
2020,50031,San Giuliano Terme,PI,62,13,172,9,6,200,7,187,18,22,234
2020,50031,San Giuliano Terme,PI,63,17,175,7,4,203,13,153,14,14,194
2020,50031,San Giuliano Terme,PI,64,12,172,11,4,199,15,147,17,24,203
2020,50031,San Giuliano Terme,PI,65,9,121,12,6,148,9,162,15,13,199
2020,50031,San Giuliano Terme,PI,66,11,154,8,6,179,7,162,8,31,208
2020,50031,San Giuliano Terme,PI,67,10,153,3,4,170,10,128,10,29,177
2020,50031,San Giuliano Terme,PI,68,11,146,4,4,166,10,147,9,32,198
2020,50031,San Giuliano Terme,PI,69,8,140,9,7,164,10,138,10,31,189
2020,50031,San Giuliano Terme,PI,70,8,144,10,7,169,4,164,10,34,212
2020,50031,San Giuliano Terme,PI,71,7,155,9,13,184,10,152,11,45,218
2020,50031,San Giuliano Terme,PI,72,12,170,5,14,201,6,197,10,41,254
2020,50031,San Giuliano Terme,PI,73,5,181,2,13,201,8,164,12,51,235
2020,50031,San Giuliano Terme,PI,74,5,185,2,17,209,7,165,10,59,241
2020,50031,San Giuliano Terme,PI,75,8,129,2,8,147,5,120,3,42,170
2020,50031,San Giuliano Terme,PI,76,1,136,3,9,149,9,104,3,59,175
2020,50031,San Giuliano Terme,PI,77,6,152,6,13,177,7,96,4,71,178
2020,50031,San Giuliano Terme,PI,78,6,114,4,18,142,7,103,1,64,175
2020,50031,San Giuliano Terme,PI,79,4,108,4,12,128,5,91,7,68,171
2020,50031,San Giuliano Terme,PI,80,7,102,1,17,127,5,78,4,92,179
2020,50031,San Giuliano Terme,PI,81,8,104,1,18,131,7,93,3,91,194
2020,50031,San Giuliano Terme,PI,82,4,124,1,20,149,2,79,1,87,169
2020,50031,San Giuliano Terme,PI,83,1,75,2,21,99,7,54,2,101,164
2020,50031,San Giuliano Terme,PI,84,5,91,3,15,114,6,45,0,90,141
2020,50031,San Giuliano Terme,PI,85,2,54,0,15,71,2,42,0,97,141
2020,50031,San Giuliano Terme,PI,86,4,64,0,24,92,3,16,3,77,99
2020,50031,San Giuliano Terme,PI,87,0,40,0,18,58,2,16,3,80,101
2020,50031,San Giuliano Terme,PI,88,1,39,0,15,55,3,19,0,71,93
2020,50031,San Giuliano Terme,PI,89,1,24,0,11,36,1,10,3,56,70
2020,50031,San Giuliano Terme,PI,90,0,17,0,7,24,4,9,0,57,70
2020,50031,San Giuliano Terme,PI,91,0,17,0,18,35,0,4,0,41,45
2020,50031,San Giuliano Terme,PI,92,0,13,0,8,21,0,1,0,35,36
2020,50031,San Giuliano Terme,PI,93,0,5,0,8,13,4,0,0,38,42
2020,50031,San Giuliano Terme,PI,94,1,6,0,4,11,2,6,0,24,32
2020,50031,San Giuliano Terme,PI,95,0,4,0,7,11,2,1,0,27,30
2020,50031,San Giuliano Terme,PI,96,0,0,0,1,1,0,0,0,17,17
2020,50031,San Giuliano Terme,PI,97,1,2,0,4,7,0,0,0,9,9
2020,50031,San Giuliano Terme,PI,98,0,0,0,5,5,0,1,0,7,8
2020,50031,San Giuliano Terme,PI,99,0,1,0,1,2,0,0,0,5,5
2020,50031,San Giuliano Terme,PI,100 e più,0,0,0,1,1,0,0,0,2,2
2020,50032,San Miniato,PI,0,87,0,0,0,87,103,0,0,0,103
2020,50032,San Miniato,PI,1,103,0,0,0,103,102,0,0,0,102
2020,50032,San Miniato,PI,2,106,0,0,0,106,103,0,0,0,103
2020,50032,San Miniato,PI,3,114,0,0,0,114,91,0,0,0,91
2020,50032,San Miniato,PI,4,109,0,0,0,109,101,0,0,0,101
2020,50032,San Miniato,PI,5,111,0,0,0,111,118,0,0,0,118
2020,50032,San Miniato,PI,6,123,0,0,0,123,114,0,0,0,114
2020,50032,San Miniato,PI,7,124,0,0,0,124,118,0,0,0,118
2020,50032,San Miniato,PI,8,113,0,0,0,113,118,0,0,0,118
2020,50032,San Miniato,PI,9,135,0,0,0,135,125,0,0,0,125
2020,50032,San Miniato,PI,10,158,0,0,0,158,155,0,0,0,155
2020,50032,San Miniato,PI,11,138,0,0,0,138,114,0,0,0,114
2020,50032,San Miniato,PI,12,128,0,0,0,128,138,0,0,0,138
2020,50032,San Miniato,PI,13,116,0,0,0,116,146,0,0,0,146
2020,50032,San Miniato,PI,14,134,0,0,0,134,110,0,0,0,110
2020,50032,San Miniato,PI,15,148,0,0,0,148,125,0,0,0,125
2020,50032,San Miniato,PI,16,130,0,0,0,130,109,0,0,0,109
2020,50032,San Miniato,PI,17,125,0,0,0,125,124,0,0,0,124
2020,50032,San Miniato,PI,18,152,0,0,0,152,104,0,0,0,104
2020,50032,San Miniato,PI,19,142,0,0,0,142,110,0,0,0,110
2020,50032,San Miniato,PI,20,135,0,0,0,135,112,1,0,0,113
2020,50032,San Miniato,PI,21,147,0,0,0,147,116,2,0,0,118
2020,50032,San Miniato,PI,22,127,0,0,0,127,123,4,0,0,127
2020,50032,San Miniato,PI,23,140,0,0,0,140,135,10,0,0,145
2020,50032,San Miniato,PI,24,107,1,0,0,108,102,7,0,0,109
2020,50032,San Miniato,PI,25,132,3,0,0,135,98,11,0,0,109
2020,50032,San Miniato,PI,26,135,2,0,0,137,123,13,0,0,136
2020,50032,San Miniato,PI,27,115,4,0,0,119,116,10,0,0,126
2020,50032,San Miniato,PI,28,153,9,0,0,162,97,21,2,0,120
2020,50032,San Miniato,PI,29,131,13,0,0,144,91,37,0,0,128
2020,50032,San Miniato,PI,30,140,22,0,0,162,106,32,0,0,138
2020,50032,San Miniato,PI,31,106,27,0,0,133,85,49,0,0,134
2020,50032,San Miniato,PI,32,114,23,1,0,138,78,54,1,0,133
2020,50032,San Miniato,PI,33,101,39,0,0,140,85,49,2,0,136
2020,50032,San Miniato,PI,34,85,45,1,0,131,77,63,0,0,140
2020,50032,San Miniato,PI,35,94,42,1,0,137,67,80,4,0,151
2020,50032,San Miniato,PI,36,70,59,2,0,131,60,76,4,0,140
2020,50032,San Miniato,PI,37,95,49,3,0,148,77,86,4,0,167
2020,50032,San Miniato,PI,38,84,78,5,0,167,58,77,7,0,142
2020,50032,San Miniato,PI,39,76,90,4,0,170,69,113,6,0,188
2020,50032,San Miniato,PI,40,100,93,5,0,198,56,104,9,2,173
2020,50032,San Miniato,PI,41,97,88,4,0,189,53,137,11,2,203
2020,50032,San Miniato,PI,42,77,109,6,1,193,51,127,7,0,185
2020,50032,San Miniato,PI,43,74,124,8,0,206,52,129,15,2,199
2020,50032,San Miniato,PI,44,84,115,12,0,211,67,142,11,2,222
2020,50032,San Miniato,PI,45,81,150,3,1,236,59,169,12,5,245
2020,50032,San Miniato,PI,46,102,159,7,0,268,70,165,14,1,251
2020,50032,San Miniato,PI,47,62,123,10,0,195,49,157,17,3,226
2020,50032,San Miniato,PI,48,55,161,12,1,229,27,153,20,4,205
2020,50032,San Miniato,PI,49,52,146,12,1,211,49,180,16,1,246
2020,50032,San Miniato,PI,50,49,158,23,1,232,40,165,24,2,231
2020,50032,San Miniato,PI,51,52,163,11,0,226,35,173,11,6,225
2020,50032,San Miniato,PI,52,51,160,16,1,228,32,171,24,4,231
2020,50032,San Miniato,PI,53,32,161,18,0,211,21,190,23,6,240
2020,50032,San Miniato,PI,54,33,182,17,1,233,24,174,21,5,225
2020,50032,San Miniato,PI,55,38,188,10,0,236,14,192,17,4,227
2020,50032,San Miniato,PI,56,37,187,19,3,246,22,194,21,4,241
2020,50032,San Miniato,PI,57,27,170,14,4,215,14,154,20,12,200
2020,50032,San Miniato,PI,58,19,174,13,1,207,20,168,20,8,216
2020,50032,San Miniato,PI,59,12,156,14,0,182,18,178,19,12,227
2020,50032,San Miniato,PI,60,18,158,16,2,194,17,155,9,15,196
2020,50032,San Miniato,PI,61,14,150,16,4,184,10,158,11,7,186
2020,50032,San Miniato,PI,62,23,142,16,1,182,9,160,10,16,195
2020,50032,San Miniato,PI,63,8,148,6,4,166,10,140,12,18,180
2020,50032,San Miniato,PI,64,7,144,7,9,168,8,137,12,18,175
2020,50032,San Miniato,PI,65,11,124,7,11,153,11,135,6,18,170
2020,50032,San Miniato,PI,66,5,131,9,5,150,10,155,14,15,194
2020,50032,San Miniato,PI,67,10,138,5,7,160,12,127,9,18,166
2020,50032,San Miniato,PI,68,10,128,7,12,157,2,106,2,27,137
2020,50032,San Miniato,PI,69,3,128,5,13,149,1,145,3,23,172
2020,50032,San Miniato,PI,70,8,128,6,1,143,0,115,6,31,152
2020,50032,San Miniato,PI,71,10,120,4,11,145,8,123,7,34,172
2020,50032,San Miniato,PI,72,4,151,2,9,166,4,125,12,44,185
2020,50032,San Miniato,PI,73,7,149,4,8,168,4,140,6,51,201
2020,50032,San Miniato,PI,74,8,143,2,12,165,9,124,3,49,185
2020,50032,San Miniato,PI,75,7,100,1,8,116,5,92,6,51,154
2020,50032,San Miniato,PI,76,4,98,3,7,112,5,74,3,45,127
2020,50032,San Miniato,PI,77,7,112,2,13,134,6,87,3,57,153
2020,50032,San Miniato,PI,78,5,81,3,17,106,2,78,4,52,136
2020,50032,San Miniato,PI,79,3,98,5,15,121,5,66,1,56,128
2020,50032,San Miniato,PI,80,3,88,2,14,107,2,69,3,64,138
2020,50032,San Miniato,PI,81,6,91,3,11,111,3,66,1,63,133
2020,50032,San Miniato,PI,82,6,88,0,20,114,3,62,0,80,145
2020,50032,San Miniato,PI,83,1,69,1,16,87,2,46,3,74,125
2020,50032,San Miniato,PI,84,3,53,1,17,74,5,33,0,67,105
2020,50032,San Miniato,PI,85,6,74,0,18,98,5,27,0,103,135
2020,50032,San Miniato,PI,86,4,37,0,13,54,1,25,1,78,105
2020,50032,San Miniato,PI,87,4,34,0,15,53,4,10,0,70,84
2020,50032,San Miniato,PI,88,1,32,0,10,43,1,8,0,63,72
2020,50032,San Miniato,PI,89,2,21,1,7,31,2,9,0,58,69
2020,50032,San Miniato,PI,90,2,19,1,15,37,3,5,0,46,54
2020,50032,San Miniato,PI,91,1,12,1,6,20,2,7,0,48,57
2020,50032,San Miniato,PI,92,1,7,1,7,16,1,3,0,39,43
2020,50032,San Miniato,PI,93,1,10,0,7,18,1,2,0,31,34
2020,50032,San Miniato,PI,94,2,6,0,7,15,0,2,1,17,20
2020,50032,San Miniato,PI,95,1,3,0,0,4,0,0,0,25,25
2020,50032,San Miniato,PI,96,0,0,0,2,2,0,0,0,15,15
2020,50032,San Miniato,PI,97,0,1,0,0,1,0,0,0,13,13
2020,50032,San Miniato,PI,98,0,0,0,1,1,0,0,0,7,7
2020,50032,San Miniato,PI,99,0,0,0,0,0,0,0,0,6,6
2020,50032,San Miniato,PI,100 e più,0,0,0,1,1,0,0,0,5,5
2020,50033,Santa Croce sull'Arno,PI,0,76,0,0,0,76,70,0,0,0,70
2020,50033,Santa Croce sull'Arno,PI,1,70,0,0,0,70,63,0,0,0,63
2020,50033,Santa Croce sull'Arno,PI,2,69,0,0,0,69,73,0,0,0,73
2020,50033,Santa Croce sull'Arno,PI,3,78,0,0,0,78,66,0,0,0,66
2020,50033,Santa Croce sull'Arno,PI,4,83,0,0,0,83,71,0,0,0,71
2020,50033,Santa Croce sull'Arno,PI,5,80,0,0,0,80,93,0,0,0,93
2020,50033,Santa Croce sull'Arno,PI,6,88,0,0,0,88,83,0,0,0,83
2020,50033,Santa Croce sull'Arno,PI,7,71,0,0,0,71,81,0,0,0,81
2020,50033,Santa Croce sull'Arno,PI,8,70,0,0,0,70,94,0,0,0,94
2020,50033,Santa Croce sull'Arno,PI,9,79,0,0,0,79,69,0,0,0,69
2020,50033,Santa Croce sull'Arno,PI,10,89,0,0,0,89,73,0,0,0,73
2020,50033,Santa Croce sull'Arno,PI,11,82,0,0,0,82,71,0,0,0,71
2020,50033,Santa Croce sull'Arno,PI,12,92,0,0,0,92,66,0,0,0,66
2020,50033,Santa Croce sull'Arno,PI,13,65,0,0,0,65,64,0,0,0,64
2020,50033,Santa Croce sull'Arno,PI,14,62,0,0,0,62,64,0,0,0,64
2020,50033,Santa Croce sull'Arno,PI,15,79,0,0,0,79,69,0,0,0,69
2020,50033,Santa Croce sull'Arno,PI,16,65,0,0,0,65,62,0,0,0,62
2020,50033,Santa Croce sull'Arno,PI,17,67,0,0,0,67,71,0,0,0,71
2020,50033,Santa Croce sull'Arno,PI,18,88,0,0,0,88,60,0,0,0,60
2020,50033,Santa Croce sull'Arno,PI,19,95,1,0,0,96,63,0,0,0,63
2020,50033,Santa Croce sull'Arno,PI,20,111,0,0,0,111,69,2,0,0,71
2020,50033,Santa Croce sull'Arno,PI,21,77,0,0,0,77,72,2,0,0,74
2020,50033,Santa Croce sull'Arno,PI,22,77,0,0,0,77,56,3,0,0,59
2020,50033,Santa Croce sull'Arno,PI,23,74,0,0,0,74,57,10,0,0,67
2020,50033,Santa Croce sull'Arno,PI,24,73,3,0,0,76,65,11,0,0,76
2020,50033,Santa Croce sull'Arno,PI,25,62,3,0,0,65,65,14,0,0,79
2020,50033,Santa Croce sull'Arno,PI,26,72,5,0,0,77,59,7,0,0,66
2020,50033,Santa Croce sull'Arno,PI,27,88,8,0,0,96,59,8,0,0,67
2020,50033,Santa Croce sull'Arno,PI,28,72,9,0,0,81,57,13,0,0,70
2020,50033,Santa Croce sull'Arno,PI,29,72,7,0,0,79,63,17,0,0,80
2020,50033,Santa Croce sull'Arno,PI,30,72,13,0,0,85,60,19,0,0,79
2020,50033,Santa Croce sull'Arno,PI,31,58,14,0,0,72,55,19,0,0,74
2020,50033,Santa Croce sull'Arno,PI,32,54,21,1,0,76,37,26,0,0,63
2020,50033,Santa Croce sull'Arno,PI,33,48,18,0,0,66,41,39,0,1,81
2020,50033,Santa Croce sull'Arno,PI,34,54,24,0,0,78,37,31,3,0,71
2020,50033,Santa Croce sull'Arno,PI,35,53,21,2,0,76,45,39,0,0,84
2020,50033,Santa Croce sull'Arno,PI,36,55,28,0,0,83,52,39,2,0,93
2020,50033,Santa Croce sull'Arno,PI,37,52,23,3,0,78,42,51,2,0,95
2020,50033,Santa Croce sull'Arno,PI,38,56,44,3,0,103,37,43,1,0,81
2020,50033,Santa Croce sull'Arno,PI,39,63,48,0,0,111,44,54,2,0,100
2020,50033,Santa Croce sull'Arno,PI,40,51,58,1,0,110,46,62,2,0,110
2020,50033,Santa Croce sull'Arno,PI,41,67,52,0,1,120,27,51,5,0,83
2020,50033,Santa Croce sull'Arno,PI,42,65,46,3,0,114,25,73,4,0,102
2020,50033,Santa Croce sull'Arno,PI,43,55,66,1,0,122,46,60,2,0,108
2020,50033,Santa Croce sull'Arno,PI,44,60,57,1,0,118,38,56,6,0,100
2020,50033,Santa Croce sull'Arno,PI,45,49,54,3,1,107,28,61,3,3,95
2020,50033,Santa Croce sull'Arno,PI,46,57,70,6,0,133,28,83,6,1,118
2020,50033,Santa Croce sull'Arno,PI,47,45,61,4,0,110,25,82,6,0,113
2020,50033,Santa Croce sull'Arno,PI,48,44,72,7,0,123,20,74,7,1,102
2020,50033,Santa Croce sull'Arno,PI,49,41,88,1,0,130,24,66,10,2,102
2020,50033,Santa Croce sull'Arno,PI,50,40,75,5,2,122,25,75,6,2,108
2020,50033,Santa Croce sull'Arno,PI,51,47,95,6,0,148,24,76,7,1,108
2020,50033,Santa Croce sull'Arno,PI,52,39,84,4,1,128,21,87,7,3,118
2020,50033,Santa Croce sull'Arno,PI,53,19,80,6,2,107,16,66,8,4,94
2020,50033,Santa Croce sull'Arno,PI,54,39,79,6,0,124,20,73,10,5,108
2020,50033,Santa Croce sull'Arno,PI,55,28,66,7,1,102,14,73,5,5,97
2020,50033,Santa Croce sull'Arno,PI,56,29,71,6,0,106,13,77,10,8,108
2020,50033,Santa Croce sull'Arno,PI,57,24,69,7,0,100,7,73,12,5,97
2020,50033,Santa Croce sull'Arno,PI,58,25,91,3,1,120,12,70,8,3,93
2020,50033,Santa Croce sull'Arno,PI,59,16,84,8,0,108,16,75,9,5,105
2020,50033,Santa Croce sull'Arno,PI,60,25,82,8,1,116,18,53,12,5,88
2020,50033,Santa Croce sull'Arno,PI,61,16,77,3,4,100,9,78,6,11,104
2020,50033,Santa Croce sull'Arno,PI,62,25,72,8,2,107,10,63,7,3,83
2020,50033,Santa Croce sull'Arno,PI,63,24,62,1,3,90,14,63,6,5,88
2020,50033,Santa Croce sull'Arno,PI,64,10,63,3,3,79,16,66,7,8,97
2020,50033,Santa Croce sull'Arno,PI,65,4,65,7,0,76,5,61,5,6,77
2020,50033,Santa Croce sull'Arno,PI,66,9,60,5,3,77,14,64,6,10,94
2020,50033,Santa Croce sull'Arno,PI,67,7,50,4,4,65,6,45,6,7,64
2020,50033,Santa Croce sull'Arno,PI,68,5,58,5,5,73,7,41,3,15,66
2020,50033,Santa Croce sull'Arno,PI,69,8,48,3,6,65,9,42,5,12,68
2020,50033,Santa Croce sull'Arno,PI,70,9,67,3,5,84,9,56,5,7,77
2020,50033,Santa Croce sull'Arno,PI,71,7,49,4,6,66,4,56,4,9,73
2020,50033,Santa Croce sull'Arno,PI,72,4,56,0,6,66,3,65,3,19,90
2020,50033,Santa Croce sull'Arno,PI,73,4,65,2,6,77,4,56,5,27,92
2020,50033,Santa Croce sull'Arno,PI,74,3,53,2,2,60,6,43,4,17,70
2020,50033,Santa Croce sull'Arno,PI,75,5,46,1,4,56,2,43,1,24,70
2020,50033,Santa Croce sull'Arno,PI,76,4,38,1,5,48,5,32,1,27,65
2020,50033,Santa Croce sull'Arno,PI,77,3,31,0,4,38,6,24,1,31,62
2020,50033,Santa Croce sull'Arno,PI,78,5,35,0,6,46,1,22,2,27,52
2020,50033,Santa Croce sull'Arno,PI,79,2,27,0,4,33,3,22,1,25,51
2020,50033,Santa Croce sull'Arno,PI,80,1,28,2,6,37,3,29,1,38,71
2020,50033,Santa Croce sull'Arno,PI,81,1,43,0,7,51,2,28,0,43,73
2020,50033,Santa Croce sull'Arno,PI,82,3,32,0,9,44,1,22,0,39,62
2020,50033,Santa Croce sull'Arno,PI,83,2,36,1,5,44,4,20,0,26,50
2020,50033,Santa Croce sull'Arno,PI,84,1,23,1,9,34,5,14,2,29,50
2020,50033,Santa Croce sull'Arno,PI,85,0,17,0,10,27,1,14,0,30,45
2020,50033,Santa Croce sull'Arno,PI,86,2,19,0,5,26,3,13,1,41,58
2020,50033,Santa Croce sull'Arno,PI,87,0,15,0,9,24,1,8,0,32,41
2020,50033,Santa Croce sull'Arno,PI,88,0,10,0,2,12,0,4,0,40,44
2020,50033,Santa Croce sull'Arno,PI,89,0,11,0,6,17,0,1,0,34,35
2020,50033,Santa Croce sull'Arno,PI,90,2,7,0,6,15,1,9,0,25,35
2020,50033,Santa Croce sull'Arno,PI,91,1,8,0,3,12,0,3,0,20,23
2020,50033,Santa Croce sull'Arno,PI,92,0,4,0,3,7,0,3,0,15,18
2020,50033,Santa Croce sull'Arno,PI,93,0,3,0,3,6,0,0,1,12,13
2020,50033,Santa Croce sull'Arno,PI,94,0,1,0,0,1,0,0,0,12,12
2020,50033,Santa Croce sull'Arno,PI,95,0,4,0,1,5,1,2,0,8,11
2020,50033,Santa Croce sull'Arno,PI,96,0,0,0,1,1,2,0,0,7,9
2020,50033,Santa Croce sull'Arno,PI,97,0,1,0,0,1,1,0,0,5,6
2020,50033,Santa Croce sull'Arno,PI,98,0,1,0,0,1,0,1,0,3,4
2020,50033,Santa Croce sull'Arno,PI,99,0,0,0,0,0,0,1,0,0,1
2020,50033,Santa Croce sull'Arno,PI,100 e più,0,0,0,1,1,0,1,0,1,2
2020,50034,Santa Luce,PI,0,3,0,0,0,3,3,0,0,0,3
2020,50034,Santa Luce,PI,1,2,0,0,0,2,4,0,0,0,4
2020,50034,Santa Luce,PI,2,5,0,0,0,5,2,0,0,0,2
2020,50034,Santa Luce,PI,3,5,0,0,0,5,6,0,0,0,6
2020,50034,Santa Luce,PI,4,3,0,0,0,3,2,0,0,0,2
2020,50034,Santa Luce,PI,5,7,0,0,0,7,3,0,0,0,3
2020,50034,Santa Luce,PI,6,4,0,0,0,4,8,0,0,0,8
2020,50034,Santa Luce,PI,7,1,0,0,0,1,2,0,0,0,2
2020,50034,Santa Luce,PI,8,5,0,0,0,5,8,0,0,0,8
2020,50034,Santa Luce,PI,9,9,0,0,0,9,7,0,0,0,7
2020,50034,Santa Luce,PI,10,9,0,0,0,9,1,0,0,0,1
2020,50034,Santa Luce,PI,11,2,0,0,0,2,6,0,0,0,6
2020,50034,Santa Luce,PI,12,9,0,0,0,9,6,0,0,0,6
2020,50034,Santa Luce,PI,13,7,0,0,0,7,4,0,0,0,4
2020,50034,Santa Luce,PI,14,11,0,0,0,11,5,0,0,0,5
2020,50034,Santa Luce,PI,15,11,0,0,0,11,4,0,0,0,4
2020,50034,Santa Luce,PI,16,13,0,0,0,13,4,0,0,0,4
2020,50034,Santa Luce,PI,17,5,0,0,0,5,6,0,0,0,6
2020,50034,Santa Luce,PI,18,11,0,0,0,11,4,0,0,0,4
2020,50034,Santa Luce,PI,19,6,0,0,0,6,4,0,0,0,4
2020,50034,Santa Luce,PI,20,8,0,0,0,8,8,0,0,0,8
2020,50034,Santa Luce,PI,21,9,0,0,0,9,9,0,0,0,9
2020,50034,Santa Luce,PI,22,6,0,0,0,6,5,0,0,0,5
2020,50034,Santa Luce,PI,23,7,0,0,0,7,2,0,0,0,2
2020,50034,Santa Luce,PI,24,3,0,0,0,3,6,0,0,0,6
2020,50034,Santa Luce,PI,25,3,0,0,0,3,4,0,0,0,4
2020,50034,Santa Luce,PI,26,9,0,0,0,9,5,0,0,0,5
2020,50034,Santa Luce,PI,27,7,0,0,0,7,2,0,0,0,2
2020,50034,Santa Luce,PI,28,8,0,0,0,8,5,0,0,0,5
2020,50034,Santa Luce,PI,29,7,0,0,0,7,6,0,0,0,6
2020,50034,Santa Luce,PI,30,7,0,0,0,7,8,1,0,0,9
2020,50034,Santa Luce,PI,31,4,0,0,0,4,5,1,0,0,6
2020,50034,Santa Luce,PI,32,3,2,0,0,5,6,0,0,0,6
2020,50034,Santa Luce,PI,33,5,2,0,0,7,7,1,0,0,8
2020,50034,Santa Luce,PI,34,3,0,0,0,3,3,5,0,0,8
2020,50034,Santa Luce,PI,35,5,1,0,0,6,3,3,1,0,7
2020,50034,Santa Luce,PI,36,6,3,0,0,9,5,6,1,0,12
2020,50034,Santa Luce,PI,37,6,0,0,0,6,6,9,3,0,18
2020,50034,Santa Luce,PI,38,2,3,0,0,5,7,3,0,0,10
2020,50034,Santa Luce,PI,39,6,2,0,0,8,9,6,1,0,16
2020,50034,Santa Luce,PI,40,3,1,1,0,5,7,3,2,0,12
2020,50034,Santa Luce,PI,41,2,5,0,0,7,7,7,0,0,14
2020,50034,Santa Luce,PI,42,4,13,0,0,17,4,10,0,0,14
2020,50034,Santa Luce,PI,43,7,5,1,0,13,5,7,1,0,13
2020,50034,Santa Luce,PI,44,4,5,1,0,10,1,12,1,0,14
2020,50034,Santa Luce,PI,45,5,8,1,0,14,6,10,4,0,20
2020,50034,Santa Luce,PI,46,4,9,0,0,13,2,6,0,1,9
2020,50034,Santa Luce,PI,47,6,7,0,0,13,7,8,0,0,15
2020,50034,Santa Luce,PI,48,6,9,1,0,16,0,14,1,0,15
2020,50034,Santa Luce,PI,49,3,15,1,0,19,4,9,1,0,14
2020,50034,Santa Luce,PI,50,3,9,2,0,14,3,10,0,0,13
2020,50034,Santa Luce,PI,51,4,10,0,0,14,3,5,0,0,8
2020,50034,Santa Luce,PI,52,3,9,3,0,15,1,12,0,1,14
2020,50034,Santa Luce,PI,53,2,8,1,0,11,1,13,0,1,15
2020,50034,Santa Luce,PI,54,5,13,1,0,19,2,13,3,0,18
2020,50034,Santa Luce,PI,55,1,8,2,0,11,4,12,1,2,19
2020,50034,Santa Luce,PI,56,2,11,2,1,16,1,9,1,1,12
2020,50034,Santa Luce,PI,57,1,11,0,0,12,1,2,2,0,5
2020,50034,Santa Luce,PI,58,4,11,2,0,17,3,11,2,0,16
2020,50034,Santa Luce,PI,59,2,8,0,0,10,3,12,1,1,17
2020,50034,Santa Luce,PI,60,0,6,1,0,7,2,9,2,0,13
2020,50034,Santa Luce,PI,61,2,13,2,0,17,4,4,1,2,11
2020,50034,Santa Luce,PI,62,2,7,1,0,10,2,6,3,0,11
2020,50034,Santa Luce,PI,63,2,15,1,1,19,5,10,3,6,24
2020,50034,Santa Luce,PI,64,2,5,3,1,11,2,9,0,0,11
2020,50034,Santa Luce,PI,65,1,4,3,0,8,2,5,4,0,11
2020,50034,Santa Luce,PI,66,4,7,2,1,14,1,8,0,1,10
2020,50034,Santa Luce,PI,67,0,9,2,0,11,3,6,0,1,10
2020,50034,Santa Luce,PI,68,2,8,0,0,10,0,7,1,3,11
2020,50034,Santa Luce,PI,69,0,7,0,1,8,1,9,1,2,13
2020,50034,Santa Luce,PI,70,1,9,0,2,12,2,3,0,3,8
2020,50034,Santa Luce,PI,71,1,9,1,0,11,1,4,2,3,10
2020,50034,Santa Luce,PI,72,2,5,1,0,8,2,7,2,2,13
2020,50034,Santa Luce,PI,73,1,9,3,0,13,0,8,0,1,9
2020,50034,Santa Luce,PI,74,1,5,3,0,9,1,4,2,3,10
2020,50034,Santa Luce,PI,75,0,3,0,1,4,0,5,0,1,6
2020,50034,Santa Luce,PI,76,1,5,0,0,6,0,6,0,2,8
2020,50034,Santa Luce,PI,77,0,4,1,0,5,0,5,1,5,11
2020,50034,Santa Luce,PI,78,0,7,0,0,7,0,5,0,4,9
2020,50034,Santa Luce,PI,79,0,5,0,0,5,0,3,1,4,8
2020,50034,Santa Luce,PI,80,1,7,0,1,9,1,6,0,6,13
2020,50034,Santa Luce,PI,81,1,7,0,2,10,0,4,0,5,9
2020,50034,Santa Luce,PI,82,0,2,0,2,4,0,2,0,3,5
2020,50034,Santa Luce,PI,83,1,6,1,1,9,0,1,0,7,8
2020,50034,Santa Luce,PI,84,1,4,1,1,7,0,4,0,6,10
2020,50034,Santa Luce,PI,85,2,2,0,1,5,1,1,0,3,5
2020,50034,Santa Luce,PI,86,1,3,0,1,5,0,0,0,4,4
2020,50034,Santa Luce,PI,87,1,5,0,1,7,0,2,1,3,6
2020,50034,Santa Luce,PI,88,0,2,0,1,3,0,1,0,4,5
2020,50034,Santa Luce,PI,89,0,1,0,2,3,0,1,0,4,5
2020,50034,Santa Luce,PI,90,0,1,0,2,3,0,0,0,0,0
2020,50034,Santa Luce,PI,91,0,1,0,0,1,0,1,1,5,7
2020,50034,Santa Luce,PI,92,0,0,0,0,0,0,0,0,5,5
2020,50034,Santa Luce,PI,93,0,0,0,0,0,0,0,0,2,2
2020,50034,Santa Luce,PI,94,0,0,0,0,0,0,0,0,1,1
2020,50034,Santa Luce,PI,95,0,0,0,0,0,0,0,0,1,1
2020,50034,Santa Luce,PI,96,0,0,0,0,0,0,0,0,1,1
2020,50034,Santa Luce,PI,97,0,1,0,0,1,0,0,0,1,1
2020,50034,Santa Luce,PI,98,0,0,0,0,0,0,0,0,0,0
2020,50034,Santa Luce,PI,99,0,0,0,0,0,0,0,0,1,1
2020,50034,Santa Luce,PI,100 e più,0,0,0,0,0,0,0,0,0,0
2020,50035,Santa Maria a Monte,PI,0,53,0,0,0,53,50,0,0,0,50
2020,50035,Santa Maria a Monte,PI,1,53,0,0,0,53,54,0,0,0,54
2020,50035,Santa Maria a Monte,PI,2,59,0,0,0,59,51,0,0,0,51
2020,50035,Santa Maria a Monte,PI,3,53,0,0,0,53,56,0,0,0,56
2020,50035,Santa Maria a Monte,PI,4,55,0,0,0,55,76,0,0,0,76
2020,50035,Santa Maria a Monte,PI,5,62,0,0,0,62,60,0,0,0,60
2020,50035,Santa Maria a Monte,PI,6,61,0,0,0,61,78,0,0,0,78
2020,50035,Santa Maria a Monte,PI,7,67,0,0,0,67,67,0,0,0,67
2020,50035,Santa Maria a Monte,PI,8,67,0,0,0,67,54,0,0,0,54
2020,50035,Santa Maria a Monte,PI,9,69,0,0,0,69,67,0,0,0,67
2020,50035,Santa Maria a Monte,PI,10,75,0,0,0,75,72,0,0,0,72
2020,50035,Santa Maria a Monte,PI,11,74,0,0,0,74,73,0,0,0,73
2020,50035,Santa Maria a Monte,PI,12,61,0,0,0,61,62,0,0,0,62
2020,50035,Santa Maria a Monte,PI,13,67,0,0,0,67,68,0,0,0,68
2020,50035,Santa Maria a Monte,PI,14,71,0,0,0,71,63,0,0,0,63
2020,50035,Santa Maria a Monte,PI,15,68,0,0,0,68,69,0,0,0,69
2020,50035,Santa Maria a Monte,PI,16,69,0,0,0,69,68,0,0,0,68
2020,50035,Santa Maria a Monte,PI,17,60,0,0,0,60,63,0,0,0,63
2020,50035,Santa Maria a Monte,PI,18,61,0,0,0,61,52,0,0,0,52
2020,50035,Santa Maria a Monte,PI,19,64,0,0,0,64,49,0,0,0,49
2020,50035,Santa Maria a Monte,PI,20,66,0,0,0,66,62,1,0,0,63
2020,50035,Santa Maria a Monte,PI,21,59,0,0,0,59,45,3,1,0,49
2020,50035,Santa Maria a Monte,PI,22,51,0,0,0,51,52,4,0,0,56
2020,50035,Santa Maria a Monte,PI,23,62,1,0,0,63,55,4,0,0,59
2020,50035,Santa Maria a Monte,PI,24,47,0,0,0,47,52,6,0,0,58
2020,50035,Santa Maria a Monte,PI,25,61,1,0,0,62,60,9,0,0,69
2020,50035,Santa Maria a Monte,PI,26,56,9,0,0,65,51,8,0,0,59
2020,50035,Santa Maria a Monte,PI,27,66,9,0,0,75,51,7,0,0,58
2020,50035,Santa Maria a Monte,PI,28,56,5,0,0,61,60,15,0,0,75
2020,50035,Santa Maria a Monte,PI,29,67,8,0,0,75,47,16,0,0,63
2020,50035,Santa Maria a Monte,PI,30,62,10,0,0,72,51,30,3,0,84
2020,50035,Santa Maria a Monte,PI,31,68,9,1,0,78,38,27,1,0,66
2020,50035,Santa Maria a Monte,PI,32,44,20,0,0,64,38,36,0,0,74
2020,50035,Santa Maria a Monte,PI,33,44,19,0,0,63,33,34,0,0,67
2020,50035,Santa Maria a Monte,PI,34,51,19,3,0,73,37,41,1,0,79
2020,50035,Santa Maria a Monte,PI,35,61,34,2,0,97,42,54,3,0,99
2020,50035,Santa Maria a Monte,PI,36,45,35,0,0,80,45,40,2,0,87
2020,50035,Santa Maria a Monte,PI,37,34,46,1,0,81,37,68,3,1,109
2020,50035,Santa Maria a Monte,PI,38,38,44,0,0,82,41,44,2,2,89
2020,50035,Santa Maria a Monte,PI,39,37,45,3,1,86,28,68,3,2,101
2020,50035,Santa Maria a Monte,PI,40,47,70,4,0,121,29,64,1,1,95
2020,50035,Santa Maria a Monte,PI,41,57,57,5,0,119,27,57,5,1,90
2020,50035,Santa Maria a Monte,PI,42,42,73,5,0,120,20,86,4,0,110
2020,50035,Santa Maria a Monte,PI,43,39,69,4,0,112,20,90,6,1,117
2020,50035,Santa Maria a Monte,PI,44,33,80,6,0,119,20,75,5,1,101
2020,50035,Santa Maria a Monte,PI,45,45,82,3,1,131,30,86,5,0,121
2020,50035,Santa Maria a Monte,PI,46,37,73,5,0,115,22,86,7,1,116
2020,50035,Santa Maria a Monte,PI,47,24,102,8,1,135,16,83,10,1,110
2020,50035,Santa Maria a Monte,PI,48,31,95,5,1,132,18,86,8,3,115
2020,50035,Santa Maria a Monte,PI,49,28,82,5,1,116,17,87,7,1,112
2020,50035,Santa Maria a Monte,PI,50,22,75,3,0,100,13,83,4,0,100
2020,50035,Santa Maria a Monte,PI,51,17,73,9,0,99,13,76,6,2,97
2020,50035,Santa Maria a Monte,PI,52,17,75,5,1,98,14,77,9,1,101
2020,50035,Santa Maria a Monte,PI,53,16,91,8,2,117,10,72,6,4,92
2020,50035,Santa Maria a Monte,PI,54,16,64,10,0,90,10,74,8,4,96
2020,50035,Santa Maria a Monte,PI,55,19,75,6,1,101,15,82,8,4,109
2020,50035,Santa Maria a Monte,PI,56,12,93,7,0,112,5,93,4,7,109
2020,50035,Santa Maria a Monte,PI,57,6,82,8,2,98,4,78,5,2,89
2020,50035,Santa Maria a Monte,PI,58,8,74,6,0,88,3,97,6,8,114
2020,50035,Santa Maria a Monte,PI,59,14,74,2,3,93,4,74,13,5,96
2020,50035,Santa Maria a Monte,PI,60,9,72,6,2,89,3,69,5,9,86
2020,50035,Santa Maria a Monte,PI,61,10,78,3,1,92,4,66,9,8,87
2020,50035,Santa Maria a Monte,PI,62,3,68,6,1,78,4,71,2,10,87
2020,50035,Santa Maria a Monte,PI,63,5,63,4,3,75,6,57,6,7,76
2020,50035,Santa Maria a Monte,PI,64,6,66,5,3,80,3,74,2,6,85
2020,50035,Santa Maria a Monte,PI,65,10,65,2,2,79,4,56,4,6,70
2020,50035,Santa Maria a Monte,PI,66,6,65,2,1,74,3,76,2,11,92
2020,50035,Santa Maria a Monte,PI,67,9,56,7,5,77,4,51,3,13,71
2020,50035,Santa Maria a Monte,PI,68,2,76,0,3,81,1,52,5,8,66
2020,50035,Santa Maria a Monte,PI,69,4,52,3,1,60,1,43,3,11,58
2020,50035,Santa Maria a Monte,PI,70,3,65,5,4,77,3,52,1,19,75
2020,50035,Santa Maria a Monte,PI,71,1,48,3,3,55,4,58,1,18,81
2020,50035,Santa Maria a Monte,PI,72,4,57,1,11,73,3,54,2,20,79
2020,50035,Santa Maria a Monte,PI,73,3,48,0,3,54,1,43,2,19,65
2020,50035,Santa Maria a Monte,PI,74,2,52,2,7,63,1,47,0,24,72
2020,50035,Santa Maria a Monte,PI,75,2,52,2,5,61,1,42,1,15,59
2020,50035,Santa Maria a Monte,PI,76,1,35,0,7,43,2,31,3,24,60
2020,50035,Santa Maria a Monte,PI,77,1,37,2,5,45,1,31,2,21,55
2020,50035,Santa Maria a Monte,PI,78,2,39,1,4,46,2,26,2,22,52
2020,50035,Santa Maria a Monte,PI,79,0,38,1,6,45,2,21,0,21,44
2020,50035,Santa Maria a Monte,PI,80,2,38,0,5,45,1,23,1,29,54
2020,50035,Santa Maria a Monte,PI,81,1,30,0,8,39,4,20,1,20,45
2020,50035,Santa Maria a Monte,PI,82,1,32,0,8,41,3,19,0,34,56
2020,50035,Santa Maria a Monte,PI,83,1,31,1,8,41,0,14,0,35,49
2020,50035,Santa Maria a Monte,PI,84,3,21,1,7,32,1,21,1,29,52
2020,50035,Santa Maria a Monte,PI,85,2,23,0,4,29,0,15,1,39,55
2020,50035,Santa Maria a Monte,PI,86,1,17,0,10,28,0,6,0,30,36
2020,50035,Santa Maria a Monte,PI,87,1,16,0,3,20,0,4,0,20,24
2020,50035,Santa Maria a Monte,PI,88,2,6,0,5,13,2,5,0,19,26
2020,50035,Santa Maria a Monte,PI,89,0,8,0,3,11,0,3,0,23,26
2020,50035,Santa Maria a Monte,PI,90,1,6,0,7,14,1,1,1,10,13
2020,50035,Santa Maria a Monte,PI,91,0,2,0,6,8,0,1,0,23,24
2020,50035,Santa Maria a Monte,PI,92,0,2,0,1,3,2,0,0,14,16
2020,50035,Santa Maria a Monte,PI,93,0,2,0,3,5,1,0,1,8,10
2020,50035,Santa Maria a Monte,PI,94,0,2,0,0,2,0,0,0,7,7
2020,50035,Santa Maria a Monte,PI,95,0,1,0,3,4,0,0,0,4,4
2020,50035,Santa Maria a Monte,PI,96,0,1,0,1,2,0,0,0,5,5
2020,50035,Santa Maria a Monte,PI,97,0,0,0,0,0,0,0,0,2,2
2020,50035,Santa Maria a Monte,PI,98,0,0,0,0,0,0,1,0,2,3
2020,50035,Santa Maria a Monte,PI,99,0,0,0,0,0,0,0,0,2,2
2020,50035,Santa Maria a Monte,PI,100 e più,0,0,0,0,0,0,0,0,3,3
2020,50036,Terricciola,PI,0,8,0,0,0,8,13,0,0,0,13
2020,50036,Terricciola,PI,1,17,0,0,0,17,17,0,0,0,17
2020,50036,Terricciola,PI,2,14,0,0,0,14,19,0,0,0,19
2020,50036,Terricciola,PI,3,16,0,0,0,16,13,0,0,0,13
2020,50036,Terricciola,PI,4,16,0,0,0,16,14,0,0,0,14
2020,50036,Terricciola,PI,5,13,0,0,0,13,16,0,0,0,16
2020,50036,Terricciola,PI,6,23,0,0,0,23,23,0,0,0,23
2020,50036,Terricciola,PI,7,25,0,0,0,25,12,0,0,0,12
2020,50036,Terricciola,PI,8,28,0,0,0,28,21,0,0,0,21
2020,50036,Terricciola,PI,9,22,0,0,0,22,19,0,0,0,19
2020,50036,Terricciola,PI,10,21,0,0,0,21,26,0,0,0,26
2020,50036,Terricciola,PI,11,19,0,0,0,19,12,0,0,0,12
2020,50036,Terricciola,PI,12,25,0,0,0,25,24,0,0,0,24
2020,50036,Terricciola,PI,13,26,0,0,0,26,29,0,0,0,29
2020,50036,Terricciola,PI,14,24,0,0,0,24,28,0,0,0,28
2020,50036,Terricciola,PI,15,13,0,0,0,13,15,0,0,0,15
2020,50036,Terricciola,PI,16,24,0,0,0,24,28,0,0,0,28
2020,50036,Terricciola,PI,17,30,0,0,0,30,24,0,0,0,24
2020,50036,Terricciola,PI,18,24,0,0,0,24,17,0,0,0,17
2020,50036,Terricciola,PI,19,27,0,0,0,27,20,0,0,0,20
2020,50036,Terricciola,PI,20,24,0,0,0,24,23,0,0,0,23
2020,50036,Terricciola,PI,21,20,0,0,0,20,18,0,0,0,18
2020,50036,Terricciola,PI,22,19,0,0,0,19,12,0,0,0,12
2020,50036,Terricciola,PI,23,18,0,0,0,18,26,0,0,0,26
2020,50036,Terricciola,PI,24,16,0,0,0,16,22,0,0,0,22
2020,50036,Terricciola,PI,25,16,0,0,0,16,17,4,0,0,21
2020,50036,Terricciola,PI,26,20,0,0,0,20,24,0,0,0,24
2020,50036,Terricciola,PI,27,9,0,0,0,9,16,4,0,0,20
2020,50036,Terricciola,PI,28,11,0,0,0,11,12,1,0,0,13
2020,50036,Terricciola,PI,29,19,2,0,0,21,10,3,0,0,13
2020,50036,Terricciola,PI,30,18,2,0,0,20,9,5,0,0,14
2020,50036,Terricciola,PI,31,9,5,0,0,14,13,8,0,0,21
2020,50036,Terricciola,PI,32,23,5,1,0,29,23,6,0,0,29
2020,50036,Terricciola,PI,33,19,6,0,0,25,13,9,0,0,22
2020,50036,Terricciola,PI,34,14,8,0,0,22,10,11,0,0,21
2020,50036,Terricciola,PI,35,11,8,0,0,19,11,11,0,0,22
2020,50036,Terricciola,PI,36,14,5,0,0,19,6,13,2,0,21
2020,50036,Terricciola,PI,37,14,11,0,0,25,10,14,4,0,28
2020,50036,Terricciola,PI,38,20,10,2,0,32,8,9,1,0,18
2020,50036,Terricciola,PI,39,14,12,0,0,26,12,24,2,0,38
2020,50036,Terricciola,PI,40,12,16,0,0,28,13,16,3,0,32
2020,50036,Terricciola,PI,41,12,7,1,1,21,13,27,3,0,43
2020,50036,Terricciola,PI,42,13,15,4,0,32,10,24,0,0,34
2020,50036,Terricciola,PI,43,17,16,3,0,36,8,21,2,0,31
2020,50036,Terricciola,PI,44,14,18,3,0,35,7,27,2,0,36
2020,50036,Terricciola,PI,45,15,30,1,0,46,7,28,4,0,39
2020,50036,Terricciola,PI,46,15,24,1,0,40,11,28,5,0,44
2020,50036,Terricciola,PI,47,10,35,4,0,49,5,24,3,2,34
2020,50036,Terricciola,PI,48,12,31,1,0,44,9,29,2,0,40
2020,50036,Terricciola,PI,49,9,28,4,0,41,6,26,1,0,33
2020,50036,Terricciola,PI,50,12,27,2,0,41,5,23,6,0,34
2020,50036,Terricciola,PI,51,7,30,3,0,40,1,27,4,1,33
2020,50036,Terricciola,PI,52,3,22,3,0,28,5,28,3,0,36
2020,50036,Terricciola,PI,53,3,30,3,1,37,4,19,3,0,26
2020,50036,Terricciola,PI,54,6,24,8,0,38,3,20,1,1,25
2020,50036,Terricciola,PI,55,7,21,2,0,30,3,29,5,0,37
2020,50036,Terricciola,PI,56,6,19,4,1,30,3,33,3,1,40
2020,50036,Terricciola,PI,57,6,27,2,2,37,3,22,3,0,28
2020,50036,Terricciola,PI,58,3,30,2,1,36,0,36,1,1,38
2020,50036,Terricciola,PI,59,7,21,6,1,35,1,15,2,2,20
2020,50036,Terricciola,PI,60,3,17,2,0,22,1,22,3,2,28
2020,50036,Terricciola,PI,61,2,29,6,2,39,6,24,2,2,34
2020,50036,Terricciola,PI,62,5,21,3,0,29,1,19,2,2,24
2020,50036,Terricciola,PI,63,3,26,2,0,31,3,18,2,1,24
2020,50036,Terricciola,PI,64,1,28,3,2,34,1,22,4,2,29
2020,50036,Terricciola,PI,65,0,17,1,1,19,3,25,0,2,30
2020,50036,Terricciola,PI,66,2,14,4,0,20,1,25,2,0,28
2020,50036,Terricciola,PI,67,2,17,0,1,20,1,22,0,3,26
2020,50036,Terricciola,PI,68,0,23,1,0,24,2,29,0,5,36
2020,50036,Terricciola,PI,69,1,17,1,1,20,0,15,0,2,17
2020,50036,Terricciola,PI,70,0,19,0,1,20,3,19,3,5,30
2020,50036,Terricciola,PI,71,1,21,1,1,24,2,21,1,6,30
2020,50036,Terricciola,PI,72,2,27,1,3,33,3,21,4,6,34
2020,50036,Terricciola,PI,73,1,26,1,3,31,0,26,0,5,31
2020,50036,Terricciola,PI,74,2,26,0,4,32,1,18,0,5,24
2020,50036,Terricciola,PI,75,0,19,0,2,21,1,15,0,6,22
2020,50036,Terricciola,PI,76,1,14,0,3,18,0,13,2,6,21
2020,50036,Terricciola,PI,77,1,17,0,3,21,0,9,0,10,19
2020,50036,Terricciola,PI,78,0,18,1,1,20,1,15,0,11,27
2020,50036,Terricciola,PI,79,2,6,1,1,10,0,8,0,8,16
2020,50036,Terricciola,PI,80,2,24,0,2,28,0,12,0,10,22
2020,50036,Terricciola,PI,81,0,14,0,1,15,0,4,0,11,15
2020,50036,Terricciola,PI,82,0,10,1,2,13,0,11,0,13,24
2020,50036,Terricciola,PI,83,1,15,1,2,19,1,6,0,11,18
2020,50036,Terricciola,PI,84,1,7,0,4,12,1,7,0,10,18
2020,50036,Terricciola,PI,85,1,11,0,3,15,0,4,0,13,17
2020,50036,Terricciola,PI,86,1,7,0,2,10,0,7,0,8,15
2020,50036,Terricciola,PI,87,0,7,1,4,12,1,5,0,11,17
2020,50036,Terricciola,PI,88,0,4,0,3,7,1,1,2,6,10
2020,50036,Terricciola,PI,89,1,8,0,4,13,0,0,0,14,14
2020,50036,Terricciola,PI,90,0,1,0,2,3,0,0,0,5,5
2020,50036,Terricciola,PI,91,0,1,0,2,3,0,1,0,10,11
2020,50036,Terricciola,PI,92,0,3,0,1,4,0,0,0,12,12
2020,50036,Terricciola,PI,93,1,2,0,2,5,0,0,0,4,4
2020,50036,Terricciola,PI,94,0,0,0,0,0,0,0,0,5,5
2020,50036,Terricciola,PI,95,0,0,0,1,1,0,0,0,2,2
2020,50036,Terricciola,PI,96,0,0,0,0,0,0,0,0,2,2
2020,50036,Terricciola,PI,97,0,0,0,1,1,0,0,0,0,0
2020,50036,Terricciola,PI,98,0,0,0,0,0,0,0,0,3,3
2020,50036,Terricciola,PI,99,0,0,0,0,0,0,0,0,1,1
2020,50036,Terricciola,PI,100 e più,0,0,0,0,0,0,0,0,2,2
2020,50037,Vecchiano,PI,0,40,0,0,0,40,36,0,0,0,36
2020,50037,Vecchiano,PI,1,35,0,0,0,35,32,0,0,0,32
2020,50037,Vecchiano,PI,2,49,0,0,0,49,37,0,0,0,37
2020,50037,Vecchiano,PI,3,42,0,0,0,42,35,0,0,0,35
2020,50037,Vecchiano,PI,4,36,0,0,0,36,41,0,0,0,41
2020,50037,Vecchiano,PI,5,57,0,0,0,57,32,0,0,0,32
2020,50037,Vecchiano,PI,6,51,0,0,0,51,54,0,0,0,54
2020,50037,Vecchiano,PI,7,42,0,0,0,42,46,0,0,0,46
2020,50037,Vecchiano,PI,8,48,0,0,0,48,47,0,0,0,47
2020,50037,Vecchiano,PI,9,45,0,0,0,45,53,0,0,0,53
2020,50037,Vecchiano,PI,10,63,0,0,0,63,60,0,0,0,60
2020,50037,Vecchiano,PI,11,69,0,0,0,69,44,0,0,0,44
2020,50037,Vecchiano,PI,12,53,0,0,0,53,57,0,0,0,57
2020,50037,Vecchiano,PI,13,55,0,0,0,55,44,0,0,0,44
2020,50037,Vecchiano,PI,14,57,0,0,0,57,68,0,0,0,68
2020,50037,Vecchiano,PI,15,60,0,0,0,60,45,0,0,0,45
2020,50037,Vecchiano,PI,16,57,0,0,0,57,42,0,0,0,42
2020,50037,Vecchiano,PI,17,58,0,0,0,58,58,0,0,0,58
2020,50037,Vecchiano,PI,18,42,0,0,0,42,58,0,0,0,58
2020,50037,Vecchiano,PI,19,64,0,0,0,64,47,0,0,0,47
2020,50037,Vecchiano,PI,20,43,0,0,0,43,60,0,0,0,60
2020,50037,Vecchiano,PI,21,56,0,0,0,56,44,1,0,0,45
2020,50037,Vecchiano,PI,22,51,0,0,0,51,50,1,0,0,51
2020,50037,Vecchiano,PI,23,51,0,0,0,51,53,1,0,0,54
2020,50037,Vecchiano,PI,24,59,1,0,0,60,55,2,0,0,57
2020,50037,Vecchiano,PI,25,52,3,0,0,55,46,3,0,0,49
2020,50037,Vecchiano,PI,26,58,0,0,0,58,34,5,0,0,39
2020,50037,Vecchiano,PI,27,68,5,0,0,73,38,13,0,0,51
2020,50037,Vecchiano,PI,28,55,2,0,0,57,48,11,0,0,59
2020,50037,Vecchiano,PI,29,48,4,0,0,52,35,13,0,0,48
2020,50037,Vecchiano,PI,30,44,6,0,0,50,42,15,0,0,57
2020,50037,Vecchiano,PI,31,42,9,0,0,51,40,18,1,0,59
2020,50037,Vecchiano,PI,32,32,19,0,0,51,28,18,0,0,46
2020,50037,Vecchiano,PI,33,33,12,0,0,45,45,26,1,0,72
2020,50037,Vecchiano,PI,34,40,19,0,0,59,27,28,1,0,56
2020,50037,Vecchiano,PI,35,39,15,1,0,55,30,31,2,0,63
2020,50037,Vecchiano,PI,36,43,26,1,0,70,26,31,0,0,57
2020,50037,Vecchiano,PI,37,37,40,0,0,77,21,31,3,0,55
2020,50037,Vecchiano,PI,38,28,29,2,0,59,36,38,2,0,76
2020,50037,Vecchiano,PI,39,37,33,2,0,72,26,37,1,0,64
2020,50037,Vecchiano,PI,40,36,38,3,0,77,24,43,3,0,70
2020,50037,Vecchiano,PI,41,30,45,0,1,76,27,43,2,0,72
2020,50037,Vecchiano,PI,42,34,39,4,0,77,30,55,1,0,86
2020,50037,Vecchiano,PI,43,41,50,2,0,93,27,45,4,0,76
2020,50037,Vecchiano,PI,44,35,45,4,0,84,16,76,7,0,99
2020,50037,Vecchiano,PI,45,21,47,4,0,72,30,71,4,1,106
2020,50037,Vecchiano,PI,46,34,63,5,1,103,36,79,13,2,130
2020,50037,Vecchiano,PI,47,24,58,4,1,87,22,88,4,1,115
2020,50037,Vecchiano,PI,48,34,76,5,1,116,13,55,6,2,76
2020,50037,Vecchiano,PI,49,26,77,5,0,108,16,74,9,1,100
2020,50037,Vecchiano,PI,50,22,62,6,2,92,14,71,10,1,96
2020,50037,Vecchiano,PI,51,22,88,7,1,118,12,78,14,2,106
2020,50037,Vecchiano,PI,52,20,69,8,0,97,16,77,8,3,104
2020,50037,Vecchiano,PI,53,27,59,12,0,98,14,78,10,7,109
2020,50037,Vecchiano,PI,54,13,73,12,1,99,16,66,9,5,96
2020,50037,Vecchiano,PI,55,20,64,11,4,99,11,75,8,3,97
2020,50037,Vecchiano,PI,56,10,78,7,2,97,10,75,6,7,98
2020,50037,Vecchiano,PI,57,15,74,5,2,96,10,62,15,5,92
2020,50037,Vecchiano,PI,58,9,65,5,2,81,1,57,9,4,71
2020,50037,Vecchiano,PI,59,11,70,7,2,90,5,80,15,9,109
2020,50037,Vecchiano,PI,60,7,55,7,0,69,4,75,5,8,92
2020,50037,Vecchiano,PI,61,8,66,12,1,87,3,60,6,7,76
2020,50037,Vecchiano,PI,62,8,67,5,2,82,6,59,5,9,79
2020,50037,Vecchiano,PI,63,5,73,3,0,81,1,75,6,12,94
2020,50037,Vecchiano,PI,64,7,41,4,5,57,5,68,10,10,93
2020,50037,Vecchiano,PI,65,1,63,3,3,70,2,54,4,11,71
2020,50037,Vecchiano,PI,66,2,68,4,1,75,2,68,10,10,90
2020,50037,Vecchiano,PI,67,6,71,1,3,81,3,45,3,13,64
2020,50037,Vecchiano,PI,68,6,48,4,3,61,4,53,1,14,72
2020,50037,Vecchiano,PI,69,2,58,4,2,66,5,63,2,18,88
2020,50037,Vecchiano,PI,70,3,67,7,4,81,0,59,1,15,75
2020,50037,Vecchiano,PI,71,1,78,2,3,84,6,53,7,22,88
2020,50037,Vecchiano,PI,72,4,64,5,5,78,1,63,4,22,90
2020,50037,Vecchiano,PI,73,2,54,4,6,66,2,59,4,36,101
2020,50037,Vecchiano,PI,74,3,71,3,6,83,3,45,6,28,82
2020,50037,Vecchiano,PI,75,1,45,1,7,54,2,37,1,20,60
2020,50037,Vecchiano,PI,76,4,45,1,4,54,2,40,2,31,75
2020,50037,Vecchiano,PI,77,2,33,2,8,45,3,47,1,34,85
2020,50037,Vecchiano,PI,78,1,42,0,4,47,0,44,2,26,72
2020,50037,Vecchiano,PI,79,3,31,1,6,41,4,23,1,22,50
2020,50037,Vecchiano,PI,80,2,53,1,4,60,2,37,1,25,65
2020,50037,Vecchiano,PI,81,5,37,1,7,50,2,26,0,26,54
2020,50037,Vecchiano,PI,82,4,30,0,11,45,1,29,2,33,65
2020,50037,Vecchiano,PI,83,2,37,0,9,48,1,21,0,27,49
2020,50037,Vecchiano,PI,84,2,32,0,6,40,3,9,0,33,45
2020,50037,Vecchiano,PI,85,1,19,0,7,27,0,9,2,34,45
2020,50037,Vecchiano,PI,86,2,20,1,8,31,0,7,0,30,37
2020,50037,Vecchiano,PI,87,1,11,1,6,19,4,5,0,28,37
2020,50037,Vecchiano,PI,88,0,11,0,7,18,0,4,0,23,27
2020,50037,Vecchiano,PI,89,1,7,1,6,15,1,3,0,32,36
2020,50037,Vecchiano,PI,90,3,5,0,6,14,0,3,0,17,20
2020,50037,Vecchiano,PI,91,1,4,0,4,9,0,0,0,28,28
2020,50037,Vecchiano,PI,92,0,4,0,4,8,1,1,0,14,16
2020,50037,Vecchiano,PI,93,0,4,0,2,6,2,0,0,16,18
2020,50037,Vecchiano,PI,94,0,1,0,1,2,1,0,0,13,14
2020,50037,Vecchiano,PI,95,0,0,0,2,2,0,0,0,9,9
2020,50037,Vecchiano,PI,96,0,0,0,0,0,0,0,0,6,6
2020,50037,Vecchiano,PI,97,0,0,0,2,2,0,0,0,6,6
2020,50037,Vecchiano,PI,98,0,0,0,0,0,0,0,0,1,1
2020,50037,Vecchiano,PI,99,0,0,0,1,1,1,0,0,3,4
2020,50037,Vecchiano,PI,100 e più,0,1,0,0,1,0,0,0,4,4
2020,50038,Vicopisano,PI,0,27,0,0,0,27,28,0,0,0,28
2020,50038,Vicopisano,PI,1,28,0,0,0,28,33,0,0,0,33
2020,50038,Vicopisano,PI,2,32,0,0,0,32,33,0,0,0,33
2020,50038,Vicopisano,PI,3,27,0,0,0,27,43,0,0,0,43
2020,50038,Vicopisano,PI,4,34,0,0,0,34,35,0,0,0,35
2020,50038,Vicopisano,PI,5,38,0,0,0,38,32,0,0,0,32
2020,50038,Vicopisano,PI,6,39,0,0,0,39,37,0,0,0,37
2020,50038,Vicopisano,PI,7,35,0,0,0,35,35,0,0,0,35
2020,50038,Vicopisano,PI,8,44,0,0,0,44,48,0,0,0,48
2020,50038,Vicopisano,PI,9,44,0,0,0,44,48,0,0,0,48
2020,50038,Vicopisano,PI,10,43,0,0,0,43,47,0,0,0,47
2020,50038,Vicopisano,PI,11,39,0,0,0,39,44,0,0,0,44
2020,50038,Vicopisano,PI,12,36,0,0,0,36,32,0,0,0,32
2020,50038,Vicopisano,PI,13,38,0,0,0,38,34,0,0,0,34
2020,50038,Vicopisano,PI,14,29,0,0,0,29,47,0,0,0,47
2020,50038,Vicopisano,PI,15,44,0,0,0,44,38,0,0,0,38
2020,50038,Vicopisano,PI,16,36,0,0,0,36,37,0,0,0,37
2020,50038,Vicopisano,PI,17,35,0,0,0,35,31,0,0,0,31
2020,50038,Vicopisano,PI,18,40,0,0,0,40,38,0,0,0,38
2020,50038,Vicopisano,PI,19,40,0,0,0,40,37,0,0,0,37
2020,50038,Vicopisano,PI,20,43,0,0,0,43,30,0,0,0,30
2020,50038,Vicopisano,PI,21,33,0,0,0,33,33,0,0,0,33
2020,50038,Vicopisano,PI,22,44,0,0,0,44,31,1,0,0,32
2020,50038,Vicopisano,PI,23,41,0,0,0,41,35,2,0,0,37
2020,50038,Vicopisano,PI,24,35,2,0,0,37,32,1,0,0,33
2020,50038,Vicopisano,PI,25,37,0,0,0,37,32,1,0,0,33
2020,50038,Vicopisano,PI,26,38,1,0,0,39,42,2,0,0,44
2020,50038,Vicopisano,PI,27,42,0,0,0,42,29,3,0,0,32
2020,50038,Vicopisano,PI,28,41,2,0,0,43,25,5,0,0,30
2020,50038,Vicopisano,PI,29,31,1,0,0,32,32,8,0,0,40
2020,50038,Vicopisano,PI,30,36,4,0,0,40,34,11,0,0,45
2020,50038,Vicopisano,PI,31,31,6,0,0,37,33,2,0,0,35
2020,50038,Vicopisano,PI,32,30,7,0,0,37,20,16,0,0,36
2020,50038,Vicopisano,PI,33,24,19,0,0,43,22,26,0,0,48
2020,50038,Vicopisano,PI,34,37,11,1,0,49,38,20,1,0,59
2020,50038,Vicopisano,PI,35,35,12,1,0,48,25,26,1,0,52
2020,50038,Vicopisano,PI,36,40,15,0,0,55,20,23,1,0,44
2020,50038,Vicopisano,PI,37,30,14,2,0,46,22,24,1,0,47
2020,50038,Vicopisano,PI,38,28,18,0,0,46,27,18,1,0,46
2020,50038,Vicopisano,PI,39,22,33,1,0,56,22,32,4,0,58
2020,50038,Vicopisano,PI,40,25,27,0,0,52,27,32,4,0,63
2020,50038,Vicopisano,PI,41,28,26,0,1,55,14,21,2,0,37
2020,50038,Vicopisano,PI,42,22,31,1,0,54,20,40,6,0,66
2020,50038,Vicopisano,PI,43,26,39,2,0,67,34,48,9,0,91
2020,50038,Vicopisano,PI,44,19,34,3,0,56,22,40,5,0,67
2020,50038,Vicopisano,PI,45,27,42,4,0,73,19,60,3,0,82
2020,50038,Vicopisano,PI,46,31,37,4,0,72,11,36,3,1,51
2020,50038,Vicopisano,PI,47,16,46,4,0,66,19,39,8,3,69
2020,50038,Vicopisano,PI,48,23,50,4,0,77,14,55,1,0,70
2020,50038,Vicopisano,PI,49,26,44,1,0,71,14,52,5,1,72
2020,50038,Vicopisano,PI,50,22,51,5,0,78,11,51,6,0,68
2020,50038,Vicopisano,PI,51,21,55,8,0,84,8,59,6,3,76
2020,50038,Vicopisano,PI,52,14,48,9,0,71,14,45,6,2,67
2020,50038,Vicopisano,PI,53,12,52,5,0,69,9,64,6,2,81
2020,50038,Vicopisano,PI,54,10,45,5,0,60,7,53,8,1,69
2020,50038,Vicopisano,PI,55,16,55,4,0,75,10,53,4,3,70
2020,50038,Vicopisano,PI,56,12,56,8,1,77,9,55,5,3,72
2020,50038,Vicopisano,PI,57,12,47,3,0,62,6,60,4,4,74
2020,50038,Vicopisano,PI,58,6,43,6,0,55,3,60,8,4,75
2020,50038,Vicopisano,PI,59,12,59,6,0,77,6,53,8,4,71
2020,50038,Vicopisano,PI,60,9,54,4,2,69,6,46,8,6,66
2020,50038,Vicopisano,PI,61,3,53,5,1,62,5,31,3,6,45
2020,50038,Vicopisano,PI,62,6,47,2,1,56,4,50,2,5,61
2020,50038,Vicopisano,PI,63,4,49,0,0,53,7,57,6,3,73
2020,50038,Vicopisano,PI,64,4,45,6,0,55,1,51,2,11,65
2020,50038,Vicopisano,PI,65,1,32,2,2,37,3,43,1,3,50
2020,50038,Vicopisano,PI,66,6,47,6,1,60,2,33,2,7,44
2020,50038,Vicopisano,PI,67,0,38,4,0,42,8,34,7,9,58
2020,50038,Vicopisano,PI,68,1,44,3,3,51,3,47,4,4,58
2020,50038,Vicopisano,PI,69,3,42,0,2,47,4,34,1,5,44
2020,50038,Vicopisano,PI,70,2,43,4,3,52,0,30,1,14,45
2020,50038,Vicopisano,PI,71,3,37,3,2,45,1,33,2,12,48
2020,50038,Vicopisano,PI,72,0,37,4,5,46,1,27,6,12,46
2020,50038,Vicopisano,PI,73,4,35,1,11,51,3,45,2,11,61
2020,50038,Vicopisano,PI,74,1,40,3,4,48,0,43,3,19,65
2020,50038,Vicopisano,PI,75,2,36,1,1,40,3,22,0,16,41
2020,50038,Vicopisano,PI,76,2,28,1,1,32,0,33,3,12,48
2020,50038,Vicopisano,PI,77,1,30,1,2,34,5,25,2,12,44
2020,50038,Vicopisano,PI,78,1,28,1,0,30,2,17,0,16,35
2020,50038,Vicopisano,PI,79,3,26,0,4,33,1,16,0,25,42
2020,50038,Vicopisano,PI,80,3,18,1,7,29,0,13,0,21,34
2020,50038,Vicopisano,PI,81,0,29,0,7,36,1,25,1,21,48
2020,50038,Vicopisano,PI,82,0,28,0,7,35,2,14,0,27,43
2020,50038,Vicopisano,PI,83,0,29,1,6,36,1,17,0,20,38
2020,50038,Vicopisano,PI,84,4,15,0,7,26,0,10,0,19,29
2020,50038,Vicopisano,PI,85,1,15,0,3,19,2,6,0,22,30
2020,50038,Vicopisano,PI,86,0,16,1,4,21,1,2,0,21,24
2020,50038,Vicopisano,PI,87,0,11,0,2,13,2,4,0,20,26
2020,50038,Vicopisano,PI,88,0,5,0,4,9,0,3,0,17,20
2020,50038,Vicopisano,PI,89,0,8,0,5,13,2,3,0,16,21
2020,50038,Vicopisano,PI,90,1,8,0,0,9,3,1,0,14,18
2020,50038,Vicopisano,PI,91,1,4,0,3,8,0,1,0,20,21
2020,50038,Vicopisano,PI,92,0,2,0,0,2,1,2,0,11,14
2020,50038,Vicopisano,PI,93,0,2,0,0,2,0,0,0,6,6
2020,50038,Vicopisano,PI,94,0,2,0,2,4,0,3,0,6,9
2020,50038,Vicopisano,PI,95,0,0,0,2,2,0,1,0,5,6
2020,50038,Vicopisano,PI,96,0,0,0,1,1,0,0,0,7,7
2020,50038,Vicopisano,PI,97,0,1,0,0,1,2,0,0,1,3
2020,50038,Vicopisano,PI,98,0,0,0,0,0,0,0,0,2,2
2020,50038,Vicopisano,PI,99,0,0,0,0,0,0,0,0,2,2
2020,50038,Vicopisano,PI,100 e più,0,1,0,0,1,0,0,0,2,2
2020,50039,Volterra,PI,0,21,0,0,0,21,20,0,0,0,20
2020,50039,Volterra,PI,1,18,0,0,0,18,27,0,0,0,27
2020,50039,Volterra,PI,2,26,0,0,0,26,32,0,0,0,32
2020,50039,Volterra,PI,3,22,0,0,0,22,33,0,0,0,33
2020,50039,Volterra,PI,4,19,0,0,0,19,31,0,0,0,31
2020,50039,Volterra,PI,5,28,0,0,0,28,34,0,0,0,34
2020,50039,Volterra,PI,6,25,0,0,0,25,26,0,0,0,26
2020,50039,Volterra,PI,7,33,0,0,0,33,29,0,0,0,29
2020,50039,Volterra,PI,8,28,0,0,0,28,30,0,0,0,30
2020,50039,Volterra,PI,9,44,0,0,0,44,33,0,0,0,33
2020,50039,Volterra,PI,10,40,0,0,0,40,35,0,0,0,35
2020,50039,Volterra,PI,11,41,0,0,0,41,38,0,0,0,38
2020,50039,Volterra,PI,12,44,0,0,0,44,39,0,0,0,39
2020,50039,Volterra,PI,13,39,0,0,0,39,34,0,0,0,34
2020,50039,Volterra,PI,14,51,0,0,0,51,33,0,0,0,33
2020,50039,Volterra,PI,15,53,0,0,0,53,41,0,0,0,41
2020,50039,Volterra,PI,16,36,0,0,0,36,36,0,0,0,36
2020,50039,Volterra,PI,17,32,0,0,0,32,46,0,0,0,46
2020,50039,Volterra,PI,18,40,0,0,0,40,28,0,0,0,28
2020,50039,Volterra,PI,19,39,0,0,0,39,28,0,0,0,28
2020,50039,Volterra,PI,20,31,0,0,0,31,47,1,0,0,48
2020,50039,Volterra,PI,21,44,0,0,0,44,46,0,0,0,46
2020,50039,Volterra,PI,22,39,0,0,0,39,38,1,0,0,39
2020,50039,Volterra,PI,23,44,0,0,0,44,36,1,0,0,37
2020,50039,Volterra,PI,24,46,0,0,0,46,32,1,0,0,33
2020,50039,Volterra,PI,25,43,2,0,0,45,47,2,0,0,49
2020,50039,Volterra,PI,26,30,0,0,0,30,45,4,0,0,49
2020,50039,Volterra,PI,27,49,0,0,0,49,42,6,0,0,48
2020,50039,Volterra,PI,28,47,1,0,0,48,38,3,0,0,41
2020,50039,Volterra,PI,29,49,3,0,0,52,33,10,0,0,43
2020,50039,Volterra,PI,30,49,7,0,0,56,34,11,0,0,45
2020,50039,Volterra,PI,31,42,9,0,0,51,31,14,0,0,45
2020,50039,Volterra,PI,32,31,4,0,0,35,28,10,2,0,40
2020,50039,Volterra,PI,33,44,8,1,0,53,26,15,1,0,42
2020,50039,Volterra,PI,34,24,7,0,0,31,18,14,0,0,32
2020,50039,Volterra,PI,35,35,13,0,0,48,28,19,2,0,49
2020,50039,Volterra,PI,36,27,12,0,0,39,15,19,1,0,35
2020,50039,Volterra,PI,37,41,8,0,0,49,13,18,2,0,33
2020,50039,Volterra,PI,38,27,19,0,0,46,16,13,2,0,31
2020,50039,Volterra,PI,39,36,22,1,0,59,24,23,1,0,48
2020,50039,Volterra,PI,40,18,22,0,0,40,25,29,0,0,54
2020,50039,Volterra,PI,41,28,16,1,0,45,15,29,1,2,47
2020,50039,Volterra,PI,42,36,27,4,1,68,17,39,2,0,58
2020,50039,Volterra,PI,43,32,27,0,0,59,25,35,2,1,63
2020,50039,Volterra,PI,44,33,33,0,1,67,28,42,4,1,75
2020,50039,Volterra,PI,45,36,28,3,0,67,25,56,4,0,85
2020,50039,Volterra,PI,46,29,37,1,0,67,21,52,4,0,77
2020,50039,Volterra,PI,47,28,50,4,0,82,22,40,3,0,65
2020,50039,Volterra,PI,48,28,45,6,0,79,21,54,8,0,83
2020,50039,Volterra,PI,49,24,50,5,1,80,14,45,5,1,65
2020,50039,Volterra,PI,50,18,38,2,0,58,17,52,5,0,74
2020,50039,Volterra,PI,51,21,40,8,0,69,17,51,11,0,79
2020,50039,Volterra,PI,52,20,55,6,0,81,12,65,10,3,90
2020,50039,Volterra,PI,53,17,53,5,0,75,17,64,3,1,85
2020,50039,Volterra,PI,54,22,60,7,2,91,11,66,5,3,85
2020,50039,Volterra,PI,55,14,66,2,1,83,19,67,6,2,94
2020,50039,Volterra,PI,56,21,58,11,0,90,11,64,13,3,91
2020,50039,Volterra,PI,57,27,59,10,1,97,11,67,10,2,90
2020,50039,Volterra,PI,58,16,59,5,3,83,7,70,9,10,96
2020,50039,Volterra,PI,59,18,52,8,1,79,10,58,11,14,93
2020,50039,Volterra,PI,60,11,55,5,0,71,8,51,9,4,72
2020,50039,Volterra,PI,61,10,75,8,0,93,8,60,5,9,82
2020,50039,Volterra,PI,62,8,64,7,0,79,5,57,9,5,76
2020,50039,Volterra,PI,63,10,46,7,0,63,6,52,4,10,72
2020,50039,Volterra,PI,64,7,55,5,1,68,7,55,3,9,74
2020,50039,Volterra,PI,65,7,51,2,2,62,4,45,9,8,66
2020,50039,Volterra,PI,66,3,56,5,2,66,3,58,7,5,73
2020,50039,Volterra,PI,67,6,48,6,1,61,1,59,5,15,80
2020,50039,Volterra,PI,68,7,56,3,2,68,7,62,4,14,87
2020,50039,Volterra,PI,69,8,56,3,4,71,3,45,2,13,63
2020,50039,Volterra,PI,70,4,38,3,0,45,2,42,1,11,56
2020,50039,Volterra,PI,71,1,58,3,2,64,6,44,3,20,73
2020,50039,Volterra,PI,72,2,69,1,5,77,8,38,5,11,62
2020,50039,Volterra,PI,73,4,49,4,4,61,7,47,4,23,81
2020,50039,Volterra,PI,74,5,46,3,6,60,4,57,2,26,89
2020,50039,Volterra,PI,75,3,46,2,1,52,0,45,3,22,70
2020,50039,Volterra,PI,76,4,34,3,2,43,4,29,3,24,60
2020,50039,Volterra,PI,77,0,30,0,6,36,0,29,1,30,60
2020,50039,Volterra,PI,78,1,36,2,7,46,3,36,1,25,65
2020,50039,Volterra,PI,79,0,36,0,9,45,1,35,0,28,64
2020,50039,Volterra,PI,80,1,37,0,9,47,0,29,0,42,71
2020,50039,Volterra,PI,81,5,43,1,6,55,0,21,1,29,51
2020,50039,Volterra,PI,82,1,38,1,9,49,1,31,1,38,71
2020,50039,Volterra,PI,83,1,23,1,9,34,0,15,0,40,55
2020,50039,Volterra,PI,84,1,27,1,5,34,3,17,0,40,60
2020,50039,Volterra,PI,85,5,30,0,8,43,0,10,0,40,50
2020,50039,Volterra,PI,86,2,28,2,13,45,1,11,0,44,56
2020,50039,Volterra,PI,87,0,23,0,10,33,1,7,0,32,40
2020,50039,Volterra,PI,88,0,5,0,6,11,2,5,0,25,32
2020,50039,Volterra,PI,89,1,12,1,6,20,3,3,0,30,36
2020,50039,Volterra,PI,90,2,14,0,6,22,3,9,1,35,48
2020,50039,Volterra,PI,91,0,7,0,6,13,0,2,0,23,25
2020,50039,Volterra,PI,92,0,6,0,4,10,0,1,0,13,14
2020,50039,Volterra,PI,93,1,2,0,2,5,1,0,0,16,17
2020,50039,Volterra,PI,94,0,3,0,3,6,0,0,0,11,11
2020,50039,Volterra,PI,95,0,1,0,3,4,0,0,0,9,9
2020,50039,Volterra,PI,96,0,0,0,1,1,2,0,0,11,13
2020,50039,Volterra,PI,97,0,0,0,1,1,0,0,0,5,5
2020,50039,Volterra,PI,98,0,0,0,0,0,0,0,0,5,5
2020,50039,Volterra,PI,99,0,0,0,0,0,0,0,0,0,0
2020,50039,Volterra,PI,100 e più,0,0,0,1,1,0,0,0,2,2
2020,50040,Casciana Terme Lari,PI,0,37,0,0,0,37,42,0,0,0,42
2020,50040,Casciana Terme Lari,PI,1,36,0,0,0,36,34,0,0,0,34
2020,50040,Casciana Terme Lari,PI,2,34,0,0,0,34,35,0,0,0,35
2020,50040,Casciana Terme Lari,PI,3,51,0,0,0,51,25,0,0,0,25
2020,50040,Casciana Terme Lari,PI,4,37,0,0,0,37,46,0,0,0,46
2020,50040,Casciana Terme Lari,PI,5,51,0,0,0,51,42,0,0,0,42
2020,50040,Casciana Terme Lari,PI,6,48,0,0,0,48,53,0,0,0,53
2020,50040,Casciana Terme Lari,PI,7,54,0,0,0,54,45,0,0,0,45
2020,50040,Casciana Terme Lari,PI,8,56,0,0,0,56,47,0,0,0,47
2020,50040,Casciana Terme Lari,PI,9,59,0,0,0,59,51,0,0,0,51
2020,50040,Casciana Terme Lari,PI,10,71,0,0,0,71,68,0,0,0,68
2020,50040,Casciana Terme Lari,PI,11,47,0,0,0,47,50,0,0,0,50
2020,50040,Casciana Terme Lari,PI,12,65,0,0,0,65,66,0,0,0,66
2020,50040,Casciana Terme Lari,PI,13,80,0,0,0,80,50,0,0,0,50
2020,50040,Casciana Terme Lari,PI,14,65,0,0,0,65,64,0,0,0,64
2020,50040,Casciana Terme Lari,PI,15,53,0,0,0,53,69,0,0,0,69
2020,50040,Casciana Terme Lari,PI,16,63,0,0,0,63,66,0,0,0,66
2020,50040,Casciana Terme Lari,PI,17,55,0,0,0,55,49,0,0,0,49
2020,50040,Casciana Terme Lari,PI,18,57,0,0,0,57,51,0,0,0,51
2020,50040,Casciana Terme Lari,PI,19,66,0,0,0,66,52,0,0,0,52
2020,50040,Casciana Terme Lari,PI,20,64,0,0,0,64,57,0,0,0,57
2020,50040,Casciana Terme Lari,PI,21,58,0,0,0,58,43,0,0,0,43
2020,50040,Casciana Terme Lari,PI,22,67,0,0,0,67,45,3,0,0,48
2020,50040,Casciana Terme Lari,PI,23,67,0,0,0,67,45,1,0,0,46
2020,50040,Casciana Terme Lari,PI,24,60,0,0,0,60,39,1,0,0,40
2020,50040,Casciana Terme Lari,PI,25,57,2,0,0,59,38,1,0,0,39
2020,50040,Casciana Terme Lari,PI,26,39,0,1,0,40,33,5,0,0,38
2020,50040,Casciana Terme Lari,PI,27,69,1,0,0,70,52,7,0,0,59
2020,50040,Casciana Terme Lari,PI,28,45,4,0,0,49,41,7,0,0,48
2020,50040,Casciana Terme Lari,PI,29,50,3,0,0,53,36,12,1,0,49
2020,50040,Casciana Terme Lari,PI,30,47,5,0,0,52,43,13,1,0,57
2020,50040,Casciana Terme Lari,PI,31,50,15,0,0,65,34,22,0,0,56
2020,50040,Casciana Terme Lari,PI,32,38,11,0,0,49,24,23,1,0,48
2020,50040,Casciana Terme Lari,PI,33,37,15,0,0,52,30,20,0,0,50
2020,50040,Casciana Terme Lari,PI,34,29,14,0,0,43,29,27,0,1,57
2020,50040,Casciana Terme Lari,PI,35,41,10,0,0,51,31,29,0,0,60
2020,50040,Casciana Terme Lari,PI,36,31,28,2,0,61,22,24,2,0,48
2020,50040,Casciana Terme Lari,PI,37,41,25,1,0,67,34,46,2,0,82
2020,50040,Casciana Terme Lari,PI,38,34,28,1,0,63,22,54,0,1,77
2020,50040,Casciana Terme Lari,PI,39,36,44,2,0,82,25,34,3,1,63
2020,50040,Casciana Terme Lari,PI,40,33,35,1,0,69,31,44,6,0,81
2020,50040,Casciana Terme Lari,PI,41,42,44,6,0,92,28,46,5,1,80
2020,50040,Casciana Terme Lari,PI,42,33,51,3,0,87,28,55,5,2,90
2020,50040,Casciana Terme Lari,PI,43,43,40,2,0,85,24,59,5,0,88
2020,50040,Casciana Terme Lari,PI,44,34,49,7,0,90,29,77,7,1,114
2020,50040,Casciana Terme Lari,PI,45,32,60,5,0,97,17,55,9,0,81
2020,50040,Casciana Terme Lari,PI,46,41,62,5,0,108,23,70,11,2,106
2020,50040,Casciana Terme Lari,PI,47,29,62,4,3,98,24,68,9,1,102
2020,50040,Casciana Terme Lari,PI,48,23,78,7,0,108,16,78,10,1,105
2020,50040,Casciana Terme Lari,PI,49,30,73,6,0,109,19,77,8,1,105
2020,50040,Casciana Terme Lari,PI,50,20,67,11,0,98,15,83,7,6,111
2020,50040,Casciana Terme Lari,PI,51,15,68,7,0,90,19,95,12,1,127
2020,50040,Casciana Terme Lari,PI,52,25,67,6,0,98,22,65,1,3,91
2020,50040,Casciana Terme Lari,PI,53,19,85,6,2,112,14,81,12,3,110
2020,50040,Casciana Terme Lari,PI,54,13,77,15,1,106,11,86,12,5,114
2020,50040,Casciana Terme Lari,PI,55,18,58,11,0,87,9,70,10,2,91
2020,50040,Casciana Terme Lari,PI,56,13,88,3,1,105,4,68,5,3,80
2020,50040,Casciana Terme Lari,PI,57,15,74,8,1,98,6,73,9,2,90
2020,50040,Casciana Terme Lari,PI,58,7,73,8,2,90,10,77,5,4,96
2020,50040,Casciana Terme Lari,PI,59,12,66,6,1,85,4,69,9,10,92
2020,50040,Casciana Terme Lari,PI,60,9,58,4,2,73,8,69,9,7,93
2020,50040,Casciana Terme Lari,PI,61,3,75,8,4,90,11,80,5,2,98
2020,50040,Casciana Terme Lari,PI,62,4,78,6,4,92,5,69,5,10,89
2020,50040,Casciana Terme Lari,PI,63,6,63,4,2,75,8,67,7,8,90
2020,50040,Casciana Terme Lari,PI,64,5,73,7,1,86,4,53,5,12,74
2020,50040,Casciana Terme Lari,PI,65,6,56,3,0,65,12,50,4,11,77
2020,50040,Casciana Terme Lari,PI,66,7,61,2,2,72,1,57,3,5,66
2020,50040,Casciana Terme Lari,PI,67,6,47,4,3,60,3,58,1,10,72
2020,50040,Casciana Terme Lari,PI,68,9,52,2,4,67,3,51,4,12,70
2020,50040,Casciana Terme Lari,PI,69,4,57,3,7,71,3,44,4,11,62
2020,50040,Casciana Terme Lari,PI,70,4,57,6,8,75,3,52,3,17,75
2020,50040,Casciana Terme Lari,PI,71,6,61,4,3,74,1,60,4,23,88
2020,50040,Casciana Terme Lari,PI,72,4,53,3,10,70,3,67,2,14,86
2020,50040,Casciana Terme Lari,PI,73,2,78,3,9,92,3,37,4,19,63
2020,50040,Casciana Terme Lari,PI,74,3,64,1,4,72,5,68,3,22,98
2020,50040,Casciana Terme Lari,PI,75,3,49,2,10,64,2,45,2,22,71
2020,50040,Casciana Terme Lari,PI,76,2,58,0,5,65,4,31,2,21,58
2020,50040,Casciana Terme Lari,PI,77,2,39,2,8,51,2,40,1,33,76
2020,50040,Casciana Terme Lari,PI,78,4,37,1,4,46,3,27,2,33,65
2020,50040,Casciana Terme Lari,PI,79,4,38,0,11,53,3,24,2,38,67
2020,50040,Casciana Terme Lari,PI,80,5,36,0,7,48,2,29,1,40,72
2020,50040,Casciana Terme Lari,PI,81,6,48,0,7,61,3,35,2,31,71
2020,50040,Casciana Terme Lari,PI,82,3,36,0,16,55,0,26,1,34,61
2020,50040,Casciana Terme Lari,PI,83,0,30,1,5,36,0,14,2,20,36
2020,50040,Casciana Terme Lari,PI,84,0,24,0,1,25,0,20,1,30,51
2020,50040,Casciana Terme Lari,PI,85,0,23,0,9,32,1,15,0,32,48
2020,50040,Casciana Terme Lari,PI,86,1,14,0,9,24,1,17,1,30,49
2020,50040,Casciana Terme Lari,PI,87,2,22,0,5,29,0,4,0,28,32
2020,50040,Casciana Terme Lari,PI,88,1,16,0,3,20,2,3,0,19,24
2020,50040,Casciana Terme Lari,PI,89,2,9,0,8,19,0,5,0,28,33
2020,50040,Casciana Terme Lari,PI,90,0,8,0,3,11,3,3,1,25,32
2020,50040,Casciana Terme Lari,PI,91,0,4,0,4,8,2,0,0,19,21
2020,50040,Casciana Terme Lari,PI,92,0,5,0,5,10,1,0,0,12,13
2020,50040,Casciana Terme Lari,PI,93,0,1,0,3,4,1,0,1,15,17
2020,50040,Casciana Terme Lari,PI,94,0,2,0,5,7,1,1,0,8,10
2020,50040,Casciana Terme Lari,PI,95,0,1,0,2,3,0,0,0,3,3
2020,50040,Casciana Terme Lari,PI,96,1,1,0,0,2,0,1,0,4,5
2020,50040,Casciana Terme Lari,PI,97,0,1,0,0,1,0,0,0,2,2
2020,50040,Casciana Terme Lari,PI,98,0,2,0,1,3,0,1,0,4,5
2020,50040,Casciana Terme Lari,PI,99,0,0,0,1,1,0,0,0,2,2
2020,50040,Casciana Terme Lari,PI,100 e più,0,0,0,0,0,0,0,0,4,4
2020,50041,Crespina Lorenzana,PI,0,18,0,0,0,18,15,0,0,0,15
2020,50041,Crespina Lorenzana,PI,1,17,0,0,0,17,18,0,0,0,18
2020,50041,Crespina Lorenzana,PI,2,23,0,0,0,23,16,0,0,0,16
2020,50041,Crespina Lorenzana,PI,3,18,0,0,0,18,21,0,0,0,21
2020,50041,Crespina Lorenzana,PI,4,23,0,0,0,23,19,0,0,0,19
2020,50041,Crespina Lorenzana,PI,5,25,0,0,0,25,23,0,0,0,23
2020,50041,Crespina Lorenzana,PI,6,17,0,0,0,17,20,0,0,0,20
2020,50041,Crespina Lorenzana,PI,7,32,0,0,0,32,24,0,0,0,24
2020,50041,Crespina Lorenzana,PI,8,28,0,0,0,28,22,0,0,0,22
2020,50041,Crespina Lorenzana,PI,9,23,0,0,0,23,22,0,0,0,22
2020,50041,Crespina Lorenzana,PI,10,26,0,0,0,26,32,0,0,0,32
2020,50041,Crespina Lorenzana,PI,11,25,0,0,0,25,28,0,0,0,28
2020,50041,Crespina Lorenzana,PI,12,20,0,0,0,20,26,0,0,0,26
2020,50041,Crespina Lorenzana,PI,13,24,0,0,0,24,22,0,0,0,22
2020,50041,Crespina Lorenzana,PI,14,28,0,0,0,28,23,0,0,0,23
2020,50041,Crespina Lorenzana,PI,15,23,0,0,0,23,16,0,0,0,16
2020,50041,Crespina Lorenzana,PI,16,30,0,0,0,30,26,0,0,0,26
2020,50041,Crespina Lorenzana,PI,17,24,0,0,0,24,29,0,0,0,29
2020,50041,Crespina Lorenzana,PI,18,24,0,0,0,24,27,0,0,0,27
2020,50041,Crespina Lorenzana,PI,19,28,0,0,0,28,18,0,0,0,18
2020,50041,Crespina Lorenzana,PI,20,20,0,0,0,20,32,0,0,0,32
2020,50041,Crespina Lorenzana,PI,21,26,0,0,0,26,16,0,0,0,16
2020,50041,Crespina Lorenzana,PI,22,32,0,0,0,32,25,1,0,0,26
2020,50041,Crespina Lorenzana,PI,23,21,0,0,0,21,18,0,0,0,18
2020,50041,Crespina Lorenzana,PI,24,30,0,0,0,30,27,0,0,0,27
2020,50041,Crespina Lorenzana,PI,25,23,0,0,0,23,15,1,0,0,16
2020,50041,Crespina Lorenzana,PI,26,24,0,0,0,24,17,0,0,0,17
2020,50041,Crespina Lorenzana,PI,27,21,2,0,0,23,18,4,0,0,22
2020,50041,Crespina Lorenzana,PI,28,18,3,0,0,21,18,5,0,0,23
2020,50041,Crespina Lorenzana,PI,29,23,2,0,0,25,12,10,0,0,22
2020,50041,Crespina Lorenzana,PI,30,18,2,0,0,20,17,8,0,0,25
2020,50041,Crespina Lorenzana,PI,31,25,9,0,0,34,11,9,0,0,20
2020,50041,Crespina Lorenzana,PI,32,24,9,0,0,33,14,12,0,0,26
2020,50041,Crespina Lorenzana,PI,33,14,7,0,0,21,16,7,0,0,23
2020,50041,Crespina Lorenzana,PI,34,15,7,1,0,23,16,16,0,0,32
2020,50041,Crespina Lorenzana,PI,35,16,7,0,0,23,23,12,2,0,37
2020,50041,Crespina Lorenzana,PI,36,23,15,0,0,38,17,14,1,0,32
2020,50041,Crespina Lorenzana,PI,37,20,11,0,0,31,9,19,1,0,29
2020,50041,Crespina Lorenzana,PI,38,20,11,2,0,33,12,20,1,0,33
2020,50041,Crespina Lorenzana,PI,39,14,14,1,0,29,12,18,1,0,31
2020,50041,Crespina Lorenzana,PI,40,19,16,2,0,37,16,19,1,0,36
2020,50041,Crespina Lorenzana,PI,41,20,17,1,0,38,3,32,0,0,35
2020,50041,Crespina Lorenzana,PI,42,17,27,1,0,45,13,26,5,0,44
2020,50041,Crespina Lorenzana,PI,43,14,27,2,0,43,12,20,1,0,33
2020,50041,Crespina Lorenzana,PI,44,19,22,3,0,44,15,37,3,1,56
2020,50041,Crespina Lorenzana,PI,45,13,26,3,0,42,9,32,1,1,43
2020,50041,Crespina Lorenzana,PI,46,13,34,2,0,49,13,37,3,0,53
2020,50041,Crespina Lorenzana,PI,47,9,29,3,0,41,14,21,3,2,40
2020,50041,Crespina Lorenzana,PI,48,13,26,2,0,41,11,37,3,1,52
2020,50041,Crespina Lorenzana,PI,49,13,31,5,0,49,4,50,2,1,57
2020,50041,Crespina Lorenzana,PI,50,11,40,1,0,52,8,32,5,1,46
2020,50041,Crespina Lorenzana,PI,51,6,45,4,0,55,1,36,4,4,45
2020,50041,Crespina Lorenzana,PI,52,8,22,4,0,34,6,29,1,2,38
2020,50041,Crespina Lorenzana,PI,53,11,39,5,0,55,6,25,2,5,38
2020,50041,Crespina Lorenzana,PI,54,5,28,3,0,36,4,32,3,0,39
2020,50041,Crespina Lorenzana,PI,55,8,19,1,1,29,8,33,3,0,44
2020,50041,Crespina Lorenzana,PI,56,9,30,6,0,45,4,32,3,2,41
2020,50041,Crespina Lorenzana,PI,57,5,40,3,0,48,5,36,5,2,48
2020,50041,Crespina Lorenzana,PI,58,5,27,6,0,38,1,26,5,3,35
2020,50041,Crespina Lorenzana,PI,59,6,32,4,0,42,3,25,4,1,33
2020,50041,Crespina Lorenzana,PI,60,2,33,2,1,38,2,39,2,2,45
2020,50041,Crespina Lorenzana,PI,61,1,22,1,0,24,1,27,1,6,35
2020,50041,Crespina Lorenzana,PI,62,1,38,5,2,46,1,26,1,3,31
2020,50041,Crespina Lorenzana,PI,63,6,28,2,1,37,2,22,5,0,29
2020,50041,Crespina Lorenzana,PI,64,1,33,0,0,34,0,36,3,3,42
2020,50041,Crespina Lorenzana,PI,65,2,34,1,1,38,5,33,0,4,42
2020,50041,Crespina Lorenzana,PI,66,2,34,3,1,40,2,31,0,5,38
2020,50041,Crespina Lorenzana,PI,67,1,28,3,3,35,1,39,1,4,45
2020,50041,Crespina Lorenzana,PI,68,2,27,1,3,33,1,23,5,5,34
2020,50041,Crespina Lorenzana,PI,69,1,32,2,1,36,2,23,1,5,31
2020,50041,Crespina Lorenzana,PI,70,2,30,1,1,34,0,32,1,7,40
2020,50041,Crespina Lorenzana,PI,71,2,30,1,0,33,0,17,0,7,24
2020,50041,Crespina Lorenzana,PI,72,1,31,2,3,37,0,34,1,6,41
2020,50041,Crespina Lorenzana,PI,73,1,29,1,1,32,0,26,1,8,35
2020,50041,Crespina Lorenzana,PI,74,1,26,1,1,29,2,16,0,12,30
2020,50041,Crespina Lorenzana,PI,75,1,23,0,3,27,1,12,1,13,27
2020,50041,Crespina Lorenzana,PI,76,1,19,1,1,22,1,10,0,8,19
2020,50041,Crespina Lorenzana,PI,77,2,15,0,1,18,0,17,1,10,28
2020,50041,Crespina Lorenzana,PI,78,1,27,0,1,29,0,14,1,8,23
2020,50041,Crespina Lorenzana,PI,79,0,11,0,2,13,0,14,0,7,21
2020,50041,Crespina Lorenzana,PI,80,1,16,0,7,24,0,8,0,20,28
2020,50041,Crespina Lorenzana,PI,81,2,9,0,3,14,0,7,0,13,20
2020,50041,Crespina Lorenzana,PI,82,0,15,0,2,17,1,13,0,11,25
2020,50041,Crespina Lorenzana,PI,83,2,12,0,5,19,0,10,0,14,24
2020,50041,Crespina Lorenzana,PI,84,1,11,0,2,14,0,5,0,13,18
2020,50041,Crespina Lorenzana,PI,85,0,9,1,5,15,1,4,0,10,15
2020,50041,Crespina Lorenzana,PI,86,2,11,0,5,18,2,5,0,9,16
2020,50041,Crespina Lorenzana,PI,87,0,9,0,4,13,0,3,0,16,19
2020,50041,Crespina Lorenzana,PI,88,0,9,0,4,13,0,3,0,15,18
2020,50041,Crespina Lorenzana,PI,89,0,4,0,1,5,0,1,0,14,15
2020,50041,Crespina Lorenzana,PI,90,0,4,0,4,8,0,2,0,9,11
2020,50041,Crespina Lorenzana,PI,91,1,4,0,3,8,1,0,0,8,9
2020,50041,Crespina Lorenzana,PI,92,0,2,0,4,6,1,1,0,4,6
2020,50041,Crespina Lorenzana,PI,93,0,0,0,1,1,0,1,0,1,2
2020,50041,Crespina Lorenzana,PI,94,0,1,0,0,1,0,1,0,3,4
2020,50041,Crespina Lorenzana,PI,95,0,1,0,0,1,0,0,0,3,3
2020,50041,Crespina Lorenzana,PI,96,0,2,0,1,3,0,0,0,1,1
2020,50041,Crespina Lorenzana,PI,97,0,0,0,1,1,0,0,0,1,1
2020,50041,Crespina Lorenzana,PI,98,0,0,0,0,0,0,0,0,1,1
2020,50041,Crespina Lorenzana,PI,99,0,0,0,1,1,0,0,0,0,0
2020,50041,Crespina Lorenzana,PI,100 e più,0,0,0,0,0,0,0,0,1,1
2020,47023,Abetone Cutigliano,PT,0,3,0,0,0,3,2,0,0,0,2
2020,47023,Abetone Cutigliano,PT,1,5,0,0,0,5,5,0,0,0,5
2020,47023,Abetone Cutigliano,PT,2,5,0,0,0,5,1,0,0,0,1
2020,47023,Abetone Cutigliano,PT,3,4,0,0,0,4,6,0,0,0,6
2020,47023,Abetone Cutigliano,PT,4,6,0,0,0,6,6,0,0,0,6
2020,47023,Abetone Cutigliano,PT,5,9,0,0,0,9,5,0,0,0,5
2020,47023,Abetone Cutigliano,PT,6,6,0,0,0,6,7,0,0,0,7
2020,47023,Abetone Cutigliano,PT,7,9,0,0,0,9,7,0,0,0,7
2020,47023,Abetone Cutigliano,PT,8,8,0,0,0,8,7,0,0,0,7
2020,47023,Abetone Cutigliano,PT,9,4,0,0,0,4,4,0,0,0,4
2020,47023,Abetone Cutigliano,PT,10,5,0,0,0,5,6,0,0,0,6
2020,47023,Abetone Cutigliano,PT,11,6,0,0,0,6,6,0,0,0,6
2020,47023,Abetone Cutigliano,PT,12,5,0,0,0,5,8,0,0,0,8
2020,47023,Abetone Cutigliano,PT,13,5,0,0,0,5,7,0,0,0,7
2020,47023,Abetone Cutigliano,PT,14,11,0,0,0,11,6,0,0,0,6
2020,47023,Abetone Cutigliano,PT,15,3,0,0,0,3,7,0,0,0,7
2020,47023,Abetone Cutigliano,PT,16,9,0,0,0,9,3,0,0,0,3
2020,47023,Abetone Cutigliano,PT,17,7,0,0,0,7,8,0,0,0,8
2020,47023,Abetone Cutigliano,PT,18,5,0,0,0,5,2,0,0,0,2
2020,47023,Abetone Cutigliano,PT,19,5,0,0,0,5,3,0,0,0,3
2020,47023,Abetone Cutigliano,PT,20,9,0,0,0,9,7,0,0,0,7
2020,47023,Abetone Cutigliano,PT,21,12,0,0,0,12,5,0,0,0,5
2020,47023,Abetone Cutigliano,PT,22,7,0,0,0,7,3,0,0,0,3
2020,47023,Abetone Cutigliano,PT,23,8,0,0,0,8,3,0,0,0,3
2020,47023,Abetone Cutigliano,PT,24,8,0,0,0,8,5,0,0,0,5
2020,47023,Abetone Cutigliano,PT,25,11,0,0,0,11,9,0,0,0,9
2020,47023,Abetone Cutigliano,PT,26,11,0,0,0,11,5,2,0,0,7
2020,47023,Abetone Cutigliano,PT,27,5,0,0,0,5,6,0,0,0,6
2020,47023,Abetone Cutigliano,PT,28,10,0,0,0,10,5,0,0,0,5
2020,47023,Abetone Cutigliano,PT,29,11,0,0,0,11,4,1,0,0,5
2020,47023,Abetone Cutigliano,PT,30,14,0,0,0,14,4,1,0,0,5
2020,47023,Abetone Cutigliano,PT,31,10,0,0,0,10,10,1,0,0,11
2020,47023,Abetone Cutigliano,PT,32,8,0,0,0,8,3,1,0,0,4
2020,47023,Abetone Cutigliano,PT,33,9,2,0,0,11,9,3,0,0,12
2020,47023,Abetone Cutigliano,PT,34,9,1,0,0,10,11,4,1,0,16
2020,47023,Abetone Cutigliano,PT,35,8,1,0,0,9,1,5,0,0,6
2020,47023,Abetone Cutigliano,PT,36,8,3,0,0,11,3,3,0,0,6
2020,47023,Abetone Cutigliano,PT,37,7,2,0,0,9,4,1,0,0,5
2020,47023,Abetone Cutigliano,PT,38,8,8,0,0,16,6,5,0,0,11
2020,47023,Abetone Cutigliano,PT,39,9,4,0,0,13,5,4,0,0,9
2020,47023,Abetone Cutigliano,PT,40,7,1,0,0,8,3,9,0,0,12
2020,47023,Abetone Cutigliano,PT,41,5,8,1,0,14,4,6,1,0,11
2020,47023,Abetone Cutigliano,PT,42,6,6,1,0,13,4,6,0,0,10
2020,47023,Abetone Cutigliano,PT,43,4,2,1,0,7,5,4,0,0,9
2020,47023,Abetone Cutigliano,PT,44,7,7,1,0,15,8,10,0,0,18
2020,47023,Abetone Cutigliano,PT,45,6,9,0,0,15,5,7,1,0,13
2020,47023,Abetone Cutigliano,PT,46,7,7,1,0,15,5,5,2,0,12
2020,47023,Abetone Cutigliano,PT,47,4,6,0,0,10,5,9,1,0,15
2020,47023,Abetone Cutigliano,PT,48,6,8,2,0,16,6,9,0,0,15
2020,47023,Abetone Cutigliano,PT,49,10,2,1,0,13,5,8,1,0,14
2020,47023,Abetone Cutigliano,PT,50,5,6,0,0,11,6,2,2,0,10
2020,47023,Abetone Cutigliano,PT,51,5,5,1,0,11,4,6,2,0,12
2020,47023,Abetone Cutigliano,PT,52,1,10,2,0,13,3,9,2,0,14
2020,47023,Abetone Cutigliano,PT,53,2,4,1,0,7,3,9,1,1,14
2020,47023,Abetone Cutigliano,PT,54,3,10,2,0,15,4,10,1,0,15
2020,47023,Abetone Cutigliano,PT,55,4,17,1,2,24,4,13,0,0,17
2020,47023,Abetone Cutigliano,PT,56,2,16,2,0,20,4,19,2,0,25
2020,47023,Abetone Cutigliano,PT,57,4,16,3,0,23,3,16,3,0,22
2020,47023,Abetone Cutigliano,PT,58,3,8,1,1,13,4,12,0,0,16
2020,47023,Abetone Cutigliano,PT,59,3,9,2,0,14,2,12,0,0,14
2020,47023,Abetone Cutigliano,PT,60,0,16,2,0,18,2,12,0,0,14
2020,47023,Abetone Cutigliano,PT,61,4,15,1,0,20,1,11,0,1,13
2020,47023,Abetone Cutigliano,PT,62,3,10,1,2,16,2,13,1,0,16
2020,47023,Abetone Cutigliano,PT,63,2,13,0,0,15,0,11,0,0,11
2020,47023,Abetone Cutigliano,PT,64,2,10,1,0,13,3,11,3,0,17
2020,47023,Abetone Cutigliano,PT,65,3,13,0,3,19,2,13,1,1,17
2020,47023,Abetone Cutigliano,PT,66,1,12,1,1,15,0,8,0,3,11
2020,47023,Abetone Cutigliano,PT,67,2,13,0,0,15,1,14,1,4,20
2020,47023,Abetone Cutigliano,PT,68,3,8,0,0,11,1,19,3,4,27
2020,47023,Abetone Cutigliano,PT,69,1,19,3,1,24,2,13,2,2,19
2020,47023,Abetone Cutigliano,PT,70,1,10,1,2,14,0,11,1,5,17
2020,47023,Abetone Cutigliano,PT,71,4,18,0,0,22,1,8,0,2,11
2020,47023,Abetone Cutigliano,PT,72,1,12,0,0,13,4,10,0,3,17
2020,47023,Abetone Cutigliano,PT,73,1,11,0,0,12,3,12,1,4,20
2020,47023,Abetone Cutigliano,PT,74,2,9,0,1,12,1,7,0,4,12
2020,47023,Abetone Cutigliano,PT,75,0,5,0,2,7,1,8,0,1,10
2020,47023,Abetone Cutigliano,PT,76,0,8,0,2,10,0,6,0,4,10
2020,47023,Abetone Cutigliano,PT,77,0,8,0,0,8,0,6,1,5,12
2020,47023,Abetone Cutigliano,PT,78,1,6,0,0,7,1,7,0,4,12
2020,47023,Abetone Cutigliano,PT,79,0,12,0,1,13,0,8,0,2,10
2020,47023,Abetone Cutigliano,PT,80,0,7,0,2,9,1,6,1,4,12
2020,47023,Abetone Cutigliano,PT,81,0,4,0,2,6,1,7,0,9,17
2020,47023,Abetone Cutigliano,PT,82,1,11,1,1,14,1,5,0,11,17
2020,47023,Abetone Cutigliano,PT,83,2,9,1,1,13,0,2,0,4,6
2020,47023,Abetone Cutigliano,PT,84,1,6,0,2,9,0,6,0,8,14
2020,47023,Abetone Cutigliano,PT,85,1,3,0,1,5,0,2,0,7,9
2020,47023,Abetone Cutigliano,PT,86,2,8,0,1,11,0,2,0,9,11
2020,47023,Abetone Cutigliano,PT,87,0,5,0,2,7,2,2,0,7,11
2020,47023,Abetone Cutigliano,PT,88,0,0,0,3,3,2,5,0,8,15
2020,47023,Abetone Cutigliano,PT,89,0,4,0,2,6,1,0,0,6,7
2020,47023,Abetone Cutigliano,PT,90,0,2,0,0,2,0,1,0,5,6
2020,47023,Abetone Cutigliano,PT,91,0,1,0,2,3,1,1,0,5,7
2020,47023,Abetone Cutigliano,PT,92,1,1,0,2,4,0,0,0,5,5
2020,47023,Abetone Cutigliano,PT,93,0,6,0,0,6,0,0,0,9,9
2020,47023,Abetone Cutigliano,PT,94,0,2,0,0,2,0,0,0,2,2
2020,47023,Abetone Cutigliano,PT,95,0,0,0,1,1,0,0,0,4,4
2020,47023,Abetone Cutigliano,PT,96,0,0,0,0,0,0,0,0,1,1
2020,47023,Abetone Cutigliano,PT,97,0,0,0,0,0,1,0,0,1,2
2020,47023,Abetone Cutigliano,PT,98,0,0,0,0,0,0,0,0,1,1
2020,47023,Abetone Cutigliano,PT,99,0,0,0,0,0,0,0,0,1,1
2020,47023,Abetone Cutigliano,PT,100 e più,0,0,0,0,0,0,0,0,1,1
2020,47002,Agliana,PT,0,64,0,0,0,64,67,0,0,0,67
2020,47002,Agliana,PT,1,62,0,0,0,62,69,0,0,0,69
2020,47002,Agliana,PT,2,74,0,0,0,74,78,0,0,0,78
2020,47002,Agliana,PT,3,88,0,0,0,88,65,0,0,0,65
2020,47002,Agliana,PT,4,82,0,0,0,82,78,0,0,0,78
2020,47002,Agliana,PT,5,92,0,0,0,92,62,0,0,0,62
2020,47002,Agliana,PT,6,87,0,0,0,87,78,0,0,0,78
2020,47002,Agliana,PT,7,79,0,0,0,79,91,0,0,0,91
2020,47002,Agliana,PT,8,97,0,0,0,97,85,0,0,0,85
2020,47002,Agliana,PT,9,132,0,0,0,132,81,0,0,0,81
2020,47002,Agliana,PT,10,88,0,0,0,88,96,0,0,0,96
2020,47002,Agliana,PT,11,97,0,0,0,97,86,0,0,0,86
2020,47002,Agliana,PT,12,107,0,0,0,107,85,0,0,0,85
2020,47002,Agliana,PT,13,104,0,0,0,104,90,0,0,0,90
2020,47002,Agliana,PT,14,82,0,0,0,82,95,0,0,0,95
2020,47002,Agliana,PT,15,83,0,0,0,83,81,0,0,0,81
2020,47002,Agliana,PT,16,78,0,0,0,78,78,0,0,0,78
2020,47002,Agliana,PT,17,97,0,0,0,97,97,0,0,0,97
2020,47002,Agliana,PT,18,97,0,0,0,97,92,1,0,0,93
2020,47002,Agliana,PT,19,94,0,0,0,94,73,0,0,0,73
2020,47002,Agliana,PT,20,92,0,0,0,92,78,1,0,0,79
2020,47002,Agliana,PT,21,65,0,0,0,65,90,1,0,0,91
2020,47002,Agliana,PT,22,91,0,0,0,91,72,6,0,0,78
2020,47002,Agliana,PT,23,72,0,0,0,72,70,5,0,0,75
2020,47002,Agliana,PT,24,82,1,0,0,83,57,6,0,0,63
2020,47002,Agliana,PT,25,107,2,0,0,109,53,15,0,0,68
2020,47002,Agliana,PT,26,87,7,0,0,94,67,13,0,0,80
2020,47002,Agliana,PT,27,91,2,0,0,93,64,21,0,0,85
2020,47002,Agliana,PT,28,92,11,0,0,103,60,21,0,0,81
2020,47002,Agliana,PT,29,78,12,0,0,90,55,20,0,0,75
2020,47002,Agliana,PT,30,77,12,0,0,89,50,34,0,0,84
2020,47002,Agliana,PT,31,72,28,0,0,100,66,44,0,0,110
2020,47002,Agliana,PT,32,83,28,0,0,111,51,55,1,0,107
2020,47002,Agliana,PT,33,64,34,0,0,98,54,42,0,0,96
2020,47002,Agliana,PT,34,56,44,1,0,101,58,51,1,0,110
2020,47002,Agliana,PT,35,69,40,1,0,110,39,48,5,0,92
2020,47002,Agliana,PT,36,62,38,4,0,104,59,52,2,1,114
2020,47002,Agliana,PT,37,63,59,1,0,123,50,73,4,1,128
2020,47002,Agliana,PT,38,55,60,0,0,115,44,74,1,2,121
2020,47002,Agliana,PT,39,67,67,2,0,136,31,73,2,0,106
2020,47002,Agliana,PT,40,53,68,4,0,125,39,71,3,0,113
2020,47002,Agliana,PT,41,62,91,1,0,154,34,100,7,0,141
2020,47002,Agliana,PT,42,56,91,1,1,149,33,76,6,0,115
2020,47002,Agliana,PT,43,52,76,6,0,134,32,105,10,2,149
2020,47002,Agliana,PT,44,43,82,4,0,129,33,93,8,0,134
2020,47002,Agliana,PT,45,53,103,9,2,167,31,104,8,0,143
2020,47002,Agliana,PT,46,59,100,6,1,166,32,110,8,3,153
2020,47002,Agliana,PT,47,46,99,4,0,149,29,123,6,3,161
2020,47002,Agliana,PT,48,43,105,6,1,155,24,97,12,4,137
2020,47002,Agliana,PT,49,31,106,7,2,146,20,112,12,0,144
2020,47002,Agliana,PT,50,39,104,12,0,155,21,105,14,4,144
2020,47002,Agliana,PT,51,26,117,9,1,153,15,145,10,3,173
2020,47002,Agliana,PT,52,30,112,4,0,146,23,115,13,2,153
2020,47002,Agliana,PT,53,23,121,9,2,155,20,112,13,2,147
2020,47002,Agliana,PT,54,18,113,10,1,142,12,112,17,6,147
2020,47002,Agliana,PT,55,21,88,8,0,117,11,101,10,3,125
2020,47002,Agliana,PT,56,24,124,9,1,158,12,107,10,4,133
2020,47002,Agliana,PT,57,18,105,14,0,137,12,91,9,6,118
2020,47002,Agliana,PT,58,7,104,9,4,124,8,99,17,4,128
2020,47002,Agliana,PT,59,9,81,7,1,98,9,92,12,8,121
2020,47002,Agliana,PT,60,16,95,10,3,124,8,93,8,8,117
2020,47002,Agliana,PT,61,11,77,6,1,95,5,104,6,12,127
2020,47002,Agliana,PT,62,7,76,4,2,89,9,87,3,12,111
2020,47002,Agliana,PT,63,6,100,9,0,115,8,85,12,10,115
2020,47002,Agliana,PT,64,4,86,7,5,102,2,95,11,10,118
2020,47002,Agliana,PT,65,4,87,0,4,95,3,80,2,12,97
2020,47002,Agliana,PT,66,3,73,3,2,81,1,83,2,11,97
2020,47002,Agliana,PT,67,1,81,6,2,90,7,79,4,13,103
2020,47002,Agliana,PT,68,3,78,4,1,86,6,77,2,12,97
2020,47002,Agliana,PT,69,7,91,6,4,108,4,82,4,24,114
2020,47002,Agliana,PT,70,3,70,2,8,83,3,69,5,24,101
2020,47002,Agliana,PT,71,3,85,1,3,92,3,67,7,25,102
2020,47002,Agliana,PT,72,8,91,1,6,106,2,67,2,28,99
2020,47002,Agliana,PT,73,1,82,1,6,90,2,95,4,31,132
2020,47002,Agliana,PT,74,2,62,3,6,73,3,73,0,36,112
2020,47002,Agliana,PT,75,6,66,2,7,81,6,62,2,28,98
2020,47002,Agliana,PT,76,0,57,3,9,69,3,52,1,25,81
2020,47002,Agliana,PT,77,3,70,1,7,81,4,48,2,39,93
2020,47002,Agliana,PT,78,7,54,2,10,73,4,42,0,27,73
2020,47002,Agliana,PT,79,3,58,1,7,69,5,45,1,38,89
2020,47002,Agliana,PT,80,4,57,1,3,65,5,50,2,43,100
2020,47002,Agliana,PT,81,8,57,0,5,70,4,44,2,48,98
2020,47002,Agliana,PT,82,4,49,1,7,61,3,34,1,29,67
2020,47002,Agliana,PT,83,1,35,0,12,48,3,25,0,44,72
2020,47002,Agliana,PT,84,3,48,0,10,61,1,17,0,47,65
2020,47002,Agliana,PT,85,3,37,1,10,51,4,16,0,48,68
2020,47002,Agliana,PT,86,1,26,0,13,40,3,13,0,47,63
2020,47002,Agliana,PT,87,1,20,1,9,31,3,10,2,45,60
2020,47002,Agliana,PT,88,3,20,0,2,25,1,9,0,35,45
2020,47002,Agliana,PT,89,0,10,0,4,14,1,4,0,36,41
2020,47002,Agliana,PT,90,0,15,0,5,20,2,0,1,26,29
2020,47002,Agliana,PT,91,3,11,0,5,19,1,3,0,33,37
2020,47002,Agliana,PT,92,1,4,0,2,7,0,2,1,19,22
2020,47002,Agliana,PT,93,0,4,0,3,7,0,0,0,15,15
2020,47002,Agliana,PT,94,0,2,0,4,6,1,0,0,14,15
2020,47002,Agliana,PT,95,0,1,0,2,3,1,0,0,13,14
2020,47002,Agliana,PT,96,0,0,0,1,1,0,1,0,4,5
2020,47002,Agliana,PT,97,0,0,0,1,1,2,1,0,3,6
2020,47002,Agliana,PT,98,0,1,0,0,1,1,0,0,3,4
2020,47002,Agliana,PT,99,0,0,0,0,0,0,0,0,3,3
2020,47002,Agliana,PT,100 e più,0,0,0,1,1,0,0,0,1,1
2020,47003,Buggiano,PT,0,19,0,0,0,19,30,0,0,0,30
2020,47003,Buggiano,PT,1,33,0,0,0,33,28,0,0,0,28
2020,47003,Buggiano,PT,2,31,0,0,0,31,25,0,0,0,25
2020,47003,Buggiano,PT,3,27,0,0,0,27,30,0,0,0,30
2020,47003,Buggiano,PT,4,25,0,0,0,25,31,0,0,0,31
2020,47003,Buggiano,PT,5,28,0,0,0,28,30,0,0,0,30
2020,47003,Buggiano,PT,6,35,0,0,0,35,37,0,0,0,37
2020,47003,Buggiano,PT,7,35,0,0,0,35,25,0,0,0,25
2020,47003,Buggiano,PT,8,27,0,0,0,27,35,0,0,0,35
2020,47003,Buggiano,PT,9,45,0,0,0,45,37,0,0,0,37
2020,47003,Buggiano,PT,10,35,0,0,0,35,24,0,0,0,24
2020,47003,Buggiano,PT,11,39,0,0,0,39,39,0,0,0,39
2020,47003,Buggiano,PT,12,46,0,0,0,46,46,0,0,0,46
2020,47003,Buggiano,PT,13,45,0,0,0,45,46,0,0,0,46
2020,47003,Buggiano,PT,14,47,0,0,0,47,37,0,0,0,37
2020,47003,Buggiano,PT,15,37,0,0,0,37,37,0,0,0,37
2020,47003,Buggiano,PT,16,39,0,0,0,39,46,0,0,0,46
2020,47003,Buggiano,PT,17,42,0,0,0,42,41,0,0,0,41
2020,47003,Buggiano,PT,18,43,0,0,0,43,25,0,0,0,25
2020,47003,Buggiano,PT,19,38,0,0,0,38,42,0,0,0,42
2020,47003,Buggiano,PT,20,52,0,0,0,52,39,2,0,0,41
2020,47003,Buggiano,PT,21,39,1,0,0,40,39,2,0,0,41
2020,47003,Buggiano,PT,22,45,0,0,0,45,51,0,0,0,51
2020,47003,Buggiano,PT,23,50,1,0,0,51,48,1,0,0,49
2020,47003,Buggiano,PT,24,44,0,0,0,44,41,2,0,0,43
2020,47003,Buggiano,PT,25,53,2,0,0,55,52,5,1,0,58
2020,47003,Buggiano,PT,26,49,4,0,0,53,25,4,0,0,29
2020,47003,Buggiano,PT,27,32,1,0,0,33,34,8,1,0,43
2020,47003,Buggiano,PT,28,42,6,0,0,48,33,14,0,0,47
2020,47003,Buggiano,PT,29,45,5,0,0,50,33,15,0,0,48
2020,47003,Buggiano,PT,30,41,3,0,0,44,36,12,0,0,48
2020,47003,Buggiano,PT,31,54,6,0,0,60,38,11,0,0,49
2020,47003,Buggiano,PT,32,39,10,1,0,50,24,16,1,0,41
2020,47003,Buggiano,PT,33,27,16,0,0,43,32,11,1,0,44
2020,47003,Buggiano,PT,34,26,19,0,0,45,16,19,1,0,36
2020,47003,Buggiano,PT,35,32,10,0,0,42,26,18,1,1,46
2020,47003,Buggiano,PT,36,27,11,1,0,39,20,19,2,0,41
2020,47003,Buggiano,PT,37,21,21,0,1,43,16,30,2,0,48
2020,47003,Buggiano,PT,38,24,25,0,0,49,21,26,0,0,47
2020,47003,Buggiano,PT,39,21,16,0,0,37,19,32,3,1,55
2020,47003,Buggiano,PT,40,33,32,2,0,67,16,20,2,1,39
2020,47003,Buggiano,PT,41,28,23,3,0,54,15,35,6,0,56
2020,47003,Buggiano,PT,42,24,35,5,0,64,17,35,4,1,57
2020,47003,Buggiano,PT,43,18,22,2,0,42,20,35,5,0,60
2020,47003,Buggiano,PT,44,14,33,1,0,48,13,38,5,1,57
2020,47003,Buggiano,PT,45,22,39,4,0,65,13,45,6,0,64
2020,47003,Buggiano,PT,46,28,47,3,0,78,13,61,7,2,83
2020,47003,Buggiano,PT,47,21,60,1,0,82,15,47,5,0,67
2020,47003,Buggiano,PT,48,16,43,2,1,62,18,45,7,0,70
2020,47003,Buggiano,PT,49,16,50,9,1,76,14,63,12,2,91
2020,47003,Buggiano,PT,50,18,42,3,0,63,10,61,6,1,78
2020,47003,Buggiano,PT,51,21,48,5,1,75,11,56,11,0,78
2020,47003,Buggiano,PT,52,10,56,4,0,70,10,62,10,3,85
2020,47003,Buggiano,PT,53,14,47,7,2,70,5,71,13,1,90
2020,47003,Buggiano,PT,54,15,48,12,0,75,12,49,10,5,76
2020,47003,Buggiano,PT,55,11,51,5,0,67,11,56,13,0,80
2020,47003,Buggiano,PT,56,4,56,9,0,69,2,57,5,2,66
2020,47003,Buggiano,PT,57,7,66,5,0,78,6,51,10,4,71
2020,47003,Buggiano,PT,58,11,69,3,0,83,8,65,4,2,79
2020,47003,Buggiano,PT,59,6,60,5,0,71,6,54,5,0,65
2020,47003,Buggiano,PT,60,8,45,1,1,55,12,49,8,4,73
2020,47003,Buggiano,PT,61,8,47,4,1,60,4,61,7,1,73
2020,47003,Buggiano,PT,62,9,46,6,0,61,3,41,5,6,55
2020,47003,Buggiano,PT,63,7,39,4,0,50,5,46,4,4,59
2020,47003,Buggiano,PT,64,1,45,2,0,48,4,37,6,4,51
2020,47003,Buggiano,PT,65,11,49,3,2,65,6,43,2,11,62
2020,47003,Buggiano,PT,66,2,48,5,0,55,1,36,5,6,48
2020,47003,Buggiano,PT,67,7,47,2,1,57,3,42,3,8,56
2020,47003,Buggiano,PT,68,1,35,3,3,42,0,52,3,6,61
2020,47003,Buggiano,PT,69,2,42,4,3,51,3,34,5,8,50
2020,47003,Buggiano,PT,70,3,30,1,3,37,2,37,1,7,47
2020,47003,Buggiano,PT,71,3,41,6,3,53,5,41,2,16,64
2020,47003,Buggiano,PT,72,3,45,2,2,52,3,30,5,8,46
2020,47003,Buggiano,PT,73,2,30,0,5,37,4,40,5,15,64
2020,47003,Buggiano,PT,74,0,36,0,6,42,1,43,6,14,64
2020,47003,Buggiano,PT,75,3,34,1,3,41,2,26,1,17,46
2020,47003,Buggiano,PT,76,2,23,1,2,28,2,27,2,21,52
2020,47003,Buggiano,PT,77,1,31,1,5,38,0,33,2,13,48
2020,47003,Buggiano,PT,78,0,37,0,3,40,2,19,2,15,38
2020,47003,Buggiano,PT,79,3,35,1,2,41,2,18,1,21,42
2020,47003,Buggiano,PT,80,3,27,0,7,37,2,14,0,23,39
2020,47003,Buggiano,PT,81,5,30,0,7,42,2,17,0,22,41
2020,47003,Buggiano,PT,82,1,23,0,4,28,2,23,2,27,54
2020,47003,Buggiano,PT,83,2,21,2,3,28,4,12,0,20,36
2020,47003,Buggiano,PT,84,1,14,0,6,21,0,12,0,25,37
2020,47003,Buggiano,PT,85,2,20,1,4,27,1,13,0,29,43
2020,47003,Buggiano,PT,86,1,18,0,10,29,1,5,1,22,29
2020,47003,Buggiano,PT,87,0,7,0,3,10,0,5,0,20,25
2020,47003,Buggiano,PT,88,3,8,0,7,18,0,3,1,27,31
2020,47003,Buggiano,PT,89,0,5,0,0,5,0,2,0,18,20
2020,47003,Buggiano,PT,90,1,6,0,3,10,0,3,0,19,22
2020,47003,Buggiano,PT,91,0,7,0,0,7,0,1,0,14,15
2020,47003,Buggiano,PT,92,1,1,1,2,5,0,1,0,6,7
2020,47003,Buggiano,PT,93,1,3,0,3,7,1,0,1,9,11
2020,47003,Buggiano,PT,94,0,0,0,1,1,1,0,0,5,6
2020,47003,Buggiano,PT,95,0,0,0,2,2,0,0,0,3,3
2020,47003,Buggiano,PT,96,0,0,0,0,0,0,0,0,1,1
2020,47003,Buggiano,PT,97,0,0,0,0,0,0,0,0,6,6
2020,47003,Buggiano,PT,98,0,0,0,0,0,0,0,0,3,3
2020,47003,Buggiano,PT,99,0,0,0,0,0,0,0,0,0,0
2020,47003,Buggiano,PT,100 e più,0,0,0,1,1,0,0,0,3,3
2020,47005,Lamporecchio,PT,0,16,0,0,0,16,20,0,0,0,20
2020,47005,Lamporecchio,PT,1,29,0,0,0,29,21,0,0,0,21
2020,47005,Lamporecchio,PT,2,15,0,0,0,15,22,0,0,0,22
2020,47005,Lamporecchio,PT,3,18,0,0,0,18,23,0,0,0,23
2020,47005,Lamporecchio,PT,4,29,0,0,0,29,21,0,0,0,21
2020,47005,Lamporecchio,PT,5,32,0,0,0,32,30,0,0,0,30
2020,47005,Lamporecchio,PT,6,31,0,0,0,31,26,0,0,0,26
2020,47005,Lamporecchio,PT,7,30,0,0,0,30,39,0,0,0,39
2020,47005,Lamporecchio,PT,8,31,0,0,0,31,36,0,0,0,36
2020,47005,Lamporecchio,PT,9,30,0,0,0,30,39,0,0,0,39
2020,47005,Lamporecchio,PT,10,37,0,0,0,37,38,0,0,0,38
2020,47005,Lamporecchio,PT,11,47,0,0,0,47,31,0,0,0,31
2020,47005,Lamporecchio,PT,12,43,0,0,0,43,47,0,0,0,47
2020,47005,Lamporecchio,PT,13,35,0,0,0,35,25,0,0,0,25
2020,47005,Lamporecchio,PT,14,40,0,0,0,40,36,0,0,0,36
2020,47005,Lamporecchio,PT,15,35,0,0,0,35,27,0,0,0,27
2020,47005,Lamporecchio,PT,16,27,0,0,0,27,37,0,0,0,37
2020,47005,Lamporecchio,PT,17,29,0,0,0,29,38,0,0,0,38
2020,47005,Lamporecchio,PT,18,40,0,0,0,40,19,0,0,0,19
2020,47005,Lamporecchio,PT,19,35,0,0,0,35,32,0,0,0,32
2020,47005,Lamporecchio,PT,20,25,0,0,0,25,28,1,0,0,29
2020,47005,Lamporecchio,PT,21,31,0,0,0,31,35,1,0,0,36
2020,47005,Lamporecchio,PT,22,47,0,0,0,47,27,0,0,0,27
2020,47005,Lamporecchio,PT,23,21,0,0,0,21,35,2,0,0,37
2020,47005,Lamporecchio,PT,24,31,0,0,0,31,23,1,0,0,24
2020,47005,Lamporecchio,PT,25,41,0,0,0,41,29,2,0,0,31
2020,47005,Lamporecchio,PT,26,30,1,0,0,31,29,5,0,0,34
2020,47005,Lamporecchio,PT,27,34,3,0,0,37,19,3,0,0,22
2020,47005,Lamporecchio,PT,28,37,4,0,0,41,21,7,0,0,28
2020,47005,Lamporecchio,PT,29,38,2,0,0,40,19,6,0,0,25
2020,47005,Lamporecchio,PT,30,22,7,0,0,29,22,12,0,0,34
2020,47005,Lamporecchio,PT,31,37,7,0,0,44,21,11,0,0,32
2020,47005,Lamporecchio,PT,32,24,4,0,0,28,27,15,0,0,42
2020,47005,Lamporecchio,PT,33,30,8,0,0,38,15,12,1,0,28
2020,47005,Lamporecchio,PT,34,21,15,0,0,36,21,11,0,1,33
2020,47005,Lamporecchio,PT,35,22,10,0,0,32,19,20,0,0,39
2020,47005,Lamporecchio,PT,36,27,5,1,0,33,16,23,0,1,40
2020,47005,Lamporecchio,PT,37,22,19,0,0,41,26,28,1,0,55
2020,47005,Lamporecchio,PT,38,17,20,0,0,37,18,29,3,0,50
2020,47005,Lamporecchio,PT,39,26,16,0,0,42,20,28,0,1,49
2020,47005,Lamporecchio,PT,40,15,23,1,0,39,13,26,3,0,42
2020,47005,Lamporecchio,PT,41,29,36,2,1,68,18,34,2,2,56
2020,47005,Lamporecchio,PT,42,28,21,5,0,54,16,37,3,0,56
2020,47005,Lamporecchio,PT,43,16,26,2,0,44,25,29,1,2,57
2020,47005,Lamporecchio,PT,44,17,29,2,0,48,17,32,5,0,54
2020,47005,Lamporecchio,PT,45,21,35,4,0,60,14,52,4,2,72
2020,47005,Lamporecchio,PT,46,21,34,2,0,57,24,37,6,0,67
2020,47005,Lamporecchio,PT,47,17,40,7,0,64,9,49,4,1,63
2020,47005,Lamporecchio,PT,48,19,29,2,0,50,12,34,6,0,52
2020,47005,Lamporecchio,PT,49,15,36,1,1,53,15,52,6,0,73
2020,47005,Lamporecchio,PT,50,12,38,5,1,56,5,43,5,2,55
2020,47005,Lamporecchio,PT,51,13,40,8,0,61,10,46,5,1,62
2020,47005,Lamporecchio,PT,52,16,45,7,0,68,10,53,7,3,73
2020,47005,Lamporecchio,PT,53,18,58,7,0,83,8,53,4,1,66
2020,47005,Lamporecchio,PT,54,13,48,8,0,69,7,33,7,2,49
2020,47005,Lamporecchio,PT,55,7,40,2,0,49,5,47,8,1,61
2020,47005,Lamporecchio,PT,56,8,39,1,0,48,5,58,5,1,69
2020,47005,Lamporecchio,PT,57,10,47,7,0,64,6,46,6,2,60
2020,47005,Lamporecchio,PT,58,5,45,2,0,52,2,57,3,2,64
2020,47005,Lamporecchio,PT,59,5,59,3,1,68,5,58,3,3,69
2020,47005,Lamporecchio,PT,60,4,45,3,3,55,3,38,3,0,44
2020,47005,Lamporecchio,PT,61,2,44,3,2,51,5,38,4,8,55
2020,47005,Lamporecchio,PT,62,3,37,4,2,46,3,42,2,2,49
2020,47005,Lamporecchio,PT,63,4,33,3,1,41,1,44,3,8,56
2020,47005,Lamporecchio,PT,64,6,39,2,2,49,0,35,1,8,44
2020,47005,Lamporecchio,PT,65,3,38,2,2,45,5,35,4,7,51
2020,47005,Lamporecchio,PT,66,2,30,2,1,35,3,36,3,3,45
2020,47005,Lamporecchio,PT,67,6,41,3,1,51,1,32,2,8,43
2020,47005,Lamporecchio,PT,68,0,30,2,2,34,2,32,1,10,45
2020,47005,Lamporecchio,PT,69,3,43,0,1,47,3,41,3,1,48
2020,47005,Lamporecchio,PT,70,3,37,1,4,45,0,39,3,8,50
2020,47005,Lamporecchio,PT,71,4,30,2,2,38,1,41,1,13,56
2020,47005,Lamporecchio,PT,72,4,25,2,3,34,3,28,1,13,45
2020,47005,Lamporecchio,PT,73,1,48,1,3,53,1,31,1,10,43
2020,47005,Lamporecchio,PT,74,3,22,0,4,29,1,39,0,14,54
2020,47005,Lamporecchio,PT,75,2,33,0,3,38,2,19,1,14,36
2020,47005,Lamporecchio,PT,76,0,33,4,4,41,0,23,5,9,37
2020,47005,Lamporecchio,PT,77,4,39,0,2,45,0,22,0,13,35
2020,47005,Lamporecchio,PT,78,2,17,1,5,25,1,28,0,12,41
2020,47005,Lamporecchio,PT,79,1,24,4,2,31,0,17,1,15,33
2020,47005,Lamporecchio,PT,80,2,28,1,6,37,1,16,0,22,39
2020,47005,Lamporecchio,PT,81,2,29,0,2,33,1,16,0,16,33
2020,47005,Lamporecchio,PT,82,3,27,0,8,38,1,8,0,19,28
2020,47005,Lamporecchio,PT,83,1,23,0,6,30,0,14,0,18,32
2020,47005,Lamporecchio,PT,84,0,18,0,4,22,1,10,1,19,31
2020,47005,Lamporecchio,PT,85,0,18,0,2,20,0,7,0,17,24
2020,47005,Lamporecchio,PT,86,1,11,0,7,19,0,6,0,16,22
2020,47005,Lamporecchio,PT,87,1,6,0,2,9,0,4,0,14,18
2020,47005,Lamporecchio,PT,88,0,7,0,3,10,1,4,0,19,24
2020,47005,Lamporecchio,PT,89,0,3,0,4,7,0,4,0,19,23
2020,47005,Lamporecchio,PT,90,1,4,0,3,8,0,2,0,19,21
2020,47005,Lamporecchio,PT,91,0,5,0,5,10,0,0,0,12,12
2020,47005,Lamporecchio,PT,92,0,3,0,1,4,0,1,0,16,17
2020,47005,Lamporecchio,PT,93,0,2,0,1,3,1,0,0,8,9
2020,47005,Lamporecchio,PT,94,0,2,0,0,2,0,0,0,8,8
2020,47005,Lamporecchio,PT,95,1,0,0,0,1,0,1,0,7,8
2020,47005,Lamporecchio,PT,96,0,1,0,1,2,0,0,0,2,2
2020,47005,Lamporecchio,PT,97,0,0,0,0,0,0,0,0,4,4
2020,47005,Lamporecchio,PT,98,0,0,0,0,0,0,0,0,4,4
2020,47005,Lamporecchio,PT,99,0,0,0,1,1,0,0,0,1,1
2020,47005,Lamporecchio,PT,100 e più,0,0,0,0,0,0,0,0,2,2
2020,47006,Larciano,PT,0,17,0,0,0,17,19,0,0,0,19
2020,47006,Larciano,PT,1,25,0,0,0,25,18,0,0,0,18
2020,47006,Larciano,PT,2,25,0,0,0,25,14,0,0,0,14
2020,47006,Larciano,PT,3,23,0,0,0,23,17,0,0,0,17
2020,47006,Larciano,PT,4,25,0,0,0,25,18,0,0,0,18
2020,47006,Larciano,PT,5,23,0,0,0,23,24,0,0,0,24
2020,47006,Larciano,PT,6,19,0,0,0,19,32,0,0,0,32
2020,47006,Larciano,PT,7,25,0,0,0,25,23,0,0,0,23
2020,47006,Larciano,PT,8,17,0,0,0,17,28,0,0,0,28
2020,47006,Larciano,PT,9,31,0,0,0,31,32,0,0,0,32
2020,47006,Larciano,PT,10,30,0,0,0,30,32,0,0,0,32
2020,47006,Larciano,PT,11,29,0,0,0,29,28,0,0,0,28
2020,47006,Larciano,PT,12,35,0,0,0,35,18,0,0,0,18
2020,47006,Larciano,PT,13,20,0,0,0,20,31,0,0,0,31
2020,47006,Larciano,PT,14,26,0,0,0,26,34,0,0,0,34
2020,47006,Larciano,PT,15,16,0,0,0,16,16,0,0,0,16
2020,47006,Larciano,PT,16,36,0,0,0,36,24,0,0,0,24
2020,47006,Larciano,PT,17,29,0,0,0,29,19,0,0,0,19
2020,47006,Larciano,PT,18,23,0,0,0,23,24,0,0,0,24
2020,47006,Larciano,PT,19,26,0,0,0,26,36,0,0,0,36
2020,47006,Larciano,PT,20,41,0,0,0,41,34,1,0,0,35
2020,47006,Larciano,PT,21,37,0,0,0,37,27,0,0,0,27
2020,47006,Larciano,PT,22,32,0,0,0,32,19,1,0,0,20
2020,47006,Larciano,PT,23,40,0,0,0,40,24,1,0,0,25
2020,47006,Larciano,PT,24,23,1,0,0,24,33,2,0,0,35
2020,47006,Larciano,PT,25,29,0,0,0,29,26,2,0,0,28
2020,47006,Larciano,PT,26,32,0,0,0,32,27,6,0,0,33
2020,47006,Larciano,PT,27,28,0,0,0,28,35,2,0,0,37
2020,47006,Larciano,PT,28,23,4,0,0,27,18,6,0,0,24
2020,47006,Larciano,PT,29,32,3,0,0,35,23,10,0,0,33
2020,47006,Larciano,PT,30,33,7,0,0,40,15,11,0,0,26
2020,47006,Larciano,PT,31,21,1,1,0,23,21,5,0,0,26
2020,47006,Larciano,PT,32,22,6,0,0,28,15,17,0,0,32
2020,47006,Larciano,PT,33,22,9,0,0,31,17,15,0,0,32
2020,47006,Larciano,PT,34,15,13,0,0,28,17,12,1,0,30
2020,47006,Larciano,PT,35,19,10,1,0,30,24,24,0,0,48
2020,47006,Larciano,PT,36,23,21,1,0,45,8,20,2,0,30
2020,47006,Larciano,PT,37,23,14,0,0,37,8,16,0,0,24
2020,47006,Larciano,PT,38,15,12,2,0,29,20,19,2,2,43
2020,47006,Larciano,PT,39,9,20,2,0,31,14,26,0,0,40
2020,47006,Larciano,PT,40,23,12,0,0,35,9,19,0,0,28
2020,47006,Larciano,PT,41,11,18,1,0,30,18,27,3,2,50
2020,47006,Larciano,PT,42,15,32,0,0,47,9,23,2,1,35
2020,47006,Larciano,PT,43,22,28,2,0,52,19,37,2,1,59
2020,47006,Larciano,PT,44,20,24,1,0,45,12,33,3,0,48
2020,47006,Larciano,PT,45,18,31,0,0,49,10,29,2,1,42
2020,47006,Larciano,PT,46,14,28,1,1,44,14,37,1,0,52
2020,47006,Larciano,PT,47,16,36,3,0,55,15,39,5,0,59
2020,47006,Larciano,PT,48,11,25,2,0,38,8,33,3,2,46
2020,47006,Larciano,PT,49,7,43,2,0,52,12,37,7,3,59
2020,47006,Larciano,PT,50,18,35,4,0,57,4,35,4,1,44
2020,47006,Larciano,PT,51,18,35,4,0,57,6,40,5,0,51
2020,47006,Larciano,PT,52,7,41,5,0,53,6,35,3,1,45
2020,47006,Larciano,PT,53,13,28,5,0,46,15,50,4,4,73
2020,47006,Larciano,PT,54,8,42,6,2,58,3,40,4,1,48
2020,47006,Larciano,PT,55,6,39,3,0,48,4,39,6,3,52
2020,47006,Larciano,PT,56,7,41,6,0,54,7,30,7,1,45
2020,47006,Larciano,PT,57,3,37,5,1,46,4,50,7,1,62
2020,47006,Larciano,PT,58,8,36,5,1,50,4,32,3,3,42
2020,47006,Larciano,PT,59,7,33,1,4,45,2,38,5,4,49
2020,47006,Larciano,PT,60,5,42,6,1,54,2,45,1,4,52
2020,47006,Larciano,PT,61,2,42,0,0,44,4,40,2,1,47
2020,47006,Larciano,PT,62,4,35,3,1,43,3,28,2,2,35
2020,47006,Larciano,PT,63,3,39,0,0,42,1,44,2,1,48
2020,47006,Larciano,PT,64,3,44,1,0,48,0,25,1,6,32
2020,47006,Larciano,PT,65,5,36,1,2,44,2,31,3,4,40
2020,47006,Larciano,PT,66,0,30,1,0,31,1,53,1,4,59
2020,47006,Larciano,PT,67,0,30,1,1,32,1,29,1,5,36
2020,47006,Larciano,PT,68,2,31,0,0,33,0,30,1,5,36
2020,47006,Larciano,PT,69,3,39,1,1,44,1,27,0,9,37
2020,47006,Larciano,PT,70,0,34,1,0,35,2,30,2,5,39
2020,47006,Larciano,PT,71,0,37,3,1,41,0,29,0,7,36
2020,47006,Larciano,PT,72,1,27,1,3,32,2,30,1,9,42
2020,47006,Larciano,PT,73,4,37,0,4,45,1,26,1,18,46
2020,47006,Larciano,PT,74,4,28,0,4,36,1,22,3,8,34
2020,47006,Larciano,PT,75,2,22,2,4,30,1,15,0,9,25
2020,47006,Larciano,PT,76,1,21,0,2,24,0,23,2,16,41
2020,47006,Larciano,PT,77,4,25,0,1,30,0,16,1,13,30
2020,47006,Larciano,PT,78,1,22,0,2,25,1,20,0,12,33
2020,47006,Larciano,PT,79,1,14,0,3,18,2,16,0,18,36
2020,47006,Larciano,PT,80,0,23,0,4,27,0,12,0,20,32
2020,47006,Larciano,PT,81,1,16,0,6,23,0,14,0,15,29
2020,47006,Larciano,PT,82,0,14,0,1,15,1,17,0,19,37
2020,47006,Larciano,PT,83,0,18,0,5,23,3,7,0,18,28
2020,47006,Larciano,PT,84,0,15,0,3,18,3,8,0,22,33
2020,47006,Larciano,PT,85,1,23,1,4,29,2,7,0,19,28
2020,47006,Larciano,PT,86,0,14,0,4,18,0,3,0,17,20
2020,47006,Larciano,PT,87,1,7,0,0,8,0,4,0,17,21
2020,47006,Larciano,PT,88,2,9,0,2,13,1,6,0,16,23
2020,47006,Larciano,PT,89,2,2,0,2,6,1,4,0,15,20
2020,47006,Larciano,PT,90,0,8,0,4,12,0,4,0,8,12
2020,47006,Larciano,PT,91,0,2,0,5,7,0,1,0,9,10
2020,47006,Larciano,PT,92,0,1,0,5,6,0,1,0,3,4
2020,47006,Larciano,PT,93,0,4,0,2,6,0,0,0,7,7
2020,47006,Larciano,PT,94,0,2,0,1,3,0,1,0,7,8
2020,47006,Larciano,PT,95,0,2,0,0,2,0,0,0,3,3
2020,47006,Larciano,PT,96,0,1,0,1,2,0,0,0,5,5
2020,47006,Larciano,PT,97,0,0,0,1,1,0,0,0,4,4
2020,47006,Larciano,PT,98,0,0,0,0,0,0,0,0,2,2
2020,47006,Larciano,PT,99,0,0,0,0,0,0,0,0,7,7
2020,47006,Larciano,PT,100 e più,0,0,0,0,0,0,0,0,0,0
2020,47007,Marliana,PT,0,10,0,0,0,10,6,0,0,0,6
2020,47007,Marliana,PT,1,16,0,0,0,16,4,0,0,0,4
2020,47007,Marliana,PT,2,12,0,0,0,12,16,0,0,0,16
2020,47007,Marliana,PT,3,16,0,0,0,16,9,0,0,0,9
2020,47007,Marliana,PT,4,8,0,0,0,8,11,0,0,0,11
2020,47007,Marliana,PT,5,10,0,0,0,10,9,0,0,0,9
2020,47007,Marliana,PT,6,8,0,0,0,8,14,0,0,0,14
2020,47007,Marliana,PT,7,3,0,0,0,3,14,0,0,0,14
2020,47007,Marliana,PT,8,13,0,0,0,13,11,0,0,0,11
2020,47007,Marliana,PT,9,9,0,0,0,9,10,0,0,0,10
2020,47007,Marliana,PT,10,9,0,0,0,9,13,0,0,0,13
2020,47007,Marliana,PT,11,14,0,0,0,14,9,0,0,0,9
2020,47007,Marliana,PT,12,17,0,0,0,17,6,0,0,0,6
2020,47007,Marliana,PT,13,15,0,0,0,15,16,0,0,0,16
2020,47007,Marliana,PT,14,9,0,0,0,9,10,0,0,0,10
2020,47007,Marliana,PT,15,11,0,0,0,11,14,0,0,0,14
2020,47007,Marliana,PT,16,17,0,0,0,17,8,0,0,0,8
2020,47007,Marliana,PT,17,11,0,0,0,11,10,0,0,0,10
2020,47007,Marliana,PT,18,8,0,0,0,8,10,0,0,0,10
2020,47007,Marliana,PT,19,9,0,0,0,9,12,0,0,0,12
2020,47007,Marliana,PT,20,12,0,0,0,12,13,0,0,0,13
2020,47007,Marliana,PT,21,17,0,0,0,17,10,1,0,0,11
2020,47007,Marliana,PT,22,14,0,0,0,14,12,1,0,0,13
2020,47007,Marliana,PT,23,11,1,0,0,12,8,0,0,0,8
2020,47007,Marliana,PT,24,9,0,0,0,9,10,0,0,0,10
2020,47007,Marliana,PT,25,6,0,0,1,7,13,1,0,0,14
2020,47007,Marliana,PT,26,13,0,0,0,13,7,0,0,0,7
2020,47007,Marliana,PT,27,17,1,0,1,19,10,1,0,0,11
2020,47007,Marliana,PT,28,16,0,0,2,18,9,2,0,1,12
2020,47007,Marliana,PT,29,12,0,0,1,13,9,1,1,0,11
2020,47007,Marliana,PT,30,17,2,0,0,19,16,1,0,0,17
2020,47007,Marliana,PT,31,12,5,1,0,18,9,6,0,0,15
2020,47007,Marliana,PT,32,9,2,0,0,11,10,4,0,0,14
2020,47007,Marliana,PT,33,6,4,1,0,11,11,3,2,0,16
2020,47007,Marliana,PT,34,7,2,0,1,10,3,4,0,0,7
2020,47007,Marliana,PT,35,13,7,0,0,20,8,12,0,0,20
2020,47007,Marliana,PT,36,3,3,0,1,7,8,10,2,0,20
2020,47007,Marliana,PT,37,13,4,0,0,17,6,5,1,0,12
2020,47007,Marliana,PT,38,9,9,0,0,18,5,16,1,0,22
2020,47007,Marliana,PT,39,12,8,1,0,21,8,8,0,0,16
2020,47007,Marliana,PT,40,13,7,0,0,20,7,11,0,2,20
2020,47007,Marliana,PT,41,10,7,1,0,18,8,7,2,0,17
2020,47007,Marliana,PT,42,17,11,2,0,30,9,14,3,0,26
2020,47007,Marliana,PT,43,12,8,2,1,23,13,11,0,1,25
2020,47007,Marliana,PT,44,6,15,2,1,24,7,9,1,1,18
2020,47007,Marliana,PT,45,10,16,2,0,28,8,18,2,0,28
2020,47007,Marliana,PT,46,6,13,3,0,22,7,20,4,2,33
2020,47007,Marliana,PT,47,10,20,1,0,31,4,13,0,2,19
2020,47007,Marliana,PT,48,13,14,4,0,31,6,8,4,1,19
2020,47007,Marliana,PT,49,7,16,3,0,26,3,16,1,1,21
2020,47007,Marliana,PT,50,21,16,3,0,40,8,13,4,1,26
2020,47007,Marliana,PT,51,9,13,5,0,27,5,23,3,0,31
2020,47007,Marliana,PT,52,10,16,0,0,26,1,11,3,0,15
2020,47007,Marliana,PT,53,5,19,4,0,28,8,16,0,1,25
2020,47007,Marliana,PT,54,6,13,5,0,24,4,20,5,1,30
2020,47007,Marliana,PT,55,3,29,1,0,33,2,13,3,1,19
2020,47007,Marliana,PT,56,7,14,4,1,26,4,19,2,0,25
2020,47007,Marliana,PT,57,3,10,3,0,16,4,18,1,3,26
2020,47007,Marliana,PT,58,4,18,1,0,23,4,17,1,3,25
2020,47007,Marliana,PT,59,5,14,2,0,21,2,18,2,1,23
2020,47007,Marliana,PT,60,0,20,5,1,26,2,15,4,4,25
2020,47007,Marliana,PT,61,1,28,4,0,33,2,14,3,3,22
2020,47007,Marliana,PT,62,2,20,1,0,23,1,14,1,4,20
2020,47007,Marliana,PT,63,2,20,2,0,24,1,21,2,3,27
2020,47007,Marliana,PT,64,1,15,3,0,19,1,24,2,5,32
2020,47007,Marliana,PT,65,2,17,1,0,20,2,16,1,6,25
2020,47007,Marliana,PT,66,1,26,1,0,28,4,21,1,9,35
2020,47007,Marliana,PT,67,1,18,3,0,22,1,17,5,2,25
2020,47007,Marliana,PT,68,3,14,0,2,19,4,22,3,5,34
2020,47007,Marliana,PT,69,1,18,1,1,21,1,7,1,4,13
2020,47007,Marliana,PT,70,2,17,2,3,24,3,15,1,6,25
2020,47007,Marliana,PT,71,4,16,7,0,27,0,18,1,4,23
2020,47007,Marliana,PT,72,4,23,4,4,35,1,13,2,2,18
2020,47007,Marliana,PT,73,0,16,0,2,18,1,11,2,7,21
2020,47007,Marliana,PT,74,1,20,0,2,23,0,18,1,4,23
2020,47007,Marliana,PT,75,0,14,1,0,15,0,8,2,3,13
2020,47007,Marliana,PT,76,0,15,1,2,18,0,6,0,5,11
2020,47007,Marliana,PT,77,1,10,2,1,14,1,9,2,8,20
2020,47007,Marliana,PT,78,0,5,2,1,8,0,9,1,5,15
2020,47007,Marliana,PT,79,2,10,3,1,16,0,5,0,9,14
2020,47007,Marliana,PT,80,1,9,2,1,13,0,3,0,7,10
2020,47007,Marliana,PT,81,0,12,0,4,16,0,7,0,4,11
2020,47007,Marliana,PT,82,1,6,2,0,9,1,6,1,8,16
2020,47007,Marliana,PT,83,1,6,1,1,9,1,3,0,11,15
2020,47007,Marliana,PT,84,2,5,0,2,9,1,4,0,9,14
2020,47007,Marliana,PT,85,1,6,0,2,9,0,3,0,9,12
2020,47007,Marliana,PT,86,2,3,0,5,10,1,4,0,8,13
2020,47007,Marliana,PT,87,0,4,0,1,5,0,3,1,4,8
2020,47007,Marliana,PT,88,2,5,0,2,9,0,0,0,10,10
2020,47007,Marliana,PT,89,0,5,0,1,6,0,2,0,7,9
2020,47007,Marliana,PT,90,0,1,1,1,3,0,4,1,4,9
2020,47007,Marliana,PT,91,1,2,0,0,3,0,0,0,7,7
2020,47007,Marliana,PT,92,0,5,0,0,5,0,0,0,4,4
2020,47007,Marliana,PT,93,0,0,0,2,2,0,0,0,3,3
2020,47007,Marliana,PT,94,0,1,0,1,2,1,0,0,5,6
2020,47007,Marliana,PT,95,0,0,0,0,0,0,1,0,4,5
2020,47007,Marliana,PT,96,0,0,0,0,0,0,0,0,2,2
2020,47007,Marliana,PT,97,0,1,0,1,2,0,0,0,3,3
2020,47007,Marliana,PT,98,0,0,0,0,0,0,0,0,2,2
2020,47007,Marliana,PT,99,0,0,0,0,0,0,0,0,2,2
2020,47007,Marliana,PT,100 e più,0,0,0,0,0,0,0,0,3,3
2020,47008,Massa e Cozzile,PT,0,13,0,0,0,13,22,0,0,0,22
2020,47008,Massa e Cozzile,PT,1,19,0,0,0,19,30,0,0,0,30
2020,47008,Massa e Cozzile,PT,2,27,0,0,0,27,19,0,0,0,19
2020,47008,Massa e Cozzile,PT,3,16,0,0,0,16,33,0,0,0,33
2020,47008,Massa e Cozzile,PT,4,29,0,0,0,29,28,0,0,0,28
2020,47008,Massa e Cozzile,PT,5,33,0,0,0,33,30,0,0,0,30
2020,47008,Massa e Cozzile,PT,6,37,0,0,0,37,36,0,0,0,36
2020,47008,Massa e Cozzile,PT,7,40,0,0,0,40,34,0,0,0,34
2020,47008,Massa e Cozzile,PT,8,20,0,0,0,20,37,0,0,0,37
2020,47008,Massa e Cozzile,PT,9,42,0,0,0,42,29,0,0,0,29
2020,47008,Massa e Cozzile,PT,10,24,0,0,0,24,31,0,0,0,31
2020,47008,Massa e Cozzile,PT,11,34,0,0,0,34,22,0,0,0,22
2020,47008,Massa e Cozzile,PT,12,41,0,0,0,41,44,0,0,0,44
2020,47008,Massa e Cozzile,PT,13,41,0,0,0,41,40,0,0,0,40
2020,47008,Massa e Cozzile,PT,14,40,0,0,0,40,35,0,0,0,35
2020,47008,Massa e Cozzile,PT,15,48,0,0,0,48,25,0,0,0,25
2020,47008,Massa e Cozzile,PT,16,40,0,0,0,40,43,0,0,0,43
2020,47008,Massa e Cozzile,PT,17,42,0,0,0,42,20,0,0,0,20
2020,47008,Massa e Cozzile,PT,18,37,0,0,0,37,25,0,0,0,25
2020,47008,Massa e Cozzile,PT,19,25,0,0,0,25,51,0,0,0,51
2020,47008,Massa e Cozzile,PT,20,40,0,0,0,40,32,0,0,0,32
2020,47008,Massa e Cozzile,PT,21,31,0,0,0,31,28,1,0,0,29
2020,47008,Massa e Cozzile,PT,22,28,0,0,0,28,35,0,0,0,35
2020,47008,Massa e Cozzile,PT,23,36,0,0,0,36,37,1,0,0,38
2020,47008,Massa e Cozzile,PT,24,38,0,0,0,38,22,2,0,0,24
2020,47008,Massa e Cozzile,PT,25,24,1,0,0,25,27,6,0,0,33
2020,47008,Massa e Cozzile,PT,26,25,2,0,0,27,24,5,1,0,30
2020,47008,Massa e Cozzile,PT,27,38,1,0,0,39,26,5,0,0,31
2020,47008,Massa e Cozzile,PT,28,26,2,0,0,28,29,7,0,0,36
2020,47008,Massa e Cozzile,PT,29,33,3,0,0,36,20,8,0,0,28
2020,47008,Massa e Cozzile,PT,30,33,3,0,0,36,30,15,0,0,45
2020,47008,Massa e Cozzile,PT,31,20,5,0,0,25,23,7,0,0,30
2020,47008,Massa e Cozzile,PT,32,39,8,0,0,47,25,10,0,0,35
2020,47008,Massa e Cozzile,PT,33,26,12,0,0,38,22,14,0,0,36
2020,47008,Massa e Cozzile,PT,34,28,7,2,0,37,21,14,2,0,37
2020,47008,Massa e Cozzile,PT,35,19,18,0,0,37,25,18,0,0,43
2020,47008,Massa e Cozzile,PT,36,31,15,0,0,46,17,18,1,1,37
2020,47008,Massa e Cozzile,PT,37,20,16,0,0,36,14,33,3,0,50
2020,47008,Massa e Cozzile,PT,38,25,20,0,0,45,17,33,2,0,52
2020,47008,Massa e Cozzile,PT,39,20,16,0,0,36,21,32,0,0,53
2020,47008,Massa e Cozzile,PT,40,14,31,2,0,47,22,36,3,0,61
2020,47008,Massa e Cozzile,PT,41,15,19,2,0,36,10,35,1,0,46
2020,47008,Massa e Cozzile,PT,42,13,28,1,0,42,14,30,3,1,48
2020,47008,Massa e Cozzile,PT,43,14,30,5,0,49,16,34,4,0,54
2020,47008,Massa e Cozzile,PT,44,23,30,1,0,54,19,44,4,0,67
2020,47008,Massa e Cozzile,PT,45,22,33,4,0,59,14,49,6,0,69
2020,47008,Massa e Cozzile,PT,46,22,20,4,0,46,17,52,4,1,74
2020,47008,Massa e Cozzile,PT,47,22,43,1,0,66,9,55,4,1,69
2020,47008,Massa e Cozzile,PT,48,27,37,1,0,65,13,41,8,2,64
2020,47008,Massa e Cozzile,PT,49,21,49,5,0,75,17,36,7,0,60
2020,47008,Massa e Cozzile,PT,50,15,46,7,0,68,7,50,10,3,70
2020,47008,Massa e Cozzile,PT,51,18,47,2,1,68,14,35,5,1,55
2020,47008,Massa e Cozzile,PT,52,20,43,5,1,69,8,48,5,1,62
2020,47008,Massa e Cozzile,PT,53,13,43,4,0,60,12,49,11,0,72
2020,47008,Massa e Cozzile,PT,54,8,42,4,0,54,12,46,7,2,67
2020,47008,Massa e Cozzile,PT,55,11,36,3,0,50,13,43,8,0,64
2020,47008,Massa e Cozzile,PT,56,8,52,7,2,69,4,41,8,1,54
2020,47008,Massa e Cozzile,PT,57,10,39,6,1,56,7,40,9,2,58
2020,47008,Massa e Cozzile,PT,58,3,43,5,2,53,13,46,9,3,71
2020,47008,Massa e Cozzile,PT,59,7,59,5,1,72,9,48,10,4,71
2020,47008,Massa e Cozzile,PT,60,9,40,7,0,56,3,51,6,1,61
2020,47008,Massa e Cozzile,PT,61,6,44,6,2,58,4,45,10,7,66
2020,47008,Massa e Cozzile,PT,62,3,53,4,2,62,8,38,8,2,56
2020,47008,Massa e Cozzile,PT,63,3,41,3,0,47,2,45,6,2,55
2020,47008,Massa e Cozzile,PT,64,5,33,3,1,42,1,35,9,2,47
2020,47008,Massa e Cozzile,PT,65,3,36,6,4,49,2,42,7,6,57
2020,47008,Massa e Cozzile,PT,66,6,33,3,1,43,5,45,2,6,58
2020,47008,Massa e Cozzile,PT,67,3,42,3,1,49,3,34,4,9,50
2020,47008,Massa e Cozzile,PT,68,1,33,4,2,40,7,33,4,8,52
2020,47008,Massa e Cozzile,PT,69,4,39,1,5,49,1,27,4,12,44
2020,47008,Massa e Cozzile,PT,70,1,34,4,6,45,3,41,8,8,60
2020,47008,Massa e Cozzile,PT,71,1,33,1,6,41,2,32,4,8,46
2020,47008,Massa e Cozzile,PT,72,5,28,4,7,44,1,36,5,6,48
2020,47008,Massa e Cozzile,PT,73,3,41,3,1,48,0,38,4,7,49
2020,47008,Massa e Cozzile,PT,74,1,34,2,3,40,2,27,6,10,45
2020,47008,Massa e Cozzile,PT,75,1,22,4,1,28,1,33,6,14,54
2020,47008,Massa e Cozzile,PT,76,1,28,1,4,34,1,19,3,11,34
2020,47008,Massa e Cozzile,PT,77,1,31,0,5,37,2,27,1,19,49
2020,47008,Massa e Cozzile,PT,78,1,26,2,2,31,1,20,2,14,37
2020,47008,Massa e Cozzile,PT,79,1,20,0,4,25,2,15,1,17,35
2020,47008,Massa e Cozzile,PT,80,3,21,2,4,30,2,21,2,22,47
2020,47008,Massa e Cozzile,PT,81,1,30,1,8,40,0,20,2,17,39
2020,47008,Massa e Cozzile,PT,82,0,23,0,3,26,2,12,0,19,33
2020,47008,Massa e Cozzile,PT,83,1,22,1,5,29,2,13,1,22,38
2020,47008,Massa e Cozzile,PT,84,1,19,0,2,22,0,10,0,26,36
2020,47008,Massa e Cozzile,PT,85,2,15,1,5,23,0,8,1,22,31
2020,47008,Massa e Cozzile,PT,86,1,15,0,1,17,0,7,0,20,27
2020,47008,Massa e Cozzile,PT,87,1,11,0,4,16,1,2,1,21,25
2020,47008,Massa e Cozzile,PT,88,0,7,0,3,10,1,8,0,23,32
2020,47008,Massa e Cozzile,PT,89,0,7,0,7,14,0,2,0,10,12
2020,47008,Massa e Cozzile,PT,90,0,4,0,9,13,1,0,0,28,29
2020,47008,Massa e Cozzile,PT,91,0,5,0,3,8,0,2,0,12,14
2020,47008,Massa e Cozzile,PT,92,0,4,0,2,6,0,2,0,14,16
2020,47008,Massa e Cozzile,PT,93,0,0,0,2,2,1,2,0,9,12
2020,47008,Massa e Cozzile,PT,94,0,3,0,2,5,0,0,0,12,12
2020,47008,Massa e Cozzile,PT,95,0,0,0,0,0,0,0,0,7,7
2020,47008,Massa e Cozzile,PT,96,0,1,1,2,4,0,0,0,9,9
2020,47008,Massa e Cozzile,PT,97,0,2,0,0,2,0,0,0,2,2
2020,47008,Massa e Cozzile,PT,98,0,0,0,0,0,0,0,0,1,1
2020,47008,Massa e Cozzile,PT,99,0,1,0,0,1,0,0,0,1,1
2020,47008,Massa e Cozzile,PT,100 e più,0,0,0,0,0,1,0,0,3,4
2020,47009,Monsummano Terme,PT,0,66,0,0,0,66,78,0,0,0,78
2020,47009,Monsummano Terme,PT,1,71,0,0,0,71,56,0,0,0,56
2020,47009,Monsummano Terme,PT,2,77,0,0,0,77,75,0,0,0,75
2020,47009,Monsummano Terme,PT,3,95,0,0,0,95,53,0,0,0,53
2020,47009,Monsummano Terme,PT,4,104,0,0,0,104,91,0,0,0,91
2020,47009,Monsummano Terme,PT,5,90,0,0,0,90,86,0,0,0,86
2020,47009,Monsummano Terme,PT,6,103,0,0,0,103,84,0,0,0,84
2020,47009,Monsummano Terme,PT,7,74,0,0,0,74,77,0,0,0,77
2020,47009,Monsummano Terme,PT,8,122,0,0,0,122,93,0,0,0,93
2020,47009,Monsummano Terme,PT,9,82,0,0,0,82,89,0,0,0,89
2020,47009,Monsummano Terme,PT,10,96,0,0,0,96,102,0,0,0,102
2020,47009,Monsummano Terme,PT,11,91,0,0,0,91,95,0,0,0,95
2020,47009,Monsummano Terme,PT,12,94,0,0,0,94,106,0,0,0,106
2020,47009,Monsummano Terme,PT,13,97,0,0,0,97,79,0,0,0,79
2020,47009,Monsummano Terme,PT,14,95,0,0,0,95,95,0,0,0,95
2020,47009,Monsummano Terme,PT,15,90,0,0,0,90,90,0,0,0,90
2020,47009,Monsummano Terme,PT,16,92,0,0,0,92,86,0,0,0,86
2020,47009,Monsummano Terme,PT,17,86,0,0,0,86,89,0,0,0,89
2020,47009,Monsummano Terme,PT,18,99,0,0,0,99,100,0,0,0,100
2020,47009,Monsummano Terme,PT,19,87,0,0,0,87,94,0,0,0,94
2020,47009,Monsummano Terme,PT,20,92,0,0,0,92,87,0,0,0,87
2020,47009,Monsummano Terme,PT,21,99,0,0,0,99,87,0,0,0,87
2020,47009,Monsummano Terme,PT,22,119,0,1,0,120,86,4,0,0,90
2020,47009,Monsummano Terme,PT,23,103,1,0,0,104,83,7,0,0,90
2020,47009,Monsummano Terme,PT,24,97,0,0,0,97,86,5,0,0,91
2020,47009,Monsummano Terme,PT,25,100,2,0,0,102,79,6,0,0,85
2020,47009,Monsummano Terme,PT,26,91,3,0,0,94,88,11,0,0,99
2020,47009,Monsummano Terme,PT,27,92,10,0,0,102,69,15,1,0,85
2020,47009,Monsummano Terme,PT,28,101,9,0,0,110,63,15,1,0,79
2020,47009,Monsummano Terme,PT,29,117,9,1,0,127,82,19,0,0,101
2020,47009,Monsummano Terme,PT,30,84,8,0,0,92,84,32,0,0,116
2020,47009,Monsummano Terme,PT,31,107,15,1,0,123,58,30,3,0,91
2020,47009,Monsummano Terme,PT,32,72,24,0,0,96,53,40,1,0,94
2020,47009,Monsummano Terme,PT,33,75,37,0,1,113,68,44,1,0,113
2020,47009,Monsummano Terme,PT,34,75,30,0,0,105,56,68,1,0,125
2020,47009,Monsummano Terme,PT,35,59,38,2,0,99,60,73,3,0,136
2020,47009,Monsummano Terme,PT,36,78,64,6,0,148,44,78,2,0,124
2020,47009,Monsummano Terme,PT,37,63,55,4,0,122,42,70,5,0,117
2020,47009,Monsummano Terme,PT,38,63,79,2,0,144,49,78,6,2,135
2020,47009,Monsummano Terme,PT,39,45,72,1,0,118,41,98,10,0,149
2020,47009,Monsummano Terme,PT,40,55,72,4,1,132,43,89,9,1,144
2020,47009,Monsummano Terme,PT,41,63,81,5,0,149,43,95,8,3,149
2020,47009,Monsummano Terme,PT,42,51,97,3,0,151,42,100,5,0,147
2020,47009,Monsummano Terme,PT,43,53,79,6,0,138,44,105,13,1,163
2020,47009,Monsummano Terme,PT,44,44,98,6,0,148,46,107,13,1,168
2020,47009,Monsummano Terme,PT,45,60,102,9,0,171,41,112,13,0,166
2020,47009,Monsummano Terme,PT,46,51,105,9,2,167,37,135,12,3,187
2020,47009,Monsummano Terme,PT,47,45,91,6,0,142,27,141,12,2,182
2020,47009,Monsummano Terme,PT,48,46,107,11,1,165,29,104,22,3,158
2020,47009,Monsummano Terme,PT,49,49,117,13,1,180,26,141,24,4,195
2020,47009,Monsummano Terme,PT,50,42,126,12,0,180,23,110,18,2,153
2020,47009,Monsummano Terme,PT,51,41,128,14,0,183,20,124,10,3,158
2020,47009,Monsummano Terme,PT,52,32,120,13,1,166,22,150,14,5,191
2020,47009,Monsummano Terme,PT,53,27,120,17,0,164,24,142,15,8,189
2020,47009,Monsummano Terme,PT,54,34,111,10,2,157,16,116,23,0,155
2020,47009,Monsummano Terme,PT,55,19,122,9,1,151,17,120,18,8,163
2020,47009,Monsummano Terme,PT,56,32,144,11,3,190,10,133,16,8,167
2020,47009,Monsummano Terme,PT,57,17,103,11,2,133,17,145,12,6,181
2020,47009,Monsummano Terme,PT,58,15,133,15,3,166,11,122,21,9,163
2020,47009,Monsummano Terme,PT,59,11,141,7,1,160,4,124,16,6,150
2020,47009,Monsummano Terme,PT,60,16,124,11,3,154,11,144,12,14,181
2020,47009,Monsummano Terme,PT,61,10,103,9,0,122,8,118,14,14,154
2020,47009,Monsummano Terme,PT,62,13,117,9,7,146,4,114,10,12,140
2020,47009,Monsummano Terme,PT,63,4,119,6,5,134,14,128,9,18,169
2020,47009,Monsummano Terme,PT,64,4,101,5,3,113,8,106,8,17,139
2020,47009,Monsummano Terme,PT,65,12,113,8,6,139,8,112,2,20,142
2020,47009,Monsummano Terme,PT,66,12,114,3,5,134,4,96,9,22,131
2020,47009,Monsummano Terme,PT,67,5,102,3,8,118,4,78,8,23,113
2020,47009,Monsummano Terme,PT,68,4,100,8,3,115,2,88,4,14,108
2020,47009,Monsummano Terme,PT,69,6,81,5,4,96,4,91,5,22,122
2020,47009,Monsummano Terme,PT,70,6,105,7,5,123,5,89,7,23,124
2020,47009,Monsummano Terme,PT,71,6,98,5,10,119,7,89,5,26,127
2020,47009,Monsummano Terme,PT,72,1,100,7,10,118,1,98,5,37,141
2020,47009,Monsummano Terme,PT,73,4,101,4,5,114,8,105,6,24,143
2020,47009,Monsummano Terme,PT,74,5,110,3,12,130,4,85,5,41,135
2020,47009,Monsummano Terme,PT,75,2,61,0,7,70,0,85,2,35,122
2020,47009,Monsummano Terme,PT,76,3,85,1,7,96,4,53,3,27,87
2020,47009,Monsummano Terme,PT,77,2,83,2,9,96,2,76,3,33,114
2020,47009,Monsummano Terme,PT,78,3,57,2,11,73,2,51,2,40,95
2020,47009,Monsummano Terme,PT,79,4,53,2,7,66,5,52,6,36,99
2020,47009,Monsummano Terme,PT,80,6,70,0,15,91,0,45,2,46,93
2020,47009,Monsummano Terme,PT,81,4,79,0,15,98,3,35,1,62,101
2020,47009,Monsummano Terme,PT,82,1,58,0,7,66,4,43,2,46,95
2020,47009,Monsummano Terme,PT,83,0,64,3,17,84,4,33,3,68,108
2020,47009,Monsummano Terme,PT,84,3,46,3,10,62,6,24,1,47,78
2020,47009,Monsummano Terme,PT,85,4,46,0,11,61,2,24,1,56,83
2020,47009,Monsummano Terme,PT,86,1,33,1,8,43,2,17,1,44,64
2020,47009,Monsummano Terme,PT,87,0,28,0,10,38,1,10,2,47,60
2020,47009,Monsummano Terme,PT,88,2,30,0,4,36,1,12,0,57,70
2020,47009,Monsummano Terme,PT,89,2,21,0,10,33,2,8,2,43,55
2020,47009,Monsummano Terme,PT,90,0,16,0,10,26,1,6,0,44,51
2020,47009,Monsummano Terme,PT,91,1,10,0,4,15,0,3,0,21,24
2020,47009,Monsummano Terme,PT,92,1,5,0,5,11,2,1,0,29,32
2020,47009,Monsummano Terme,PT,93,0,4,0,8,12,0,0,0,19,19
2020,47009,Monsummano Terme,PT,94,0,1,0,4,5,0,0,0,13,13
2020,47009,Monsummano Terme,PT,95,0,1,0,4,5,0,1,0,18,19
2020,47009,Monsummano Terme,PT,96,0,2,0,1,3,1,0,0,10,11
2020,47009,Monsummano Terme,PT,97,0,1,0,2,3,1,0,0,3,4
2020,47009,Monsummano Terme,PT,98,0,0,0,1,1,0,0,0,5,5
2020,47009,Monsummano Terme,PT,99,0,0,0,1,1,0,0,0,3,3
2020,47009,Monsummano Terme,PT,100 e più,0,0,0,1,1,0,0,0,2,2
2020,47010,Montale,PT,0,30,0,0,0,30,27,0,0,0,27
2020,47010,Montale,PT,1,28,0,0,0,28,31,0,0,0,31
2020,47010,Montale,PT,2,36,0,0,0,36,39,0,0,0,39
2020,47010,Montale,PT,3,38,0,0,0,38,47,0,0,0,47
2020,47010,Montale,PT,4,37,0,0,0,37,35,0,0,0,35
2020,47010,Montale,PT,5,52,0,0,0,52,59,0,0,0,59
2020,47010,Montale,PT,6,58,0,0,0,58,34,0,0,0,34
2020,47010,Montale,PT,7,46,0,0,0,46,40,0,0,0,40
2020,47010,Montale,PT,8,47,0,0,0,47,42,0,0,0,42
2020,47010,Montale,PT,9,54,0,0,0,54,52,0,0,0,52
2020,47010,Montale,PT,10,51,0,0,0,51,53,0,0,0,53
2020,47010,Montale,PT,11,38,0,0,0,38,46,0,0,0,46
2020,47010,Montale,PT,12,68,0,0,0,68,59,0,0,0,59
2020,47010,Montale,PT,13,56,0,0,0,56,44,0,0,0,44
2020,47010,Montale,PT,14,48,0,0,0,48,38,0,0,0,38
2020,47010,Montale,PT,15,51,0,0,0,51,44,0,0,0,44
2020,47010,Montale,PT,16,60,0,0,0,60,47,0,0,0,47
2020,47010,Montale,PT,17,58,0,0,0,58,63,0,0,0,63
2020,47010,Montale,PT,18,49,0,0,0,49,43,0,0,0,43
2020,47010,Montale,PT,19,54,0,0,0,54,41,1,0,0,42
2020,47010,Montale,PT,20,42,0,0,0,42,42,3,0,0,45
2020,47010,Montale,PT,21,53,0,0,0,53,42,2,0,0,44
2020,47010,Montale,PT,22,53,0,0,0,53,42,3,0,0,45
2020,47010,Montale,PT,23,50,0,0,0,50,58,1,0,0,59
2020,47010,Montale,PT,24,50,1,0,0,51,31,2,0,0,33
2020,47010,Montale,PT,25,39,0,0,0,39,26,1,0,0,27
2020,47010,Montale,PT,26,63,3,0,0,66,49,2,0,0,51
2020,47010,Montale,PT,27,49,1,0,0,50,40,7,0,0,47
2020,47010,Montale,PT,28,38,2,0,0,40,42,7,0,0,49
2020,47010,Montale,PT,29,41,3,0,0,44,29,7,1,0,37
2020,47010,Montale,PT,30,38,6,0,0,44,39,11,0,0,50
2020,47010,Montale,PT,31,46,6,0,0,52,39,12,0,0,51
2020,47010,Montale,PT,32,45,9,0,0,54,35,18,0,0,53
2020,47010,Montale,PT,33,31,14,1,0,46,34,14,1,1,50
2020,47010,Montale,PT,34,38,14,0,0,52,26,19,1,0,46
2020,47010,Montale,PT,35,38,20,0,0,58,23,31,3,0,57
2020,47010,Montale,PT,36,37,15,1,0,53,29,32,2,0,63
2020,47010,Montale,PT,37,37,24,1,0,62,16,38,5,0,59
2020,47010,Montale,PT,38,32,28,0,0,60,22,48,0,0,70
2020,47010,Montale,PT,39,28,30,1,0,59,32,35,3,0,70
2020,47010,Montale,PT,40,32,45,0,1,78,29,46,3,0,78
2020,47010,Montale,PT,41,32,38,4,0,74,24,48,1,0,73
2020,47010,Montale,PT,42,40,51,1,0,92,20,52,4,0,76
2020,47010,Montale,PT,43,30,46,6,2,84,17,50,5,2,74
2020,47010,Montale,PT,44,23,42,3,1,69,18,60,5,0,83
2020,47010,Montale,PT,45,25,43,1,0,69,17,61,7,0,85
2020,47010,Montale,PT,46,23,63,2,0,88,18,67,7,1,93
2020,47010,Montale,PT,47,18,50,5,0,73,15,54,9,0,78
2020,47010,Montale,PT,48,17,50,5,0,72,17,64,7,0,88
2020,47010,Montale,PT,49,22,73,6,1,102,17,65,4,0,86
2020,47010,Montale,PT,50,15,69,5,0,89,12,66,5,0,83
2020,47010,Montale,PT,51,21,71,7,0,99,7,76,5,4,92
2020,47010,Montale,PT,52,13,62,5,1,81,11,74,8,1,94
2020,47010,Montale,PT,53,12,58,4,0,74,7,63,6,2,78
2020,47010,Montale,PT,54,11,75,2,0,88,7,66,2,2,77
2020,47010,Montale,PT,55,25,61,6,1,93,7,74,8,1,90
2020,47010,Montale,PT,56,10,68,4,0,82,5,82,3,2,92
2020,47010,Montale,PT,57,10,59,4,0,73,4,77,9,1,91
2020,47010,Montale,PT,58,6,64,2,3,75,5,55,5,5,70
2020,47010,Montale,PT,59,12,66,1,2,81,6,84,4,5,99
2020,47010,Montale,PT,60,7,63,6,6,82,4,73,3,3,83
2020,47010,Montale,PT,61,7,68,3,1,79,1,49,2,5,57
2020,47010,Montale,PT,62,7,54,6,1,68,8,64,2,11,85
2020,47010,Montale,PT,63,3,48,8,3,62,4,66,1,8,79
2020,47010,Montale,PT,64,3,78,3,1,85,2,52,4,5,63
2020,47010,Montale,PT,65,7,61,1,4,73,3,56,7,15,81
2020,47010,Montale,PT,66,5,55,1,1,62,2,66,4,15,87
2020,47010,Montale,PT,67,7,63,3,4,77,1,50,2,12,65
2020,47010,Montale,PT,68,2,46,3,2,53,6,59,2,8,75
2020,47010,Montale,PT,69,2,52,3,6,63,5,64,5,9,83
2020,47010,Montale,PT,70,2,48,0,1,51,4,39,2,19,64
2020,47010,Montale,PT,71,1,62,2,4,69,2,55,3,12,72
2020,47010,Montale,PT,72,3,51,1,5,60,0,65,3,18,86
2020,47010,Montale,PT,73,6,61,1,1,69,2,43,3,22,70
2020,47010,Montale,PT,74,4,51,1,3,59,4,53,3,15,75
2020,47010,Montale,PT,75,2,44,1,6,53,0,36,0,16,52
2020,47010,Montale,PT,76,4,44,1,2,51,2,30,1,17,50
2020,47010,Montale,PT,77,2,42,0,3,47,0,30,0,17,47
2020,47010,Montale,PT,78,1,37,2,3,43,2,27,3,18,50
2020,47010,Montale,PT,79,2,39,0,5,46,0,25,0,25,50
2020,47010,Montale,PT,80,3,30,0,8,41,1,24,1,24,50
2020,47010,Montale,PT,81,2,52,0,10,64,0,24,0,33,57
2020,47010,Montale,PT,82,5,31,0,7,43,0,30,3,27,60
2020,47010,Montale,PT,83,1,26,0,7,34,2,10,1,35,48
2020,47010,Montale,PT,84,2,22,0,5,29,2,12,3,35,52
2020,47010,Montale,PT,85,0,19,0,3,22,1,13,0,35,49
2020,47010,Montale,PT,86,1,13,0,11,25,1,6,0,31,38
2020,47010,Montale,PT,87,0,14,0,6,20,1,2,0,25,28
2020,47010,Montale,PT,88,0,15,0,8,23,0,4,0,30,34
2020,47010,Montale,PT,89,0,15,0,6,21,0,4,0,18,22
2020,47010,Montale,PT,90,0,6,0,7,13,1,2,0,33,36
2020,47010,Montale,PT,91,0,3,0,6,9,1,3,0,24,28
2020,47010,Montale,PT,92,0,0,0,5,5,1,2,0,17,20
2020,47010,Montale,PT,93,0,2,0,2,4,0,0,1,12,13
2020,47010,Montale,PT,94,1,2,0,0,3,0,1,0,7,8
2020,47010,Montale,PT,95,1,1,0,2,4,0,0,0,5,5
2020,47010,Montale,PT,96,0,1,0,2,3,0,1,0,6,7
2020,47010,Montale,PT,97,0,0,0,2,2,0,0,0,6,6
2020,47010,Montale,PT,98,0,0,0,1,1,0,0,0,2,2
2020,47010,Montale,PT,99,0,0,0,1,1,1,0,0,1,2
2020,47010,Montale,PT,100 e più,0,0,0,0,0,1,0,0,4,5
2020,47011,Montecatini-Terme,PT,0,68,0,0,0,68,59,0,0,0,59
2020,47011,Montecatini-Terme,PT,1,69,0,0,0,69,70,0,0,0,70
2020,47011,Montecatini-Terme,PT,2,79,0,0,0,79,75,0,0,0,75
2020,47011,Montecatini-Terme,PT,3,77,0,0,0,77,87,0,0,0,87
2020,47011,Montecatini-Terme,PT,4,75,0,0,0,75,76,0,0,0,76
2020,47011,Montecatini-Terme,PT,5,93,0,0,0,93,65,0,0,0,65
2020,47011,Montecatini-Terme,PT,6,87,0,0,0,87,70,0,0,0,70
2020,47011,Montecatini-Terme,PT,7,63,0,0,0,63,84,0,0,0,84
2020,47011,Montecatini-Terme,PT,8,89,0,0,0,89,68,0,0,0,68
2020,47011,Montecatini-Terme,PT,9,85,0,0,0,85,88,0,0,0,88
2020,47011,Montecatini-Terme,PT,10,84,0,0,0,84,96,0,0,0,96
2020,47011,Montecatini-Terme,PT,11,96,0,0,0,96,80,0,0,0,80
2020,47011,Montecatini-Terme,PT,12,90,0,0,0,90,75,0,0,0,75
2020,47011,Montecatini-Terme,PT,13,82,0,0,0,82,78,0,0,0,78
2020,47011,Montecatini-Terme,PT,14,79,0,0,0,79,71,0,0,0,71
2020,47011,Montecatini-Terme,PT,15,91,0,0,0,91,73,0,0,0,73
2020,47011,Montecatini-Terme,PT,16,77,0,0,0,77,85,0,0,0,85
2020,47011,Montecatini-Terme,PT,17,75,0,0,0,75,79,0,0,0,79
2020,47011,Montecatini-Terme,PT,18,89,0,0,0,89,72,0,0,0,72
2020,47011,Montecatini-Terme,PT,19,81,0,0,0,81,78,0,0,0,78
2020,47011,Montecatini-Terme,PT,20,111,0,0,0,111,108,0,0,0,108
2020,47011,Montecatini-Terme,PT,21,95,1,0,0,96,82,0,0,0,82
2020,47011,Montecatini-Terme,PT,22,109,0,0,0,109,106,2,0,0,108
2020,47011,Montecatini-Terme,PT,23,101,0,0,0,101,76,7,0,0,83
2020,47011,Montecatini-Terme,PT,24,100,0,0,0,100,93,8,0,0,101
2020,47011,Montecatini-Terme,PT,25,90,7,0,0,97,80,10,0,0,91
2020,47011,Montecatini-Terme,PT,26,87,4,1,0,92,88,9,0,0,97
2020,47011,Montecatini-Terme,PT,27,95,10,0,0,105,109,26,2,0,137
2020,47011,Montecatini-Terme,PT,28,84,8,0,0,92,81,34,1,0,117
2020,47011,Montecatini-Terme,PT,29,105,11,0,0,116,80,25,0,0,105
2020,47011,Montecatini-Terme,PT,30,97,18,0,0,115,72,53,0,0,126
2020,47011,Montecatini-Terme,PT,31,77,17,1,0,95,77,40,4,0,121
2020,47011,Montecatini-Terme,PT,32,96,38,2,0,136,64,55,1,0,120
2020,47011,Montecatini-Terme,PT,33,60,37,0,0,97,52,71,8,0,131
2020,47011,Montecatini-Terme,PT,34,74,43,0,0,117,69,65,5,0,139
2020,47011,Montecatini-Terme,PT,35,59,44,1,0,104,59,63,4,0,126
2020,47011,Montecatini-Terme,PT,36,56,40,0,0,97,52,67,6,0,125
2020,47011,Montecatini-Terme,PT,37,74,53,1,0,128,41,67,11,0,119
2020,47011,Montecatini-Terme,PT,38,54,64,7,0,125,40,80,11,0,131
2020,47011,Montecatini-Terme,PT,39,51,69,2,0,123,41,83,9,0,133
2020,47011,Montecatini-Terme,PT,40,45,60,0,0,105,49,93,10,3,155
2020,47011,Montecatini-Terme,PT,41,44,50,2,0,96,45,87,4,3,139
2020,47011,Montecatini-Terme,PT,42,48,72,3,0,123,35,86,14,4,139
2020,47011,Montecatini-Terme,PT,43,54,92,2,0,148,53,85,9,2,149
2020,47011,Montecatini-Terme,PT,44,49,84,5,0,138,45,91,8,1,145
2020,47011,Montecatini-Terme,PT,45,60,75,6,0,141,57,100,10,3,170
2020,47011,Montecatini-Terme,PT,46,57,90,6,0,154,31,99,15,3,148
2020,47011,Montecatini-Terme,PT,47,34,95,10,0,139,32,109,10,3,154
2020,47011,Montecatini-Terme,PT,48,46,88,12,2,148,35,98,18,2,153
2020,47011,Montecatini-Terme,PT,49,49,87,7,1,144,27,129,22,1,179
2020,47011,Montecatini-Terme,PT,50,30,111,9,0,150,33,108,26,2,169
2020,47011,Montecatini-Terme,PT,51,35,103,8,1,147,24,123,19,3,169
2020,47011,Montecatini-Terme,PT,52,33,92,12,0,137,42,119,18,4,183
2020,47011,Montecatini-Terme,PT,53,36,93,12,0,141,26,115,15,3,159
2020,47011,Montecatini-Terme,PT,54,38,107,16,3,164,31,130,20,9,190
2020,47011,Montecatini-Terme,PT,55,29,123,16,1,169,37,97,25,4,163
2020,47011,Montecatini-Terme,PT,56,29,126,13,2,170,24,120,10,5,159
2020,47011,Montecatini-Terme,PT,57,18,110,8,2,138,25,104,29,10,168
2020,47011,Montecatini-Terme,PT,58,25,124,17,2,168,17,93,19,8,137
2020,47011,Montecatini-Terme,PT,59,25,108,13,2,148,17,104,18,6,145
2020,47011,Montecatini-Terme,PT,60,15,107,13,1,136,15,107,12,12,146
2020,47011,Montecatini-Terme,PT,61,21,95,9,4,129,13,113,10,11,147
2020,47011,Montecatini-Terme,PT,62,19,93,20,1,134,18,99,22,17,157
2020,47011,Montecatini-Terme,PT,63,18,95,13,2,128,16,99,13,13,141
2020,47011,Montecatini-Terme,PT,64,10,79,9,2,100,9,106,13,14,142
2020,47011,Montecatini-Terme,PT,65,17,78,12,2,109,15,81,19,18,133
2020,47011,Montecatini-Terme,PT,66,12,84,13,5,114,14,69,19,16,118
2020,47011,Montecatini-Terme,PT,67,13,70,12,6,101,14,84,7,20,125
2020,47011,Montecatini-Terme,PT,68,10,86,8,5,109,9,78,10,20,117
2020,47011,Montecatini-Terme,PT,69,14,81,9,5,109,11,77,11,17,116
2020,47011,Montecatini-Terme,PT,70,4,100,11,4,119,6,84,15,24,129
2020,47011,Montecatini-Terme,PT,71,7,80,6,7,100,20,95,6,22,143
2020,47011,Montecatini-Terme,PT,72,7,97,3,6,113,9,85,12,32,138
2020,47011,Montecatini-Terme,PT,73,4,101,9,10,124,9,76,16,29,130
2020,47011,Montecatini-Terme,PT,74,7,109,5,11,132,12,102,6,27,147
2020,47011,Montecatini-Terme,PT,75,5,75,7,7,94,8,71,4,28,111
2020,47011,Montecatini-Terme,PT,76,4,65,3,9,81,4,74,7,44,129
2020,47011,Montecatini-Terme,PT,77,6,66,2,6,80,11,57,6,34,108
2020,47011,Montecatini-Terme,PT,78,7,55,5,10,78,7,56,8,42,113
2020,47011,Montecatini-Terme,PT,79,8,77,6,7,98,6,63,9,41,119
2020,47011,Montecatini-Terme,PT,80,2,59,4,14,79,11,58,5,56,130
2020,47011,Montecatini-Terme,PT,81,3,67,3,9,82,9,54,8,43,114
2020,47011,Montecatini-Terme,PT,82,3,50,3,12,68,9,31,5,56,101
2020,47011,Montecatini-Terme,PT,83,3,63,3,13,82,10,39,4,61,114
2020,47011,Montecatini-Terme,PT,84,3,44,4,12,63,14,41,6,66,127
2020,47011,Montecatini-Terme,PT,85,2,45,0,15,62,7,35,1,66,109
2020,47011,Montecatini-Terme,PT,86,2,43,1,13,59,8,27,1,61,97
2020,47011,Montecatini-Terme,PT,87,0,24,1,8,33,5,12,2,54,73
2020,47011,Montecatini-Terme,PT,88,3,20,0,8,31,6,5,0,58,69
2020,47011,Montecatini-Terme,PT,89,5,30,0,10,45,5,7,0,48,60
2020,47011,Montecatini-Terme,PT,90,2,14,1,9,26,5,7,0,44,56
2020,47011,Montecatini-Terme,PT,91,1,11,1,6,19,2,5,1,36,44
2020,47011,Montecatini-Terme,PT,92,1,15,0,7,23,7,2,1,37,47
2020,47011,Montecatini-Terme,PT,93,0,8,0,6,14,1,1,0,33,35
2020,47011,Montecatini-Terme,PT,94,0,8,0,7,15,1,6,1,19,27
2020,47011,Montecatini-Terme,PT,95,0,2,0,2,4,3,1,0,26,30
2020,47011,Montecatini-Terme,PT,96,0,5,0,1,6,1,3,1,13,18
2020,47011,Montecatini-Terme,PT,97,0,0,0,1,1,0,0,0,14,14
2020,47011,Montecatini-Terme,PT,98,0,1,0,0,1,0,0,1,11,12
2020,47011,Montecatini-Terme,PT,99,0,0,0,1,1,0,0,0,5,5
2020,47011,Montecatini-Terme,PT,100 e più,0,0,0,0,0,0,0,0,4,4
2020,47012,Pescia,PT,0,59,0,0,0,59,61,0,0,0,61
2020,47012,Pescia,PT,1,68,0,0,0,68,58,0,0,0,58
2020,47012,Pescia,PT,2,84,0,0,0,84,75,0,0,0,75
2020,47012,Pescia,PT,3,66,0,0,0,66,60,0,0,0,60
2020,47012,Pescia,PT,4,77,0,0,0,77,66,0,0,0,66
2020,47012,Pescia,PT,5,70,0,0,0,70,76,0,0,0,76
2020,47012,Pescia,PT,6,76,0,0,0,76,78,0,0,0,78
2020,47012,Pescia,PT,7,73,0,0,0,73,78,0,0,0,78
2020,47012,Pescia,PT,8,82,0,0,0,82,77,0,0,0,77
2020,47012,Pescia,PT,9,101,0,0,0,101,76,0,0,0,76
2020,47012,Pescia,PT,10,88,0,0,0,88,89,0,0,0,89
2020,47012,Pescia,PT,11,97,0,0,0,97,87,0,0,0,87
2020,47012,Pescia,PT,12,92,0,0,0,92,81,0,0,0,81
2020,47012,Pescia,PT,13,89,0,0,0,89,88,0,0,0,88
2020,47012,Pescia,PT,14,89,0,0,0,89,100,0,0,0,100
2020,47012,Pescia,PT,15,80,0,0,0,80,70,0,0,0,70
2020,47012,Pescia,PT,16,81,0,0,0,81,84,0,0,0,84
2020,47012,Pescia,PT,17,86,0,0,0,86,88,0,0,0,88
2020,47012,Pescia,PT,18,90,0,0,0,90,89,0,0,0,89
2020,47012,Pescia,PT,19,88,0,0,0,88,71,0,0,0,71
2020,47012,Pescia,PT,20,95,0,0,0,95,91,1,1,0,93
2020,47012,Pescia,PT,21,91,0,0,0,91,69,3,0,0,72
2020,47012,Pescia,PT,22,96,0,0,0,96,75,3,0,0,78
2020,47012,Pescia,PT,23,87,1,0,0,88,86,3,0,0,89
2020,47012,Pescia,PT,24,88,1,0,0,89,73,5,0,0,78
2020,47012,Pescia,PT,25,99,1,0,0,100,85,12,1,0,98
2020,47012,Pescia,PT,26,78,3,0,0,81,71,15,0,0,86
2020,47012,Pescia,PT,27,100,3,0,0,103,74,12,0,0,86
2020,47012,Pescia,PT,28,83,4,0,0,87,77,22,0,0,99
2020,47012,Pescia,PT,29,85,15,0,0,100,88,20,0,0,108
2020,47012,Pescia,PT,30,87,20,1,0,108,56,34,0,0,90
2020,47012,Pescia,PT,31,86,15,0,0,101,78,42,2,0,122
2020,47012,Pescia,PT,32,87,32,0,0,119,42,45,1,0,88
2020,47012,Pescia,PT,33,66,42,0,0,108,44,45,3,0,92
2020,47012,Pescia,PT,34,54,34,0,0,88,46,65,0,0,111
2020,47012,Pescia,PT,35,81,42,0,0,123,49,53,0,0,102
2020,47012,Pescia,PT,36,63,46,0,0,109,35,48,1,0,84
2020,47012,Pescia,PT,37,47,48,3,0,98,32,60,4,1,97
2020,47012,Pescia,PT,38,62,32,3,0,97,37,57,5,1,100
2020,47012,Pescia,PT,39,53,51,0,0,104,35,73,3,0,111
2020,47012,Pescia,PT,40,40,64,3,0,107,36,74,6,1,117
2020,47012,Pescia,PT,41,55,66,5,0,126,43,80,4,1,128
2020,47012,Pescia,PT,42,56,63,6,0,125,39,65,5,1,110
2020,47012,Pescia,PT,43,65,66,3,0,134,38,97,10,1,146
2020,47012,Pescia,PT,44,62,76,6,0,144,29,98,9,4,140
2020,47012,Pescia,PT,45,53,104,8,0,165,37,104,18,2,161
2020,47012,Pescia,PT,46,58,96,8,1,163,37,95,9,6,147
2020,47012,Pescia,PT,47,48,109,4,0,161,33,108,22,1,164
2020,47012,Pescia,PT,48,50,94,11,2,157,24,91,10,2,127
2020,47012,Pescia,PT,49,37,106,10,1,154,21,110,12,2,145
2020,47012,Pescia,PT,50,51,98,9,4,162,40,128,23,1,192
2020,47012,Pescia,PT,51,47,109,8,2,166,24,134,15,5,178
2020,47012,Pescia,PT,52,36,103,14,1,154,26,103,12,1,142
2020,47012,Pescia,PT,53,39,103,13,2,157,32,113,31,4,180
2020,47012,Pescia,PT,54,30,118,8,1,157,23,121,16,1,161
2020,47012,Pescia,PT,55,20,143,23,1,187,19,101,21,0,141
2020,47012,Pescia,PT,56,33,96,18,1,148,19,120,19,6,164
2020,47012,Pescia,PT,57,22,115,22,3,162,21,127,23,8,179
2020,47012,Pescia,PT,58,22,119,20,3,164,13,103,17,8,141
2020,47012,Pescia,PT,59,12,88,8,1,109,9,114,11,8,142
2020,47012,Pescia,PT,60,13,89,9,2,113,8,121,12,12,153
2020,47012,Pescia,PT,61,20,116,13,0,149,10,100,10,7,127
2020,47012,Pescia,PT,62,16,83,9,4,112,15,105,8,7,135
2020,47012,Pescia,PT,63,9,95,5,2,111,16,93,12,18,139
2020,47012,Pescia,PT,64,6,96,6,5,113,10,86,7,14,117
2020,47012,Pescia,PT,65,11,109,12,4,136,16,90,13,16,135
2020,47012,Pescia,PT,66,14,96,4,2,116,7,83,7,24,121
2020,47012,Pescia,PT,67,6,67,12,7,92,5,98,8,11,122
2020,47012,Pescia,PT,68,11,88,8,3,110,13,71,15,22,121
2020,47012,Pescia,PT,69,9,96,4,5,114,7,90,4,18,119
2020,47012,Pescia,PT,70,9,85,5,7,106,7,70,7,17,101
2020,47012,Pescia,PT,71,9,73,8,6,96,3,85,4,24,116
2020,47012,Pescia,PT,72,7,112,4,3,126,8,89,4,31,132
2020,47012,Pescia,PT,73,6,107,3,4,120,6,82,11,31,130
2020,47012,Pescia,PT,74,8,105,4,4,121,8,89,3,29,129
2020,47012,Pescia,PT,75,8,92,2,7,109,3,56,3,35,97
2020,47012,Pescia,PT,76,4,59,7,8,78,2,54,6,45,107
2020,47012,Pescia,PT,77,3,54,3,10,70,4,50,2,34,90
2020,47012,Pescia,PT,78,5,61,7,6,79,5,53,0,39,97
2020,47012,Pescia,PT,79,7,68,1,11,87,3,54,1,34,92
2020,47012,Pescia,PT,80,4,61,1,13,79,7,45,5,66,123
2020,47012,Pescia,PT,81,7,59,2,15,83,6,41,1,48,96
2020,47012,Pescia,PT,82,3,49,1,12,65,7,38,2,57,104
2020,47012,Pescia,PT,83,3,42,0,10,55,9,23,7,50,89
2020,47012,Pescia,PT,84,6,31,0,14,51,4,29,2,61,96
2020,47012,Pescia,PT,85,8,41,1,7,57,2,16,3,69,90
2020,47012,Pescia,PT,86,6,32,0,7,45,1,13,3,42,59
2020,47012,Pescia,PT,87,4,15,1,9,29,4,7,1,52,64
2020,47012,Pescia,PT,88,2,15,0,15,32,3,3,1,39,46
2020,47012,Pescia,PT,89,2,13,1,7,23,2,7,0,43,52
2020,47012,Pescia,PT,90,1,14,0,7,22,3,4,0,36,43
2020,47012,Pescia,PT,91,1,10,0,7,18,1,3,0,37,41
2020,47012,Pescia,PT,92,1,5,0,5,11,1,6,0,35,42
2020,47012,Pescia,PT,93,1,4,0,6,11,0,0,0,24,24
2020,47012,Pescia,PT,94,1,0,0,0,1,1,1,0,21,23
2020,47012,Pescia,PT,95,1,1,0,4,6,1,0,0,22,23
2020,47012,Pescia,PT,96,0,1,0,3,4,2,2,0,13,17
2020,47012,Pescia,PT,97,0,0,0,0,0,1,0,0,4,5
2020,47012,Pescia,PT,98,0,0,0,0,0,0,0,0,7,7
2020,47012,Pescia,PT,99,0,1,0,0,1,0,0,0,6,6
2020,47012,Pescia,PT,100 e più,0,0,0,1,1,1,0,0,3,4
2020,47013,Pieve a Nievole,PT,0,31,0,0,0,31,23,0,0,0,23
2020,47013,Pieve a Nievole,PT,1,20,0,0,0,20,31,0,0,0,31
2020,47013,Pieve a Nievole,PT,2,28,0,0,0,28,29,0,0,0,29
2020,47013,Pieve a Nievole,PT,3,20,0,0,0,20,35,0,0,0,35
2020,47013,Pieve a Nievole,PT,4,39,0,0,0,39,33,0,0,0,33
2020,47013,Pieve a Nievole,PT,5,32,0,0,0,32,37,0,0,0,37
2020,47013,Pieve a Nievole,PT,6,34,0,0,0,34,21,0,0,0,21
2020,47013,Pieve a Nievole,PT,7,41,0,0,0,41,26,0,0,0,26
2020,47013,Pieve a Nievole,PT,8,37,0,0,0,37,33,0,0,0,33
2020,47013,Pieve a Nievole,PT,9,30,0,0,0,30,38,0,0,0,38
2020,47013,Pieve a Nievole,PT,10,36,0,0,0,36,30,0,0,0,30
2020,47013,Pieve a Nievole,PT,11,37,0,0,0,37,37,0,0,0,37
2020,47013,Pieve a Nievole,PT,12,48,0,0,0,48,46,0,0,0,46
2020,47013,Pieve a Nievole,PT,13,52,0,0,0,52,39,0,0,0,39
2020,47013,Pieve a Nievole,PT,14,48,0,0,0,48,38,0,0,0,38
2020,47013,Pieve a Nievole,PT,15,43,0,0,0,43,44,0,0,0,44
2020,47013,Pieve a Nievole,PT,16,39,0,0,0,39,54,0,0,0,54
2020,47013,Pieve a Nievole,PT,17,40,0,0,0,40,38,0,0,0,38
2020,47013,Pieve a Nievole,PT,18,54,0,0,0,54,44,0,0,0,44
2020,47013,Pieve a Nievole,PT,19,39,0,0,0,39,49,0,0,0,49
2020,47013,Pieve a Nievole,PT,20,54,0,0,0,54,40,1,0,0,41
2020,47013,Pieve a Nievole,PT,21,40,0,0,0,40,40,1,0,0,41
2020,47013,Pieve a Nievole,PT,22,44,0,0,0,44,42,0,0,0,42
2020,47013,Pieve a Nievole,PT,23,45,0,0,0,45,51,2,0,0,53
2020,47013,Pieve a Nievole,PT,24,40,1,0,0,41,44,1,0,0,45
2020,47013,Pieve a Nievole,PT,25,42,0,0,0,42,31,2,0,0,33
2020,47013,Pieve a Nievole,PT,26,43,1,0,0,44,40,4,0,0,44
2020,47013,Pieve a Nievole,PT,27,42,1,0,0,43,31,8,0,0,39
2020,47013,Pieve a Nievole,PT,28,44,3,0,0,47,27,14,0,0,41
2020,47013,Pieve a Nievole,PT,29,34,5,0,0,39,41,13,0,0,54
2020,47013,Pieve a Nievole,PT,30,41,5,0,0,46,33,7,1,0,41
2020,47013,Pieve a Nievole,PT,31,37,9,0,0,46,22,7,0,0,29
2020,47013,Pieve a Nievole,PT,32,41,10,1,0,52,27,10,1,0,38
2020,47013,Pieve a Nievole,PT,33,38,8,0,0,46,27,18,2,0,47
2020,47013,Pieve a Nievole,PT,34,36,14,1,0,51,25,30,0,0,55
2020,47013,Pieve a Nievole,PT,35,32,13,1,0,46,22,19,0,0,41
2020,47013,Pieve a Nievole,PT,36,35,26,1,0,62,15,21,0,1,37
2020,47013,Pieve a Nievole,PT,37,33,24,1,1,59,23,25,1,1,50
2020,47013,Pieve a Nievole,PT,38,40,25,0,0,65,15,40,0,0,55
2020,47013,Pieve a Nievole,PT,39,21,19,1,0,41,23,20,2,1,46
2020,47013,Pieve a Nievole,PT,40,20,23,1,0,44,23,38,4,0,65
2020,47013,Pieve a Nievole,PT,41,28,36,4,0,68,20,36,2,1,59
2020,47013,Pieve a Nievole,PT,42,24,31,0,0,55,18,38,4,0,60
2020,47013,Pieve a Nievole,PT,43,19,37,2,0,58,29,38,4,2,73
2020,47013,Pieve a Nievole,PT,44,39,31,3,0,73,25,44,1,0,70
2020,47013,Pieve a Nievole,PT,45,29,49,4,0,82,20,59,6,0,85
2020,47013,Pieve a Nievole,PT,46,20,48,4,0,72,21,45,5,1,72
2020,47013,Pieve a Nievole,PT,47,18,35,2,0,55,16,51,5,0,72
2020,47013,Pieve a Nievole,PT,48,15,46,6,0,67,18,52,10,3,83
2020,47013,Pieve a Nievole,PT,49,20,57,9,1,87,13,53,10,3,79
2020,47013,Pieve a Nievole,PT,50,17,63,7,0,87,10,69,7,2,88
2020,47013,Pieve a Nievole,PT,51,16,50,4,3,73,6,56,6,2,70
2020,47013,Pieve a Nievole,PT,52,17,46,10,1,74,10,57,6,1,74
2020,47013,Pieve a Nievole,PT,53,11,54,5,0,70,15,61,5,1,82
2020,47013,Pieve a Nievole,PT,54,19,53,4,1,77,14,57,6,2,79
2020,47013,Pieve a Nievole,PT,55,10,64,5,1,80,16,53,3,3,75
2020,47013,Pieve a Nievole,PT,56,11,68,5,1,85,11,75,6,3,95
2020,47013,Pieve a Nievole,PT,57,10,61,5,0,76,5,48,4,2,59
2020,47013,Pieve a Nievole,PT,58,16,42,2,3,63,6,60,6,10,82
2020,47013,Pieve a Nievole,PT,59,8,59,6,1,74,5,63,6,5,79
2020,47013,Pieve a Nievole,PT,60,3,47,9,2,61,2,48,10,5,65
2020,47013,Pieve a Nievole,PT,61,7,51,5,2,65,8,49,5,8,70
2020,47013,Pieve a Nievole,PT,62,1,54,1,2,58,3,46,10,4,63
2020,47013,Pieve a Nievole,PT,63,4,40,8,1,53,7,43,2,8,60
2020,47013,Pieve a Nievole,PT,64,4,42,5,1,52,4,41,1,8,54
2020,47013,Pieve a Nievole,PT,65,2,46,3,2,53,7,39,6,9,61
2020,47013,Pieve a Nievole,PT,66,2,43,1,1,47,4,49,3,2,58
2020,47013,Pieve a Nievole,PT,67,3,43,3,0,49,3,34,5,10,52
2020,47013,Pieve a Nievole,PT,68,0,41,3,5,49,1,46,8,7,62
2020,47013,Pieve a Nievole,PT,69,4,45,3,2,54,1,27,3,9,40
2020,47013,Pieve a Nievole,PT,70,3,39,2,1,45,4,44,3,8,59
2020,47013,Pieve a Nievole,PT,71,1,52,2,3,58,0,40,3,14,57
2020,47013,Pieve a Nievole,PT,72,0,52,3,3,58,2,53,3,9,67
2020,47013,Pieve a Nievole,PT,73,1,54,2,5,62,3,48,3,8,62
2020,47013,Pieve a Nievole,PT,74,3,45,5,5,58,2,42,2,19,65
2020,47013,Pieve a Nievole,PT,75,1,47,2,7,57,1,29,1,14,45
2020,47013,Pieve a Nievole,PT,76,3,20,0,5,28,2,21,4,19,46
2020,47013,Pieve a Nievole,PT,77,2,43,2,2,49,3,32,3,15,53
2020,47013,Pieve a Nievole,PT,78,2,24,3,0,29,3,23,2,17,45
2020,47013,Pieve a Nievole,PT,79,1,34,2,1,38,1,28,1,23,53
2020,47013,Pieve a Nievole,PT,80,1,26,1,2,30,2,25,0,28,55
2020,47013,Pieve a Nievole,PT,81,3,24,1,1,29,0,20,0,22,42
2020,47013,Pieve a Nievole,PT,82,1,31,1,6,39,2,21,2,22,47
2020,47013,Pieve a Nievole,PT,83,3,35,0,8,46,4,18,2,30,54
2020,47013,Pieve a Nievole,PT,84,1,14,0,8,23,4,14,1,14,33
2020,47013,Pieve a Nievole,PT,85,0,25,0,6,31,3,12,2,31,48
2020,47013,Pieve a Nievole,PT,86,2,15,1,6,24,3,6,0,22,31
2020,47013,Pieve a Nievole,PT,87,0,16,0,1,17,1,9,1,14,25
2020,47013,Pieve a Nievole,PT,88,2,9,0,2,13,1,8,0,17,26
2020,47013,Pieve a Nievole,PT,89,1,10,0,7,18,1,2,0,20,23
2020,47013,Pieve a Nievole,PT,90,0,7,0,4,11,1,5,0,16,22
2020,47013,Pieve a Nievole,PT,91,1,4,0,5,10,0,2,0,14,16
2020,47013,Pieve a Nievole,PT,92,0,4,0,2,6,2,0,0,14,16
2020,47013,Pieve a Nievole,PT,93,0,2,0,3,5,0,0,0,9,9
2020,47013,Pieve a Nievole,PT,94,0,1,0,0,1,0,0,0,6,6
2020,47013,Pieve a Nievole,PT,95,0,0,0,2,2,1,1,0,8,10
2020,47013,Pieve a Nievole,PT,96,1,1,0,1,3,0,0,0,2,2
2020,47013,Pieve a Nievole,PT,97,0,0,0,1,1,1,0,0,4,5
2020,47013,Pieve a Nievole,PT,98,0,2,0,1,3,0,0,0,0,0
2020,47013,Pieve a Nievole,PT,99,0,0,0,0,0,0,0,0,1,1
2020,47013,Pieve a Nievole,PT,100 e più,0,0,0,1,1,1,0,0,3,4
2020,47014,Pistoia,PT,0,282,0,0,0,282,260,0,0,0,260
2020,47014,Pistoia,PT,1,300,0,0,0,300,247,0,0,0,247
2020,47014,Pistoia,PT,2,344,0,0,0,344,301,0,0,0,301
2020,47014,Pistoia,PT,3,353,0,0,0,353,330,0,0,0,330
2020,47014,Pistoia,PT,4,329,0,0,0,329,297,0,0,0,297
2020,47014,Pistoia,PT,5,358,0,0,0,358,332,0,0,0,332
2020,47014,Pistoia,PT,6,338,0,0,0,338,349,0,0,0,349
2020,47014,Pistoia,PT,7,374,0,0,0,374,343,0,0,0,343
2020,47014,Pistoia,PT,8,412,0,0,0,412,351,0,0,0,351
2020,47014,Pistoia,PT,9,393,0,0,0,393,368,0,0,0,368
2020,47014,Pistoia,PT,10,403,0,0,0,403,380,0,0,0,380
2020,47014,Pistoia,PT,11,425,0,0,0,425,382,0,0,0,382
2020,47014,Pistoia,PT,12,416,0,0,0,416,358,0,0,0,358
2020,47014,Pistoia,PT,13,412,0,0,0,412,376,0,0,0,376
2020,47014,Pistoia,PT,14,419,0,0,0,419,402,0,0,0,402
2020,47014,Pistoia,PT,15,433,0,0,0,433,415,0,0,0,415
2020,47014,Pistoia,PT,16,407,0,0,0,407,398,1,0,0,399
2020,47014,Pistoia,PT,17,404,0,0,0,404,366,0,0,0,366
2020,47014,Pistoia,PT,18,436,0,0,0,436,349,0,0,0,349
2020,47014,Pistoia,PT,19,425,0,0,0,425,403,2,0,0,405
2020,47014,Pistoia,PT,20,400,0,0,0,400,391,6,0,0,397
2020,47014,Pistoia,PT,21,448,0,0,0,448,344,9,0,0,353
2020,47014,Pistoia,PT,22,453,0,0,0,453,367,14,0,0,381
2020,47014,Pistoia,PT,23,412,3,0,0,415,360,21,0,0,381
2020,47014,Pistoia,PT,24,436,5,0,0,441,372,33,0,0,405
2020,47014,Pistoia,PT,25,380,2,0,0,382,311,42,1,0,354
2020,47014,Pistoia,PT,26,369,13,0,0,382,314,42,1,0,357
2020,47014,Pistoia,PT,27,350,23,0,0,373,345,50,6,0,401
2020,47014,Pistoia,PT,28,365,39,3,0,407,331,88,5,0,425
2020,47014,Pistoia,PT,29,390,41,0,0,431,273,113,3,0,389
2020,47014,Pistoia,PT,30,389,73,0,0,462,305,107,2,0,414
2020,47014,Pistoia,PT,31,344,89,4,0,437,276,141,0,0,417
2020,47014,Pistoia,PT,32,322,105,1,0,428,267,167,8,2,444
2020,47014,Pistoia,PT,33,326,140,3,0,470,270,206,4,1,482
2020,47014,Pistoia,PT,34,280,144,6,1,431,239,233,10,0,482
2020,47014,Pistoia,PT,35,300,183,3,0,486,232,233,10,1,479
2020,47014,Pistoia,PT,36,278,176,10,0,464,220,233,9,2,464
2020,47014,Pistoia,PT,37,266,214,10,0,490,216,260,10,1,488
2020,47014,Pistoia,PT,38,248,228,7,1,485,200,269,11,2,482
2020,47014,Pistoia,PT,39,232,253,16,0,501,180,296,20,2,500
2020,47014,Pistoia,PT,40,230,273,14,0,517,178,326,19,3,527
2020,47014,Pistoia,PT,41,249,294,15,2,561,178,314,32,0,525
2020,47014,Pistoia,PT,42,248,316,12,1,578,180,391,31,6,609
2020,47014,Pistoia,PT,43,241,338,19,1,600,192,389,37,7,625
2020,47014,Pistoia,PT,44,260,336,26,0,624,210,417,33,2,662
2020,47014,Pistoia,PT,45,243,370,32,2,647,211,416,46,4,678
2020,47014,Pistoia,PT,46,247,431,34,0,713,172,490,48,9,721
2020,47014,Pistoia,PT,47,243,445,44,1,734,183,472,64,11,730
2020,47014,Pistoia,PT,48,240,430,41,4,715,162,500,66,11,740
2020,47014,Pistoia,PT,49,207,441,48,2,698,152,527,73,8,761
2020,47014,Pistoia,PT,50,196,470,36,3,705,137,485,83,12,717
2020,47014,Pistoia,PT,51,175,475,45,7,702,120,545,64,13,742
2020,47014,Pistoia,PT,52,188,459,54,4,705,140,540,71,22,773
2020,47014,Pistoia,PT,53,145,455,38,6,646,131,521,73,18,744
2020,47014,Pistoia,PT,54,151,504,47,5,708,103,506,87,23,722
2020,47014,Pistoia,PT,55,150,513,52,6,721,101,577,74,20,774
2020,47014,Pistoia,PT,56,140,527,66,5,738,99,590,87,26,802
2020,47014,Pistoia,PT,57,103,525,46,2,679,99,543,69,38,750
2020,47014,Pistoia,PT,58,88,501,63,9,663,72,517,82,37,708
2020,47014,Pistoia,PT,59,91,522,48,9,670,63,507,88,46,704
2020,47014,Pistoia,PT,60,64,496,60,11,631,49,516,66,41,672
2020,47014,Pistoia,PT,61,72,484,50,3,609,65,466,75,33,639
2020,47014,Pistoia,PT,62,73,455,40,6,574,49,495,58,55,657
2020,47014,Pistoia,PT,63,57,439,42,12,551,46,464,52,58,620
2020,47014,Pistoia,PT,64,51,459,45,16,571,49,409,48,57,563
2020,47014,Pistoia,PT,65,49,418,36,15,518,33,426,45,57,561
2020,47014,Pistoia,PT,66,47,414,34,24,519,51,408,45,60,564
2020,47014,Pistoia,PT,67,49,391,26,19,485,44,394,47,76,561
2020,47014,Pistoia,PT,68,36,389,27,23,475,33,412,58,72,575
2020,47014,Pistoia,PT,69,41,421,31,23,516,42,409,44,89,585
2020,47014,Pistoia,PT,70,34,423,42,21,520,30,388,35,108,562
2020,47014,Pistoia,PT,71,34,416,27,23,501,35,392,35,105,568
2020,47014,Pistoia,PT,72,39,452,31,25,547,35,451,39,149,674
2020,47014,Pistoia,PT,73,38,488,31,39,596,28,407,36,153,624
2020,47014,Pistoia,PT,74,36,460,16,50,562,37,431,32,187,687
2020,47014,Pistoia,PT,75,21,347,14,35,418,29,289,27,158,503
2020,47014,Pistoia,PT,76,27,342,17,27,413,27,315,24,185,551
2020,47014,Pistoia,PT,77,30,341,8,37,417,22,292,22,190,526
2020,47014,Pistoia,PT,78,28,306,10,40,384,19,255,19,211,504
2020,47014,Pistoia,PT,79,15,260,4,49,328,21,256,18,215,510
2020,47014,Pistoia,PT,80,24,290,9,52,375,24,255,26,221,526
2020,47014,Pistoia,PT,81,23,306,11,62,402,16,222,16,275,529
2020,47014,Pistoia,PT,82,20,288,9,47,364,19,209,6,271,505
2020,47014,Pistoia,PT,83,20,246,8,66,340,20,160,10,284,474
2020,47014,Pistoia,PT,84,14,200,1,64,279,21,127,7,278,433
2020,47014,Pistoia,PT,85,13,184,3,47,247,26,112,5,243,386
2020,47014,Pistoia,PT,86,4,178,2,54,238,24,73,4,264,365
2020,47014,Pistoia,PT,87,9,134,1,45,189,17,58,2,267,344
2020,47014,Pistoia,PT,88,15,119,1,43,178,16,45,7,229,297
2020,47014,Pistoia,PT,89,11,94,2,44,151,15,40,2,189,246
2020,47014,Pistoia,PT,90,10,66,2,39,117,16,22,7,199,244
2020,47014,Pistoia,PT,91,5,55,1,37,98,8,24,5,197,234
2020,47014,Pistoia,PT,92,3,39,0,23,65,13,16,3,175,207
2020,47014,Pistoia,PT,93,0,26,0,23,49,5,6,3,130,144
2020,47014,Pistoia,PT,94,2,23,0,20,45,14,6,1,87,108
2020,47014,Pistoia,PT,95,1,12,0,12,25,7,4,4,96,111
2020,47014,Pistoia,PT,96,0,6,0,8,14,2,4,1,67,74
2020,47014,Pistoia,PT,97,1,4,0,13,18,4,2,0,38,44
2020,47014,Pistoia,PT,98,0,5,0,4,9,2,0,0,41,43
2020,47014,Pistoia,PT,99,1,0,0,3,4,3,0,0,32,35
2020,47014,Pistoia,PT,100 e più,0,0,0,2,2,3,0,1,34,38
2020,47016,Ponte Buggianese,PT,0,29,0,0,0,29,19,0,0,0,19
2020,47016,Ponte Buggianese,PT,1,25,0,0,0,25,27,0,0,0,27
2020,47016,Ponte Buggianese,PT,2,48,0,0,0,48,41,0,0,0,41
2020,47016,Ponte Buggianese,PT,3,33,0,0,0,33,29,0,0,0,29
2020,47016,Ponte Buggianese,PT,4,38,0,0,0,38,23,0,0,0,23
2020,47016,Ponte Buggianese,PT,5,35,0,0,0,35,27,0,0,0,27
2020,47016,Ponte Buggianese,PT,6,29,0,0,0,29,34,0,0,0,34
2020,47016,Ponte Buggianese,PT,7,50,0,0,0,50,40,0,0,0,40
2020,47016,Ponte Buggianese,PT,8,33,0,0,0,33,33,0,0,0,33
2020,47016,Ponte Buggianese,PT,9,45,0,0,0,45,38,0,0,0,38
2020,47016,Ponte Buggianese,PT,10,39,0,0,0,39,40,0,0,0,40
2020,47016,Ponte Buggianese,PT,11,53,0,0,0,53,46,0,0,0,46
2020,47016,Ponte Buggianese,PT,12,52,0,0,0,52,40,0,0,0,40
2020,47016,Ponte Buggianese,PT,13,48,0,0,0,48,39,0,0,0,39
2020,47016,Ponte Buggianese,PT,14,42,0,0,0,42,50,0,0,0,50
2020,47016,Ponte Buggianese,PT,15,40,0,0,0,40,53,0,0,0,53
2020,47016,Ponte Buggianese,PT,16,37,0,0,0,37,37,0,0,0,37
2020,47016,Ponte Buggianese,PT,17,53,0,0,0,53,43,0,0,0,43
2020,47016,Ponte Buggianese,PT,18,46,0,0,0,46,41,0,0,0,41
2020,47016,Ponte Buggianese,PT,19,41,0,0,0,41,35,0,0,0,35
2020,47016,Ponte Buggianese,PT,20,45,0,0,0,45,44,0,0,0,44
2020,47016,Ponte Buggianese,PT,21,43,0,0,0,43,30,0,0,0,30
2020,47016,Ponte Buggianese,PT,22,48,0,0,0,48,31,2,0,0,33
2020,47016,Ponte Buggianese,PT,23,48,1,0,0,49,29,5,0,0,34
2020,47016,Ponte Buggianese,PT,24,32,0,0,0,32,25,3,0,0,28
2020,47016,Ponte Buggianese,PT,25,43,1,0,0,44,34,8,0,0,42
2020,47016,Ponte Buggianese,PT,26,43,1,0,0,44,27,3,0,0,30
2020,47016,Ponte Buggianese,PT,27,33,3,0,0,36,26,5,0,0,31
2020,47016,Ponte Buggianese,PT,28,40,5,1,0,46,33,13,0,0,46
2020,47016,Ponte Buggianese,PT,29,32,5,0,0,37,35,12,0,0,47
2020,47016,Ponte Buggianese,PT,30,34,10,0,0,44,36,18,0,0,54
2020,47016,Ponte Buggianese,PT,31,35,10,0,0,45,29,18,0,0,47
2020,47016,Ponte Buggianese,PT,32,39,6,0,0,45,34,18,1,0,53
2020,47016,Ponte Buggianese,PT,33,30,9,0,0,39,29,12,1,1,43
2020,47016,Ponte Buggianese,PT,34,24,18,1,0,43,28,19,0,0,47
2020,47016,Ponte Buggianese,PT,35,31,13,1,0,45,21,26,0,0,47
2020,47016,Ponte Buggianese,PT,36,25,23,0,0,48,11,22,1,0,34
2020,47016,Ponte Buggianese,PT,37,27,19,0,0,46,19,31,0,0,50
2020,47016,Ponte Buggianese,PT,38,24,19,1,0,44,18,26,0,0,44
2020,47016,Ponte Buggianese,PT,39,22,32,2,0,56,14,39,1,0,54
2020,47016,Ponte Buggianese,PT,40,22,29,1,0,52,17,40,5,0,62
2020,47016,Ponte Buggianese,PT,41,27,31,0,0,58,21,42,2,1,66
2020,47016,Ponte Buggianese,PT,42,28,39,0,0,67,20,38,6,0,64
2020,47016,Ponte Buggianese,PT,43,16,43,3,0,62,19,58,2,1,80
2020,47016,Ponte Buggianese,PT,44,22,47,2,0,71,23,42,2,1,68
2020,47016,Ponte Buggianese,PT,45,25,39,4,0,68,20,53,10,0,83
2020,47016,Ponte Buggianese,PT,46,20,45,7,0,72,28,57,7,0,92
2020,47016,Ponte Buggianese,PT,47,20,59,5,0,84,10,56,7,0,73
2020,47016,Ponte Buggianese,PT,48,23,50,6,0,79,13,48,7,1,69
2020,47016,Ponte Buggianese,PT,49,19,51,5,1,76,15,58,10,2,85
2020,47016,Ponte Buggianese,PT,50,11,46,3,1,61,14,42,4,1,61
2020,47016,Ponte Buggianese,PT,51,15,56,3,0,74,13,60,8,0,81
2020,47016,Ponte Buggianese,PT,52,8,46,5,1,60,17,56,12,3,88
2020,47016,Ponte Buggianese,PT,53,18,58,5,0,81,10,46,2,0,58
2020,47016,Ponte Buggianese,PT,54,11,64,5,0,80,7,53,8,1,69
2020,47016,Ponte Buggianese,PT,55,9,50,7,2,68,14,52,8,2,76
2020,47016,Ponte Buggianese,PT,56,17,50,4,3,74,9,52,7,0,68
2020,47016,Ponte Buggianese,PT,57,14,51,5,1,71,6,43,4,3,56
2020,47016,Ponte Buggianese,PT,58,10,52,4,0,66,6,50,3,3,62
2020,47016,Ponte Buggianese,PT,59,7,54,3,1,65,4,55,5,5,69
2020,47016,Ponte Buggianese,PT,60,7,45,5,1,58,7,49,5,4,65
2020,47016,Ponte Buggianese,PT,61,6,39,4,2,51,4,40,4,8,56
2020,47016,Ponte Buggianese,PT,62,4,56,1,1,62,4,48,3,2,57
2020,47016,Ponte Buggianese,PT,63,8,49,3,0,60,1,51,7,5,64
2020,47016,Ponte Buggianese,PT,64,10,34,1,1,46,3,43,8,5,59
2020,47016,Ponte Buggianese,PT,65,4,39,1,0,44,4,40,10,5,59
2020,47016,Ponte Buggianese,PT,66,5,53,3,2,63,1,35,4,2,42
2020,47016,Ponte Buggianese,PT,67,3,42,1,4,50,7,35,2,11,55
2020,47016,Ponte Buggianese,PT,68,9,42,2,5,58,2,30,7,2,41
2020,47016,Ponte Buggianese,PT,69,4,49,3,0,56,0,41,1,14,56
2020,47016,Ponte Buggianese,PT,70,2,48,4,2,56,5,32,2,14,53
2020,47016,Ponte Buggianese,PT,71,3,35,0,2,40,3,33,1,4,41
2020,47016,Ponte Buggianese,PT,72,4,34,0,7,45,5,41,3,6,55
2020,47016,Ponte Buggianese,PT,73,5,36,1,0,42,4,36,5,16,61
2020,47016,Ponte Buggianese,PT,74,4,31,0,4,39,8,44,1,12,65
2020,47016,Ponte Buggianese,PT,75,5,41,1,2,49,3,26,1,14,44
2020,47016,Ponte Buggianese,PT,76,2,35,1,1,39,5,26,0,11,42
2020,47016,Ponte Buggianese,PT,77,3,25,0,1,29,5,20,3,19,47
2020,47016,Ponte Buggianese,PT,78,3,22,0,4,29,4,17,1,12,34
2020,47016,Ponte Buggianese,PT,79,3,21,1,6,31,1,20,1,18,40
2020,47016,Ponte Buggianese,PT,80,1,32,0,3,36,3,24,1,28,56
2020,47016,Ponte Buggianese,PT,81,2,17,0,5,24,0,13,1,29,43
2020,47016,Ponte Buggianese,PT,82,1,22,0,2,25,0,14,1,18,33
2020,47016,Ponte Buggianese,PT,83,0,18,1,1,20,2,14,0,28,44
2020,47016,Ponte Buggianese,PT,84,2,19,0,5,26,1,5,1,23,30
2020,47016,Ponte Buggianese,PT,85,1,9,0,5,15,1,10,1,24,36
2020,47016,Ponte Buggianese,PT,86,2,16,1,6,25,0,11,0,17,28
2020,47016,Ponte Buggianese,PT,87,0,11,0,2,13,1,4,0,17,22
2020,47016,Ponte Buggianese,PT,88,0,13,0,3,16,5,9,0,25,39
2020,47016,Ponte Buggianese,PT,89,2,12,0,3,17,1,2,0,22,25
2020,47016,Ponte Buggianese,PT,90,1,5,0,0,6,1,4,2,17,24
2020,47016,Ponte Buggianese,PT,91,1,5,0,0,6,1,2,0,19,22
2020,47016,Ponte Buggianese,PT,92,2,5,0,2,9,1,0,0,17,18
2020,47016,Ponte Buggianese,PT,93,0,4,0,1,5,0,1,0,9,10
2020,47016,Ponte Buggianese,PT,94,0,0,0,2,2,0,1,0,10,11
2020,47016,Ponte Buggianese,PT,95,0,1,0,3,4,0,0,0,5,5
2020,47016,Ponte Buggianese,PT,96,1,2,0,0,3,1,0,0,7,8
2020,47016,Ponte Buggianese,PT,97,0,1,0,1,2,0,0,0,2,2
2020,47016,Ponte Buggianese,PT,98,0,0,0,0,0,0,0,0,4,4
2020,47016,Ponte Buggianese,PT,99,0,0,0,0,0,0,0,0,2,2
2020,47016,Ponte Buggianese,PT,100 e più,0,0,0,0,0,0,0,0,6,6
2020,47017,Quarrata,PT,0,86,0,0,0,86,91,0,0,0,91
2020,47017,Quarrata,PT,1,99,0,0,0,99,101,0,0,0,101
2020,47017,Quarrata,PT,2,102,0,0,0,102,113,0,0,0,113
2020,47017,Quarrata,PT,3,134,0,0,0,134,111,0,0,0,111
2020,47017,Quarrata,PT,4,114,0,0,0,114,114,0,0,0,114
2020,47017,Quarrata,PT,5,135,0,0,0,135,109,0,0,0,109
2020,47017,Quarrata,PT,6,139,0,0,0,139,138,0,0,0,138
2020,47017,Quarrata,PT,7,131,0,0,0,131,107,0,0,0,107
2020,47017,Quarrata,PT,8,146,0,0,0,146,138,0,0,0,138
2020,47017,Quarrata,PT,9,145,0,0,0,145,126,0,0,0,126
2020,47017,Quarrata,PT,10,147,0,0,0,147,143,0,0,0,143
2020,47017,Quarrata,PT,11,145,0,0,0,145,136,0,0,0,136
2020,47017,Quarrata,PT,12,157,0,0,0,157,138,0,0,0,138
2020,47017,Quarrata,PT,13,146,0,0,0,146,127,0,0,0,127
2020,47017,Quarrata,PT,14,141,0,0,0,141,143,0,0,0,143
2020,47017,Quarrata,PT,15,151,0,0,0,151,139,0,0,0,139
2020,47017,Quarrata,PT,16,142,0,0,0,142,125,0,0,0,125
2020,47017,Quarrata,PT,17,123,0,0,0,123,106,0,0,0,106
2020,47017,Quarrata,PT,18,143,0,0,0,143,120,0,0,0,120
2020,47017,Quarrata,PT,19,126,0,0,0,126,132,1,0,0,133
2020,47017,Quarrata,PT,20,125,0,0,0,125,126,5,0,0,131
2020,47017,Quarrata,PT,21,132,0,0,0,132,117,2,0,0,119
2020,47017,Quarrata,PT,22,104,0,0,0,104,109,4,0,0,113
2020,47017,Quarrata,PT,23,110,2,0,0,112,114,6,0,0,120
2020,47017,Quarrata,PT,24,117,0,0,0,117,95,16,0,0,111
2020,47017,Quarrata,PT,25,112,1,0,0,113,107,14,0,0,121
2020,47017,Quarrata,PT,26,113,9,0,0,122,106,12,1,0,119
2020,47017,Quarrata,PT,27,129,3,0,0,132,76,23,0,0,100
2020,47017,Quarrata,PT,28,112,13,0,0,125,102,26,0,0,128
2020,47017,Quarrata,PT,29,103,17,1,0,121,82,38,0,1,121
2020,47017,Quarrata,PT,30,100,19,0,0,119,85,48,0,1,134
2020,47017,Quarrata,PT,31,107,33,1,0,141,86,57,1,1,145
2020,47017,Quarrata,PT,32,114,26,0,0,140,79,58,4,0,141
2020,47017,Quarrata,PT,33,92,38,2,0,132,70,84,0,0,154
2020,47017,Quarrata,PT,34,96,49,1,0,146,89,83,4,0,176
2020,47017,Quarrata,PT,35,94,56,1,0,151,73,84,2,0,159
2020,47017,Quarrata,PT,36,103,73,2,0,178,75,72,3,0,150
2020,47017,Quarrata,PT,37,93,90,3,0,186,75,89,3,0,167
2020,47017,Quarrata,PT,38,88,75,7,1,172,73,105,3,0,181
2020,47017,Quarrata,PT,39,83,94,3,0,180,74,99,2,0,175
2020,47017,Quarrata,PT,40,71,92,12,0,175,63,131,4,1,200
2020,47017,Quarrata,PT,41,85,100,2,0,187,80,139,4,1,224
2020,47017,Quarrata,PT,42,87,123,7,0,217,54,140,10,1,205
2020,47017,Quarrata,PT,43,70,150,3,0,224,62,134,14,2,212
2020,47017,Quarrata,PT,44,82,96,7,0,185,55,140,11,3,209
2020,47017,Quarrata,PT,45,62,141,6,0,209,65,161,10,1,237
2020,47017,Quarrata,PT,46,64,148,3,0,216,56,153,17,3,229
2020,47017,Quarrata,PT,47,86,147,8,2,244,51,155,18,2,227
2020,47017,Quarrata,PT,48,69,148,5,0,222,54,147,8,4,213
2020,47017,Quarrata,PT,49,67,172,11,0,250,51,171,12,3,237
2020,47017,Quarrata,PT,50,59,150,12,3,224,55,166,15,4,240
2020,47017,Quarrata,PT,51,51,184,16,0,251,61,153,14,7,235
2020,47017,Quarrata,PT,52,53,164,11,0,228,40,145,21,4,210
2020,47017,Quarrata,PT,53,53,164,11,1,229,36,163,13,1,213
2020,47017,Quarrata,PT,54,40,133,16,0,189,33,162,15,4,214
2020,47017,Quarrata,PT,55,37,159,16,3,215,20,153,19,5,197
2020,47017,Quarrata,PT,56,35,151,19,6,211,25,161,23,11,220
2020,47017,Quarrata,PT,57,23,168,13,2,206,25,146,14,3,188
2020,47017,Quarrata,PT,58,25,133,13,3,174,23,147,14,10,194
2020,47017,Quarrata,PT,59,22,154,8,1,185,17,153,18,12,200
2020,47017,Quarrata,PT,60,8,135,16,0,159,21,158,8,16,203
2020,47017,Quarrata,PT,61,18,153,9,3,183,22,162,8,12,204
2020,47017,Quarrata,PT,62,15,124,11,2,152,17,123,14,13,167
2020,47017,Quarrata,PT,63,14,138,9,4,165,17,129,10,10,166
2020,47017,Quarrata,PT,64,15,123,9,4,151,7,125,19,21,172
2020,47017,Quarrata,PT,65,11,155,9,3,178,18,116,7,16,157
2020,47017,Quarrata,PT,66,14,126,6,5,151,15,117,6,14,152
2020,47017,Quarrata,PT,67,7,110,2,3,122,10,98,8,22,138
2020,47017,Quarrata,PT,68,9,129,7,2,147,7,124,8,15,154
2020,47017,Quarrata,PT,69,9,114,4,7,134,10,89,9,17,125
2020,47017,Quarrata,PT,70,6,108,6,5,125,17,109,6,31,163
2020,47017,Quarrata,PT,71,10,108,2,11,131,6,117,2,37,162
2020,47017,Quarrata,PT,72,12,115,5,6,138,13,103,4,33,153
2020,47017,Quarrata,PT,73,9,124,8,4,145,12,107,6,46,171
2020,47017,Quarrata,PT,74,13,138,2,14,167,6,92,3,51,152
2020,47017,Quarrata,PT,75,4,93,0,9,106,4,83,4,56,147
2020,47017,Quarrata,PT,76,2,76,3,6,87,6,74,4,38,122
2020,47017,Quarrata,PT,77,4,101,3,13,121,2,66,4,54,126
2020,47017,Quarrata,PT,78,8,84,2,9,103,5,69,0,53,127
2020,47017,Quarrata,PT,79,3,73,1,10,87,4,80,5,59,148
2020,47017,Quarrata,PT,80,7,77,4,10,98,6,64,0,55,125
2020,47017,Quarrata,PT,81,6,74,4,9,93,7,47,4,57,115
2020,47017,Quarrata,PT,82,3,65,2,14,84,5,46,4,60,115
2020,47017,Quarrata,PT,83,5,69,0,10,84,3,38,2,64,107
2020,47017,Quarrata,PT,84,6,62,1,15,84,6,26,2,59,93
2020,47017,Quarrata,PT,85,3,48,0,21,72,3,31,2,42,78
2020,47017,Quarrata,PT,86,4,33,1,15,53,1,19,0,58,78
2020,47017,Quarrata,PT,87,1,28,0,15,44,3,10,0,43,56
2020,47017,Quarrata,PT,88,2,25,0,7,34,0,11,1,56,68
2020,47017,Quarrata,PT,89,2,15,0,9,26,3,7,1,45,56
2020,47017,Quarrata,PT,90,1,18,0,7,26,1,7,0,49,57
2020,47017,Quarrata,PT,91,1,16,0,8,25,0,3,0,31,34
2020,47017,Quarrata,PT,92,1,11,0,3,15,1,3,0,29,33
2020,47017,Quarrata,PT,93,1,5,0,4,10,1,2,0,20,23
2020,47017,Quarrata,PT,94,1,4,0,6,11,0,1,0,17,18
2020,47017,Quarrata,PT,95,0,2,0,1,3,0,0,0,21,21
2020,47017,Quarrata,PT,96,1,2,0,0,3,0,0,0,16,16
2020,47017,Quarrata,PT,97,0,2,0,2,4,0,0,0,12,12
2020,47017,Quarrata,PT,98,0,0,0,1,1,0,0,0,8,8
2020,47017,Quarrata,PT,99,0,0,0,1,1,0,0,0,4,4
2020,47017,Quarrata,PT,100 e più,0,0,0,1,1,1,0,0,5,6
2020,47018,Sambuca Pistoiese,PT,0,5,0,0,0,5,6,0,0,0,6
2020,47018,Sambuca Pistoiese,PT,1,0,0,0,0,0,4,0,0,0,4
2020,47018,Sambuca Pistoiese,PT,2,2,0,0,0,2,0,0,0,0,0
2020,47018,Sambuca Pistoiese,PT,3,5,0,0,0,5,3,0,0,0,3
2020,47018,Sambuca Pistoiese,PT,4,3,0,0,0,3,2,0,0,0,2
2020,47018,Sambuca Pistoiese,PT,5,2,0,0,0,2,4,0,0,0,4
2020,47018,Sambuca Pistoiese,PT,6,3,0,0,0,3,4,0,0,0,4
2020,47018,Sambuca Pistoiese,PT,7,5,0,0,0,5,8,0,0,0,8
2020,47018,Sambuca Pistoiese,PT,8,9,0,0,0,9,1,0,0,0,1
2020,47018,Sambuca Pistoiese,PT,9,6,0,0,0,6,4,0,0,0,4
2020,47018,Sambuca Pistoiese,PT,10,6,0,0,0,6,4,0,0,0,4
2020,47018,Sambuca Pistoiese,PT,11,7,0,0,0,7,5,0,0,0,5
2020,47018,Sambuca Pistoiese,PT,12,9,0,0,0,9,11,0,0,0,11
2020,47018,Sambuca Pistoiese,PT,13,8,0,0,0,8,4,0,0,0,4
2020,47018,Sambuca Pistoiese,PT,14,3,0,0,0,3,5,0,0,0,5
2020,47018,Sambuca Pistoiese,PT,15,4,0,0,0,4,3,0,0,0,3
2020,47018,Sambuca Pistoiese,PT,16,10,0,0,0,10,2,0,0,0,2
2020,47018,Sambuca Pistoiese,PT,17,9,0,0,0,9,5,0,0,0,5
2020,47018,Sambuca Pistoiese,PT,18,12,0,0,0,12,6,0,0,0,6
2020,47018,Sambuca Pistoiese,PT,19,5,0,0,0,5,4,0,0,0,4
2020,47018,Sambuca Pistoiese,PT,20,5,0,0,0,5,10,0,0,0,10
2020,47018,Sambuca Pistoiese,PT,21,8,0,0,0,8,5,0,0,0,5
2020,47018,Sambuca Pistoiese,PT,22,6,0,0,0,6,10,0,0,0,10
2020,47018,Sambuca Pistoiese,PT,23,2,0,0,0,2,2,0,0,0,2
2020,47018,Sambuca Pistoiese,PT,24,7,0,0,0,7,10,0,0,0,10
2020,47018,Sambuca Pistoiese,PT,25,8,0,0,0,8,11,0,0,0,11
2020,47018,Sambuca Pistoiese,PT,26,7,0,0,0,7,1,0,0,0,1
2020,47018,Sambuca Pistoiese,PT,27,3,0,0,0,3,3,0,0,0,3
2020,47018,Sambuca Pistoiese,PT,28,3,0,0,0,3,2,4,0,0,6
2020,47018,Sambuca Pistoiese,PT,29,4,0,0,0,4,2,0,0,0,2
2020,47018,Sambuca Pistoiese,PT,30,4,2,0,0,6,1,1,0,0,2
2020,47018,Sambuca Pistoiese,PT,31,3,2,0,0,5,4,0,0,0,4
2020,47018,Sambuca Pistoiese,PT,32,4,2,0,0,6,3,2,0,0,5
2020,47018,Sambuca Pistoiese,PT,33,6,0,0,0,6,6,2,0,0,8
2020,47018,Sambuca Pistoiese,PT,34,4,0,0,0,4,3,2,0,0,5
2020,47018,Sambuca Pistoiese,PT,35,6,2,0,0,8,5,2,0,0,7
2020,47018,Sambuca Pistoiese,PT,36,4,2,0,0,6,4,3,0,0,7
2020,47018,Sambuca Pistoiese,PT,37,6,1,1,0,8,3,3,0,0,6
2020,47018,Sambuca Pistoiese,PT,38,1,2,0,0,3,2,3,0,0,5
2020,47018,Sambuca Pistoiese,PT,39,4,0,0,0,4,3,3,1,0,7
2020,47018,Sambuca Pistoiese,PT,40,2,2,0,0,4,7,1,0,0,8
2020,47018,Sambuca Pistoiese,PT,41,7,4,0,0,11,3,4,0,0,7
2020,47018,Sambuca Pistoiese,PT,42,9,3,0,0,12,6,5,0,0,11
2020,47018,Sambuca Pistoiese,PT,43,5,4,1,0,10,4,3,0,0,7
2020,47018,Sambuca Pistoiese,PT,44,7,5,0,0,12,4,3,1,0,8
2020,47018,Sambuca Pistoiese,PT,45,11,5,0,0,16,3,6,0,0,9
2020,47018,Sambuca Pistoiese,PT,46,6,4,0,0,10,4,3,0,0,7
2020,47018,Sambuca Pistoiese,PT,47,7,4,3,0,14,5,7,2,0,14
2020,47018,Sambuca Pistoiese,PT,48,11,7,1,0,19,5,7,2,0,14
2020,47018,Sambuca Pistoiese,PT,49,8,4,1,0,13,5,8,0,0,13
2020,47018,Sambuca Pistoiese,PT,50,4,6,1,0,11,3,12,0,0,15
2020,47018,Sambuca Pistoiese,PT,51,5,5,1,0,11,5,7,1,0,13
2020,47018,Sambuca Pistoiese,PT,52,7,7,0,0,14,3,6,0,0,9
2020,47018,Sambuca Pistoiese,PT,53,5,7,1,0,13,1,9,0,0,10
2020,47018,Sambuca Pistoiese,PT,54,2,7,1,0,10,2,5,0,1,8
2020,47018,Sambuca Pistoiese,PT,55,5,8,2,0,15,2,6,1,0,9
2020,47018,Sambuca Pistoiese,PT,56,3,11,2,0,16,6,13,1,1,21
2020,47018,Sambuca Pistoiese,PT,57,3,8,2,1,14,2,5,1,0,8
2020,47018,Sambuca Pistoiese,PT,58,3,5,2,0,10,1,13,1,0,15
2020,47018,Sambuca Pistoiese,PT,59,4,10,0,0,14,3,4,2,2,11
2020,47018,Sambuca Pistoiese,PT,60,6,7,2,0,15,0,5,0,1,6
2020,47018,Sambuca Pistoiese,PT,61,5,11,1,1,18,1,3,1,1,6
2020,47018,Sambuca Pistoiese,PT,62,5,7,2,0,14,1,8,1,1,11
2020,47018,Sambuca Pistoiese,PT,63,0,7,1,0,8,3,11,2,0,16
2020,47018,Sambuca Pistoiese,PT,64,2,6,0,0,8,2,3,0,2,7
2020,47018,Sambuca Pistoiese,PT,65,3,3,1,1,8,0,8,0,2,10
2020,47018,Sambuca Pistoiese,PT,66,0,6,0,0,6,0,12,0,2,14
2020,47018,Sambuca Pistoiese,PT,67,0,5,1,1,7,1,4,0,1,6
2020,47018,Sambuca Pistoiese,PT,68,0,8,0,0,8,0,9,0,2,11
2020,47018,Sambuca Pistoiese,PT,69,0,6,1,0,7,0,6,0,1,7
2020,47018,Sambuca Pistoiese,PT,70,2,7,2,1,12,0,5,0,3,8
2020,47018,Sambuca Pistoiese,PT,71,0,12,0,0,12,1,8,0,1,10
2020,47018,Sambuca Pistoiese,PT,72,1,6,1,0,8,0,7,2,1,10
2020,47018,Sambuca Pistoiese,PT,73,3,9,0,1,13,1,9,0,6,16
2020,47018,Sambuca Pistoiese,PT,74,1,10,0,0,11,1,8,0,7,16
2020,47018,Sambuca Pistoiese,PT,75,0,10,0,0,10,1,7,0,1,9
2020,47018,Sambuca Pistoiese,PT,76,3,10,0,0,13,0,6,0,7,13
2020,47018,Sambuca Pistoiese,PT,77,0,8,0,2,10,0,4,0,2,6
2020,47018,Sambuca Pistoiese,PT,78,1,2,0,0,3,2,3,0,4,9
2020,47018,Sambuca Pistoiese,PT,79,2,3,1,0,6,0,7,0,2,9
2020,47018,Sambuca Pistoiese,PT,80,0,6,0,0,6,1,10,1,1,13
2020,47018,Sambuca Pistoiese,PT,81,0,4,0,1,5,1,4,0,5,10
2020,47018,Sambuca Pistoiese,PT,82,1,8,0,3,12,1,3,0,7,11
2020,47018,Sambuca Pistoiese,PT,83,0,5,0,3,8,1,1,0,5,7
2020,47018,Sambuca Pistoiese,PT,84,0,5,0,2,7,1,0,0,4,5
2020,47018,Sambuca Pistoiese,PT,85,0,0,0,0,0,0,2,0,0,2
2020,47018,Sambuca Pistoiese,PT,86,1,3,0,1,5,2,0,0,6,8
2020,47018,Sambuca Pistoiese,PT,87,0,5,0,0,5,0,1,0,5,6
2020,47018,Sambuca Pistoiese,PT,88,1,2,1,2,6,1,1,0,2,4
2020,47018,Sambuca Pistoiese,PT,89,0,2,0,0,2,1,1,0,1,3
2020,47018,Sambuca Pistoiese,PT,90,1,2,0,0,3,1,1,0,3,5
2020,47018,Sambuca Pistoiese,PT,91,0,1,0,0,1,0,1,0,3,4
2020,47018,Sambuca Pistoiese,PT,92,0,0,0,0,0,0,1,0,4,5
2020,47018,Sambuca Pistoiese,PT,93,0,0,0,0,0,0,0,0,3,3
2020,47018,Sambuca Pistoiese,PT,94,0,0,0,1,1,0,0,0,3,3
2020,47018,Sambuca Pistoiese,PT,95,0,0,0,0,0,0,0,0,2,2
2020,47018,Sambuca Pistoiese,PT,96,0,0,0,0,0,0,0,0,4,4
2020,47018,Sambuca Pistoiese,PT,97,0,0,0,0,0,0,0,0,1,1
2020,47018,Sambuca Pistoiese,PT,98,0,0,0,0,0,0,0,0,0,0
2020,47018,Sambuca Pistoiese,PT,99,0,0,0,0,0,0,0,0,0,0
2020,47018,Sambuca Pistoiese,PT,100 e più,0,0,0,0,0,0,0,0,1,1
2020,47020,Serravalle Pistoiese,PT,0,38,0,0,0,38,38,0,0,0,38
2020,47020,Serravalle Pistoiese,PT,1,44,0,0,0,44,46,0,0,0,46
2020,47020,Serravalle Pistoiese,PT,2,36,0,0,0,36,43,0,0,0,43
2020,47020,Serravalle Pistoiese,PT,3,48,0,0,0,48,36,0,0,0,36
2020,47020,Serravalle Pistoiese,PT,4,43,0,0,0,43,43,0,0,0,43
2020,47020,Serravalle Pistoiese,PT,5,58,0,0,0,58,52,0,0,0,52
2020,47020,Serravalle Pistoiese,PT,6,49,0,0,0,49,53,0,0,0,53
2020,47020,Serravalle Pistoiese,PT,7,46,0,0,0,46,41,0,0,0,41
2020,47020,Serravalle Pistoiese,PT,8,63,0,0,0,63,46,0,0,0,46
2020,47020,Serravalle Pistoiese,PT,9,66,0,0,0,66,53,0,0,0,53
2020,47020,Serravalle Pistoiese,PT,10,71,0,0,0,71,42,0,0,0,42
2020,47020,Serravalle Pistoiese,PT,11,48,0,0,0,48,42,0,0,0,42
2020,47020,Serravalle Pistoiese,PT,12,60,0,0,0,60,59,0,0,0,59
2020,47020,Serravalle Pistoiese,PT,13,53,0,0,0,53,60,0,0,0,60
2020,47020,Serravalle Pistoiese,PT,14,50,0,0,0,50,58,0,0,0,58
2020,47020,Serravalle Pistoiese,PT,15,58,0,0,0,58,54,0,0,0,54
2020,47020,Serravalle Pistoiese,PT,16,68,0,0,0,68,57,0,0,0,57
2020,47020,Serravalle Pistoiese,PT,17,56,0,0,0,56,52,0,0,0,52
2020,47020,Serravalle Pistoiese,PT,18,67,0,0,0,67,47,0,0,0,47
2020,47020,Serravalle Pistoiese,PT,19,56,0,0,0,56,46,0,0,0,46
2020,47020,Serravalle Pistoiese,PT,20,55,0,0,0,55,50,1,0,0,51
2020,47020,Serravalle Pistoiese,PT,21,46,0,0,0,46,49,1,0,0,50
2020,47020,Serravalle Pistoiese,PT,22,41,0,0,0,41,45,3,0,0,48
2020,47020,Serravalle Pistoiese,PT,23,65,1,0,0,66,58,6,0,0,64
2020,47020,Serravalle Pistoiese,PT,24,49,0,0,0,49,41,5,0,0,46
2020,47020,Serravalle Pistoiese,PT,25,51,0,0,0,51,44,4,0,0,48
2020,47020,Serravalle Pistoiese,PT,26,42,2,0,0,44,41,7,0,0,48
2020,47020,Serravalle Pistoiese,PT,27,37,2,0,0,39,39,10,0,0,49
2020,47020,Serravalle Pistoiese,PT,28,61,3,0,0,64,47,13,0,0,60
2020,47020,Serravalle Pistoiese,PT,29,53,6,0,0,59,36,11,0,0,47
2020,47020,Serravalle Pistoiese,PT,30,56,13,0,0,69,38,21,0,0,59
2020,47020,Serravalle Pistoiese,PT,31,44,12,0,0,56,48,19,0,1,68
2020,47020,Serravalle Pistoiese,PT,32,43,15,2,0,60,33,31,1,0,65
2020,47020,Serravalle Pistoiese,PT,33,31,18,0,0,49,34,27,1,0,62
2020,47020,Serravalle Pistoiese,PT,34,34,22,2,0,58,30,38,0,0,68
2020,47020,Serravalle Pistoiese,PT,35,27,29,2,0,58,30,30,1,0,61
2020,47020,Serravalle Pistoiese,PT,36,31,22,1,0,54,25,23,2,0,50
2020,47020,Serravalle Pistoiese,PT,37,44,35,0,0,79,29,38,3,0,70
2020,47020,Serravalle Pistoiese,PT,38,30,33,0,0,63,34,38,2,0,74
2020,47020,Serravalle Pistoiese,PT,39,33,41,1,0,75,26,60,3,0,89
2020,47020,Serravalle Pistoiese,PT,40,31,33,0,0,64,23,56,5,0,84
2020,47020,Serravalle Pistoiese,PT,41,33,46,1,0,80,31,48,3,1,83
2020,47020,Serravalle Pistoiese,PT,42,35,45,3,0,83,32,52,5,0,89
2020,47020,Serravalle Pistoiese,PT,43,29,46,3,0,78,25,56,3,1,85
2020,47020,Serravalle Pistoiese,PT,44,30,48,1,1,80,25,63,7,0,95
2020,47020,Serravalle Pistoiese,PT,45,31,65,3,0,99,21,76,12,1,110
2020,47020,Serravalle Pistoiese,PT,46,23,53,2,0,78,23,57,5,0,85
2020,47020,Serravalle Pistoiese,PT,47,28,66,5,1,100,16,64,5,0,85
2020,47020,Serravalle Pistoiese,PT,48,26,63,9,0,98,17,73,8,1,99
2020,47020,Serravalle Pistoiese,PT,49,31,66,6,0,103,17,76,5,2,100
2020,47020,Serravalle Pistoiese,PT,50,21,72,3,2,98,15,69,6,3,93
2020,47020,Serravalle Pistoiese,PT,51,24,69,5,1,99,11,69,5,5,90
2020,47020,Serravalle Pistoiese,PT,52,17,60,4,1,82,11,74,7,3,95
2020,47020,Serravalle Pistoiese,PT,53,15,74,4,0,93,7,73,6,2,88
2020,47020,Serravalle Pistoiese,PT,54,13,76,5,1,95,11,84,8,4,107
2020,47020,Serravalle Pistoiese,PT,55,12,85,6,0,103,10,74,10,1,95
2020,47020,Serravalle Pistoiese,PT,56,8,66,7,2,83,14,85,10,6,115
2020,47020,Serravalle Pistoiese,PT,57,12,75,5,3,95,10,65,11,6,92
2020,47020,Serravalle Pistoiese,PT,58,8,70,2,1,81,9,83,9,6,107
2020,47020,Serravalle Pistoiese,PT,59,16,79,6,2,103,1,72,10,9,92
2020,47020,Serravalle Pistoiese,PT,60,8,73,12,1,94,6,68,9,5,88
2020,47020,Serravalle Pistoiese,PT,61,10,70,5,2,87,1,75,9,3,88
2020,47020,Serravalle Pistoiese,PT,62,12,71,11,3,97,4,60,2,7,73
2020,47020,Serravalle Pistoiese,PT,63,3,59,5,2,69,3,65,8,9,85
2020,47020,Serravalle Pistoiese,PT,64,4,61,5,3,73,5,69,7,10,91
2020,47020,Serravalle Pistoiese,PT,65,3,59,7,1,70,4,65,6,8,83
2020,47020,Serravalle Pistoiese,PT,66,1,60,1,2,64,0,58,2,4,64
2020,47020,Serravalle Pistoiese,PT,67,3,68,3,4,78,5,51,3,12,71
2020,47020,Serravalle Pistoiese,PT,68,4,57,3,2,66,3,50,4,5,62
2020,47020,Serravalle Pistoiese,PT,69,4,62,6,4,76,1,52,5,12,70
2020,47020,Serravalle Pistoiese,PT,70,2,59,3,2,66,3,38,3,16,60
2020,47020,Serravalle Pistoiese,PT,71,4,49,3,3,59,0,52,0,16,68
2020,47020,Serravalle Pistoiese,PT,72,6,62,1,2,71,6,58,2,12,78
2020,47020,Serravalle Pistoiese,PT,73,5,55,1,7,68,1,57,3,18,79
2020,47020,Serravalle Pistoiese,PT,74,1,50,0,1,52,0,47,2,19,68
2020,47020,Serravalle Pistoiese,PT,75,1,39,2,5,47,1,31,4,11,47
2020,47020,Serravalle Pistoiese,PT,76,1,51,3,6,61,0,36,0,18,54
2020,47020,Serravalle Pistoiese,PT,77,2,37,2,4,45,0,32,0,17,49
2020,47020,Serravalle Pistoiese,PT,78,2,34,1,2,39,1,28,2,27,58
2020,47020,Serravalle Pistoiese,PT,79,3,39,1,2,45,3,23,0,12,38
2020,47020,Serravalle Pistoiese,PT,80,0,47,2,11,60,0,32,2,36,70
2020,47020,Serravalle Pistoiese,PT,81,2,27,3,5,37,4,22,1,26,53
2020,47020,Serravalle Pistoiese,PT,82,1,26,1,9,37,0,16,0,34,50
2020,47020,Serravalle Pistoiese,PT,83,2,28,1,7,38,0,15,1,25,41
2020,47020,Serravalle Pistoiese,PT,84,4,22,0,6,32,1,11,0,25,37
2020,47020,Serravalle Pistoiese,PT,85,1,17,0,8,26,1,5,1,34,41
2020,47020,Serravalle Pistoiese,PT,86,1,20,0,5,26,2,8,1,30,41
2020,47020,Serravalle Pistoiese,PT,87,2,15,2,5,24,4,6,0,34,44
2020,47020,Serravalle Pistoiese,PT,88,0,9,0,4,13,1,5,0,28,34
2020,47020,Serravalle Pistoiese,PT,89,1,9,0,7,17,3,5,1,19,28
2020,47020,Serravalle Pistoiese,PT,90,0,8,0,10,18,2,3,0,21,26
2020,47020,Serravalle Pistoiese,PT,91,1,6,0,8,15,1,3,1,14,19
2020,47020,Serravalle Pistoiese,PT,92,1,5,0,2,8,3,1,0,12,16
2020,47020,Serravalle Pistoiese,PT,93,0,3,0,2,5,0,0,0,19,19
2020,47020,Serravalle Pistoiese,PT,94,1,2,0,3,6,0,1,1,11,13
2020,47020,Serravalle Pistoiese,PT,95,0,0,0,1,1,0,0,0,4,4
2020,47020,Serravalle Pistoiese,PT,96,0,0,0,3,3,0,0,0,8,8
2020,47020,Serravalle Pistoiese,PT,97,0,0,0,0,0,0,0,0,5,5
2020,47020,Serravalle Pistoiese,PT,98,0,0,0,0,0,0,0,0,1,1
2020,47020,Serravalle Pistoiese,PT,99,0,0,0,0,0,0,0,0,2,2
2020,47020,Serravalle Pistoiese,PT,100 e più,0,0,0,0,0,0,0,0,3,3
2020,47021,Uzzano,PT,0,30,0,0,0,30,14,0,0,0,14
2020,47021,Uzzano,PT,1,18,0,0,0,18,26,0,0,0,26
2020,47021,Uzzano,PT,2,20,0,0,0,20,22,0,0,0,22
2020,47021,Uzzano,PT,3,18,0,0,0,18,19,0,0,0,19
2020,47021,Uzzano,PT,4,30,0,0,0,30,26,0,0,0,26
2020,47021,Uzzano,PT,5,24,0,0,0,24,24,0,0,0,24
2020,47021,Uzzano,PT,6,25,0,0,0,25,19,0,0,0,19
2020,47021,Uzzano,PT,7,26,0,0,0,26,31,0,0,0,31
2020,47021,Uzzano,PT,8,26,0,0,0,26,23,0,0,0,23
2020,47021,Uzzano,PT,9,27,0,0,0,27,32,0,0,0,32
2020,47021,Uzzano,PT,10,22,0,0,0,22,18,0,0,0,18
2020,47021,Uzzano,PT,11,24,0,0,0,24,31,0,0,0,31
2020,47021,Uzzano,PT,12,21,0,0,0,21,24,0,0,0,24
2020,47021,Uzzano,PT,13,41,0,0,0,41,36,0,0,0,36
2020,47021,Uzzano,PT,14,28,0,0,0,28,20,0,0,0,20
2020,47021,Uzzano,PT,15,25,0,0,0,25,12,0,0,0,12
2020,47021,Uzzano,PT,16,28,0,0,0,28,27,0,0,0,27
2020,47021,Uzzano,PT,17,27,0,0,0,27,32,0,0,0,32
2020,47021,Uzzano,PT,18,23,0,0,0,23,17,0,0,0,17
2020,47021,Uzzano,PT,19,21,0,0,0,21,41,0,0,0,41
2020,47021,Uzzano,PT,20,30,0,0,0,30,28,1,0,0,29
2020,47021,Uzzano,PT,21,21,0,0,0,21,27,0,0,0,27
2020,47021,Uzzano,PT,22,27,0,0,0,27,31,0,0,0,31
2020,47021,Uzzano,PT,23,28,0,0,0,28,28,1,0,0,29
2020,47021,Uzzano,PT,24,23,0,0,0,23,25,2,0,0,27
2020,47021,Uzzano,PT,25,28,0,0,0,28,18,2,0,0,20
2020,47021,Uzzano,PT,26,24,0,0,0,24,25,2,0,0,27
2020,47021,Uzzano,PT,27,25,0,0,0,25,26,4,0,0,30
2020,47021,Uzzano,PT,28,22,2,0,0,24,27,7,0,0,34
2020,47021,Uzzano,PT,29,29,2,0,0,31,19,7,1,0,27
2020,47021,Uzzano,PT,30,16,5,0,0,21,23,7,0,0,30
2020,47021,Uzzano,PT,31,23,2,0,0,25,19,12,0,1,32
2020,47021,Uzzano,PT,32,26,9,0,0,35,25,13,0,0,38
2020,47021,Uzzano,PT,33,14,11,0,0,25,21,9,1,0,31
2020,47021,Uzzano,PT,34,26,4,0,0,30,11,9,1,0,21
2020,47021,Uzzano,PT,35,20,13,0,0,33,9,15,1,0,25
2020,47021,Uzzano,PT,36,21,12,0,0,33,17,19,1,0,37
2020,47021,Uzzano,PT,37,17,12,0,0,29,13,13,0,0,26
2020,47021,Uzzano,PT,38,22,13,1,0,36,12,26,0,0,38
2020,47021,Uzzano,PT,39,17,19,0,0,36,10,23,1,0,34
2020,47021,Uzzano,PT,40,20,21,3,0,44,13,26,0,1,40
2020,47021,Uzzano,PT,41,17,22,2,0,41,12,27,0,0,39
2020,47021,Uzzano,PT,42,12,18,3,0,33,10,24,2,0,36
2020,47021,Uzzano,PT,43,18,22,3,0,43,18,34,2,0,54
2020,47021,Uzzano,PT,44,18,27,1,0,46,15,35,4,0,54
2020,47021,Uzzano,PT,45,12,33,0,1,46,13,26,2,1,42
2020,47021,Uzzano,PT,46,10,35,3,1,49,11,25,7,1,44
2020,47021,Uzzano,PT,47,17,37,2,0,56,13,32,3,1,49
2020,47021,Uzzano,PT,48,14,38,4,1,57,6,43,4,1,54
2020,47021,Uzzano,PT,49,10,31,4,0,45,7,39,4,0,50
2020,47021,Uzzano,PT,50,12,40,0,0,52,8,30,9,2,49
2020,47021,Uzzano,PT,51,14,36,7,0,57,7,35,6,0,48
2020,47021,Uzzano,PT,52,4,40,4,0,48,13,33,4,2,52
2020,47021,Uzzano,PT,53,13,30,6,1,50,9,40,8,0,57
2020,47021,Uzzano,PT,54,6,30,5,1,42,5,47,4,3,59
2020,47021,Uzzano,PT,55,8,35,5,1,49,4,30,1,2,37
2020,47021,Uzzano,PT,56,4,48,4,1,57,0,37,3,2,42
2020,47021,Uzzano,PT,57,7,34,0,0,41,2,40,7,1,50
2020,47021,Uzzano,PT,58,7,37,5,0,49,4,26,2,2,34
2020,47021,Uzzano,PT,59,5,27,2,0,34,4,41,4,5,54
2020,47021,Uzzano,PT,60,2,33,2,0,37,5,39,1,5,50
2020,47021,Uzzano,PT,61,2,27,5,1,35,6,28,6,3,43
2020,47021,Uzzano,PT,62,5,29,3,1,38,3,29,4,5,41
2020,47021,Uzzano,PT,63,0,32,2,2,36,5,27,4,6,42
2020,47021,Uzzano,PT,64,1,23,0,1,25,0,19,4,3,26
2020,47021,Uzzano,PT,65,5,27,3,1,36,5,32,3,4,44
2020,47021,Uzzano,PT,66,2,27,1,0,30,2,19,3,3,27
2020,47021,Uzzano,PT,67,2,31,1,0,34,0,25,6,5,36
2020,47021,Uzzano,PT,68,2,26,3,0,31,0,27,1,6,34
2020,47021,Uzzano,PT,69,1,25,2,0,28,1,23,4,3,31
2020,47021,Uzzano,PT,70,1,29,0,3,33,2,24,3,5,34
2020,47021,Uzzano,PT,71,3,12,0,4,19,2,21,5,6,34
2020,47021,Uzzano,PT,72,2,27,2,3,34,4,26,1,3,34
2020,47021,Uzzano,PT,73,0,23,0,2,25,3,21,4,7,35
2020,47021,Uzzano,PT,74,1,21,1,1,24,1,19,1,4,25
2020,47021,Uzzano,PT,75,0,13,2,1,16,3,17,2,13,35
2020,47021,Uzzano,PT,76,0,20,0,1,21,1,8,0,6,15
2020,47021,Uzzano,PT,77,2,20,0,2,24,2,12,1,5,20
2020,47021,Uzzano,PT,78,1,12,1,1,15,0,12,1,8,21
2020,47021,Uzzano,PT,79,0,15,1,3,19,1,10,2,9,22
2020,47021,Uzzano,PT,80,0,20,0,5,25,1,6,0,14,21
2020,47021,Uzzano,PT,81,3,13,0,2,18,0,10,1,7,18
2020,47021,Uzzano,PT,82,1,14,1,3,19,1,6,1,13,21
2020,47021,Uzzano,PT,83,1,9,0,1,11,1,8,0,7,16
2020,47021,Uzzano,PT,84,0,10,1,4,15,1,5,0,15,21
2020,47021,Uzzano,PT,85,0,8,1,3,12,0,5,0,9,14
2020,47021,Uzzano,PT,86,0,8,1,2,11,1,1,0,13,15
2020,47021,Uzzano,PT,87,1,6,0,3,10,0,4,0,19,23
2020,47021,Uzzano,PT,88,0,3,0,1,4,0,0,0,14,14
2020,47021,Uzzano,PT,89,0,4,0,3,7,0,3,0,7,10
2020,47021,Uzzano,PT,90,0,0,0,2,2,0,1,0,7,8
2020,47021,Uzzano,PT,91,0,2,0,2,4,0,1,0,9,10
2020,47021,Uzzano,PT,92,0,1,0,1,2,0,1,0,7,8
2020,47021,Uzzano,PT,93,0,0,0,2,2,1,0,0,4,5
2020,47021,Uzzano,PT,94,0,0,0,2,2,0,1,0,4,5
2020,47021,Uzzano,PT,95,0,1,0,0,1,0,0,0,3,3
2020,47021,Uzzano,PT,96,0,0,0,1,1,1,0,0,1,2
2020,47021,Uzzano,PT,97,0,1,0,0,1,0,1,0,0,1
2020,47021,Uzzano,PT,98,0,0,0,0,0,0,0,0,0,0
2020,47021,Uzzano,PT,99,0,0,0,0,0,0,0,0,1,1
2020,47021,Uzzano,PT,100 e più,0,0,0,0,0,0,0,0,2,2
2020,47022,Chiesina Uzzanese,PT,0,13,0,0,0,13,20,0,0,0,20
2020,47022,Chiesina Uzzanese,PT,1,15,0,0,0,15,13,0,0,0,13
2020,47022,Chiesina Uzzanese,PT,2,16,0,0,0,16,17,0,0,0,17
2020,47022,Chiesina Uzzanese,PT,3,7,0,0,0,7,18,0,0,0,18
2020,47022,Chiesina Uzzanese,PT,4,18,0,0,0,18,19,0,0,0,19
2020,47022,Chiesina Uzzanese,PT,5,20,0,0,0,20,18,0,0,0,18
2020,47022,Chiesina Uzzanese,PT,6,23,0,0,0,23,24,0,0,0,24
2020,47022,Chiesina Uzzanese,PT,7,18,0,0,0,18,13,0,0,0,13
2020,47022,Chiesina Uzzanese,PT,8,20,0,0,0,20,23,0,0,0,23
2020,47022,Chiesina Uzzanese,PT,9,25,0,0,0,25,27,0,0,0,27
2020,47022,Chiesina Uzzanese,PT,10,27,0,0,0,27,16,0,0,0,16
2020,47022,Chiesina Uzzanese,PT,11,22,0,0,0,22,19,0,0,0,19
2020,47022,Chiesina Uzzanese,PT,12,28,0,0,0,28,32,0,0,0,32
2020,47022,Chiesina Uzzanese,PT,13,28,0,0,0,28,22,0,0,0,22
2020,47022,Chiesina Uzzanese,PT,14,14,0,0,0,14,11,0,0,0,11
2020,47022,Chiesina Uzzanese,PT,15,20,0,0,0,20,18,0,0,0,18
2020,47022,Chiesina Uzzanese,PT,16,18,0,0,0,18,22,0,0,0,22
2020,47022,Chiesina Uzzanese,PT,17,21,0,0,0,21,21,0,0,0,21
2020,47022,Chiesina Uzzanese,PT,18,23,0,0,0,23,21,0,0,0,21
2020,47022,Chiesina Uzzanese,PT,19,27,0,0,0,27,18,0,0,0,18
2020,47022,Chiesina Uzzanese,PT,20,29,0,0,0,29,21,0,0,0,21
2020,47022,Chiesina Uzzanese,PT,21,18,0,0,0,18,21,0,0,0,21
2020,47022,Chiesina Uzzanese,PT,22,21,0,0,0,21,16,3,0,0,19
2020,47022,Chiesina Uzzanese,PT,23,16,0,0,0,16,15,0,0,0,15
2020,47022,Chiesina Uzzanese,PT,24,20,0,0,0,20,22,3,0,0,25
2020,47022,Chiesina Uzzanese,PT,25,16,0,0,0,16,16,1,0,0,17
2020,47022,Chiesina Uzzanese,PT,26,22,0,0,0,22,11,2,0,0,13
2020,47022,Chiesina Uzzanese,PT,27,21,1,0,0,22,17,6,0,0,23
2020,47022,Chiesina Uzzanese,PT,28,20,2,0,0,22,14,4,0,0,18
2020,47022,Chiesina Uzzanese,PT,29,21,6,0,0,27,11,8,0,0,19
2020,47022,Chiesina Uzzanese,PT,30,18,7,0,0,25,15,6,0,0,21
2020,47022,Chiesina Uzzanese,PT,31,23,5,0,0,28,16,7,0,0,23
2020,47022,Chiesina Uzzanese,PT,32,22,6,0,0,28,11,16,0,0,27
2020,47022,Chiesina Uzzanese,PT,33,14,4,0,0,18,12,6,0,0,18
2020,47022,Chiesina Uzzanese,PT,34,25,8,0,0,33,6,13,0,0,19
2020,47022,Chiesina Uzzanese,PT,35,21,10,0,0,31,6,15,0,0,21
2020,47022,Chiesina Uzzanese,PT,36,18,12,0,0,30,12,15,0,0,27
2020,47022,Chiesina Uzzanese,PT,37,20,8,1,0,29,7,15,1,0,23
2020,47022,Chiesina Uzzanese,PT,38,11,11,0,0,22,10,13,0,0,23
2020,47022,Chiesina Uzzanese,PT,39,16,14,1,0,31,7,19,2,0,28
2020,47022,Chiesina Uzzanese,PT,40,9,13,1,0,23,7,18,0,0,25
2020,47022,Chiesina Uzzanese,PT,41,12,16,1,0,29,6,18,0,1,25
2020,47022,Chiesina Uzzanese,PT,42,15,18,0,0,33,10,34,4,0,48
2020,47022,Chiesina Uzzanese,PT,43,15,20,0,0,35,11,21,2,0,34
2020,47022,Chiesina Uzzanese,PT,44,12,30,2,0,44,9,19,3,1,32
2020,47022,Chiesina Uzzanese,PT,45,11,26,0,0,37,5,25,2,0,32
2020,47022,Chiesina Uzzanese,PT,46,13,28,1,0,42,7,21,2,0,30
2020,47022,Chiesina Uzzanese,PT,47,10,19,3,0,32,3,24,3,0,30
2020,47022,Chiesina Uzzanese,PT,48,14,30,4,0,48,5,25,5,0,35
2020,47022,Chiesina Uzzanese,PT,49,15,22,1,0,38,7,36,4,1,48
2020,47022,Chiesina Uzzanese,PT,50,5,32,2,1,40,5,37,3,0,45
2020,47022,Chiesina Uzzanese,PT,51,12,24,3,0,39,4,33,3,0,40
2020,47022,Chiesina Uzzanese,PT,52,9,28,1,0,38,5,26,3,3,37
2020,47022,Chiesina Uzzanese,PT,53,10,34,1,0,45,3,28,4,0,35
2020,47022,Chiesina Uzzanese,PT,54,4,17,5,0,26,5,42,3,1,51
2020,47022,Chiesina Uzzanese,PT,55,10,25,2,0,37,2,24,1,0,27
2020,47022,Chiesina Uzzanese,PT,56,6,39,5,0,50,0,29,5,1,35
2020,47022,Chiesina Uzzanese,PT,57,4,25,1,0,30,4,20,6,1,31
2020,47022,Chiesina Uzzanese,PT,58,5,31,3,1,40,4,25,4,1,34
2020,47022,Chiesina Uzzanese,PT,59,3,21,1,1,26,3,24,1,5,33
2020,47022,Chiesina Uzzanese,PT,60,3,27,4,0,34,0,29,3,2,34
2020,47022,Chiesina Uzzanese,PT,61,6,27,0,0,33,3,19,2,6,30
2020,47022,Chiesina Uzzanese,PT,62,1,19,1,0,21,4,21,2,3,30
2020,47022,Chiesina Uzzanese,PT,63,1,19,0,0,20,1,19,2,6,28
2020,47022,Chiesina Uzzanese,PT,64,6,23,2,0,31,2,32,0,5,39
2020,47022,Chiesina Uzzanese,PT,65,3,25,1,2,31,4,19,2,2,27
2020,47022,Chiesina Uzzanese,PT,66,2,21,0,2,25,0,18,0,4,22
2020,47022,Chiesina Uzzanese,PT,67,3,20,1,0,24,2,18,0,2,22
2020,47022,Chiesina Uzzanese,PT,68,3,24,3,1,31,1,17,2,3,23
2020,47022,Chiesina Uzzanese,PT,69,3,16,0,1,20,2,23,0,1,26
2020,47022,Chiesina Uzzanese,PT,70,1,21,3,1,26,0,11,2,5,18
2020,47022,Chiesina Uzzanese,PT,71,0,20,1,1,22,2,23,1,5,31
2020,47022,Chiesina Uzzanese,PT,72,2,17,2,2,23,1,15,0,8,24
2020,47022,Chiesina Uzzanese,PT,73,3,22,3,2,30,2,18,0,9,29
2020,47022,Chiesina Uzzanese,PT,74,1,12,0,0,13,1,20,2,11,34
2020,47022,Chiesina Uzzanese,PT,75,1,17,3,3,24,3,8,0,8,19
2020,47022,Chiesina Uzzanese,PT,76,2,8,1,2,13,2,16,0,6,24
2020,47022,Chiesina Uzzanese,PT,77,1,11,1,1,14,0,18,2,9,29
2020,47022,Chiesina Uzzanese,PT,78,0,19,0,3,22,0,12,0,14,26
2020,47022,Chiesina Uzzanese,PT,79,0,16,0,1,17,1,9,0,7,17
2020,47022,Chiesina Uzzanese,PT,80,0,15,0,2,17,0,4,2,11,17
2020,47022,Chiesina Uzzanese,PT,81,1,15,0,1,17,0,5,0,10,15
2020,47022,Chiesina Uzzanese,PT,82,0,14,0,3,17,1,7,0,16,24
2020,47022,Chiesina Uzzanese,PT,83,1,13,0,2,16,0,5,0,12,17
2020,47022,Chiesina Uzzanese,PT,84,1,6,0,2,9,1,10,0,11,22
2020,47022,Chiesina Uzzanese,PT,85,1,3,0,3,7,3,3,1,13,20
2020,47022,Chiesina Uzzanese,PT,86,1,5,1,1,8,1,1,0,11,13
2020,47022,Chiesina Uzzanese,PT,87,0,4,0,1,5,0,4,0,9,13
2020,47022,Chiesina Uzzanese,PT,88,1,1,0,3,5,0,2,0,10,12
2020,47022,Chiesina Uzzanese,PT,89,0,6,1,0,7,1,2,0,9,12
2020,47022,Chiesina Uzzanese,PT,90,1,4,0,0,5,2,2,0,13,17
2020,47022,Chiesina Uzzanese,PT,91,0,0,1,3,4,0,0,0,7,7
2020,47022,Chiesina Uzzanese,PT,92,0,1,0,2,3,0,0,0,6,6
2020,47022,Chiesina Uzzanese,PT,93,0,1,0,0,1,0,0,0,11,11
2020,47022,Chiesina Uzzanese,PT,94,0,0,0,1,1,0,0,0,4,4
2020,47022,Chiesina Uzzanese,PT,95,0,1,0,0,1,0,0,0,4,4
2020,47022,Chiesina Uzzanese,PT,96,0,0,0,1,1,0,0,0,5,5
2020,47022,Chiesina Uzzanese,PT,97,0,1,0,1,2,0,0,0,5,5
2020,47022,Chiesina Uzzanese,PT,98,0,0,0,0,0,0,0,0,2,2
2020,47022,Chiesina Uzzanese,PT,99,0,0,0,2,2,0,0,0,1,1
2020,47022,Chiesina Uzzanese,PT,100 e più,0,0,0,0,0,0,0,0,1,1
2020,47024,San Marcello Piteglio,PT,0,15,0,0,0,15,16,0,0,0,16
2020,47024,San Marcello Piteglio,PT,1,17,0,0,0,17,17,0,0,0,17
2020,47024,San Marcello Piteglio,PT,2,14,0,0,0,14,7,0,0,0,7
2020,47024,San Marcello Piteglio,PT,3,23,0,0,0,23,24,0,0,0,24
2020,47024,San Marcello Piteglio,PT,4,12,0,0,0,12,14,0,0,0,14
2020,47024,San Marcello Piteglio,PT,5,20,0,0,0,20,20,0,0,0,20
2020,47024,San Marcello Piteglio,PT,6,20,0,0,0,20,21,0,0,0,21
2020,47024,San Marcello Piteglio,PT,7,22,0,0,0,22,22,0,0,0,22
2020,47024,San Marcello Piteglio,PT,8,22,0,0,0,22,18,0,0,0,18
2020,47024,San Marcello Piteglio,PT,9,29,0,0,0,29,17,0,0,0,17
2020,47024,San Marcello Piteglio,PT,10,28,0,0,0,28,22,0,0,0,22
2020,47024,San Marcello Piteglio,PT,11,21,0,0,0,21,31,0,0,0,31
2020,47024,San Marcello Piteglio,PT,12,21,0,0,0,21,40,0,0,0,40
2020,47024,San Marcello Piteglio,PT,13,26,0,0,0,26,25,0,0,0,25
2020,47024,San Marcello Piteglio,PT,14,29,0,0,0,29,28,0,0,0,28
2020,47024,San Marcello Piteglio,PT,15,32,0,0,0,32,37,0,0,0,37
2020,47024,San Marcello Piteglio,PT,16,23,0,0,0,23,39,0,0,0,39
2020,47024,San Marcello Piteglio,PT,17,24,0,0,0,24,21,0,0,0,21
2020,47024,San Marcello Piteglio,PT,18,26,0,0,0,26,37,0,0,0,37
2020,47024,San Marcello Piteglio,PT,19,36,0,0,0,36,28,0,0,0,28
2020,47024,San Marcello Piteglio,PT,20,32,0,0,0,32,26,0,0,0,26
2020,47024,San Marcello Piteglio,PT,21,27,0,0,0,27,33,1,0,0,34
2020,47024,San Marcello Piteglio,PT,22,36,0,0,0,36,24,1,0,0,25
2020,47024,San Marcello Piteglio,PT,23,36,0,0,0,36,24,1,0,0,25
2020,47024,San Marcello Piteglio,PT,24,50,0,0,0,50,32,1,0,0,33
2020,47024,San Marcello Piteglio,PT,25,32,0,0,0,32,27,0,0,0,27
2020,47024,San Marcello Piteglio,PT,26,43,1,0,0,44,30,1,0,0,31
2020,47024,San Marcello Piteglio,PT,27,29,0,0,0,29,30,2,0,0,32
2020,47024,San Marcello Piteglio,PT,28,19,2,0,0,21,30,3,0,0,33
2020,47024,San Marcello Piteglio,PT,29,28,0,0,0,28,18,5,0,0,23
2020,47024,San Marcello Piteglio,PT,30,22,0,0,0,22,17,6,1,0,24
2020,47024,San Marcello Piteglio,PT,31,27,3,0,0,30,16,5,0,0,21
2020,47024,San Marcello Piteglio,PT,32,26,2,0,0,28,21,6,0,0,27
2020,47024,San Marcello Piteglio,PT,33,19,4,0,0,23,19,8,1,0,28
2020,47024,San Marcello Piteglio,PT,34,21,8,1,0,30,21,14,0,0,35
2020,47024,San Marcello Piteglio,PT,35,25,7,1,0,33,19,12,0,0,31
2020,47024,San Marcello Piteglio,PT,36,27,5,1,0,33,11,12,0,0,23
2020,47024,San Marcello Piteglio,PT,37,23,6,0,0,29,13,16,2,0,31
2020,47024,San Marcello Piteglio,PT,38,14,6,1,0,21,16,11,3,0,30
2020,47024,San Marcello Piteglio,PT,39,22,11,1,0,34,13,19,0,1,33
2020,47024,San Marcello Piteglio,PT,40,19,16,1,0,36,23,14,0,1,38
2020,47024,San Marcello Piteglio,PT,41,21,14,0,0,35,25,16,1,0,42
2020,47024,San Marcello Piteglio,PT,42,23,15,0,0,38,18,17,1,0,36
2020,47024,San Marcello Piteglio,PT,43,27,21,1,1,50,26,14,2,0,42
2020,47024,San Marcello Piteglio,PT,44,32,16,3,0,51,28,22,1,0,51
2020,47024,San Marcello Piteglio,PT,45,26,19,3,1,49,23,30,4,2,59
2020,47024,San Marcello Piteglio,PT,46,27,22,5,0,54,17,29,5,0,51
2020,47024,San Marcello Piteglio,PT,47,32,21,2,1,56,22,38,8,0,68
2020,47024,San Marcello Piteglio,PT,48,38,41,3,1,83,19,29,4,0,52
2020,47024,San Marcello Piteglio,PT,49,23,19,3,1,46,21,39,4,2,66
2020,47024,San Marcello Piteglio,PT,50,26,27,6,1,60,20,35,3,0,58
2020,47024,San Marcello Piteglio,PT,51,19,48,4,0,71,15,32,6,0,53
2020,47024,San Marcello Piteglio,PT,52,19,29,4,0,52,11,39,9,0,59
2020,47024,San Marcello Piteglio,PT,53,19,33,4,1,57,20,43,3,2,68
2020,47024,San Marcello Piteglio,PT,54,17,44,9,0,70,20,56,8,2,86
2020,47024,San Marcello Piteglio,PT,55,19,32,5,1,57,14,45,6,4,69
2020,47024,San Marcello Piteglio,PT,56,24,43,6,0,73,21,38,10,3,72
2020,47024,San Marcello Piteglio,PT,57,9,33,6,0,48,14,43,4,2,63
2020,47024,San Marcello Piteglio,PT,58,13,47,10,0,70,5,42,6,2,55
2020,47024,San Marcello Piteglio,PT,59,11,44,3,0,58,12,36,6,5,59
2020,47024,San Marcello Piteglio,PT,60,12,44,7,0,63,12,41,3,6,62
2020,47024,San Marcello Piteglio,PT,61,11,42,3,1,57,11,35,4,3,53
2020,47024,San Marcello Piteglio,PT,62,9,40,4,2,55,9,29,3,5,46
2020,47024,San Marcello Piteglio,PT,63,11,34,3,1,49,11,30,5,5,51
2020,47024,San Marcello Piteglio,PT,64,11,28,5,3,47,7,41,0,10,58
2020,47024,San Marcello Piteglio,PT,65,3,41,5,4,53,9,34,6,5,54
2020,47024,San Marcello Piteglio,PT,66,5,34,5,1,45,10,45,1,8,64
2020,47024,San Marcello Piteglio,PT,67,9,30,8,1,48,6,35,0,8,49
2020,47024,San Marcello Piteglio,PT,68,6,41,0,3,50,8,43,5,10,66
2020,47024,San Marcello Piteglio,PT,69,7,34,4,1,46,3,40,2,5,50
2020,47024,San Marcello Piteglio,PT,70,7,37,2,4,50,2,30,3,7,42
2020,47024,San Marcello Piteglio,PT,71,11,44,2,6,63,8,40,2,13,63
2020,47024,San Marcello Piteglio,PT,72,9,47,3,3,62,2,43,4,8,57
2020,47024,San Marcello Piteglio,PT,73,2,40,1,6,49,8,37,5,16,66
2020,47024,San Marcello Piteglio,PT,74,6,52,4,2,64,3,40,3,28,74
2020,47024,San Marcello Piteglio,PT,75,3,35,4,5,47,2,44,0,19,65
2020,47024,San Marcello Piteglio,PT,76,5,32,5,4,46,1,34,2,30,67
2020,47024,San Marcello Piteglio,PT,77,2,49,2,3,56,4,21,1,15,41
2020,47024,San Marcello Piteglio,PT,78,4,35,1,6,46,4,26,1,19,50
2020,47024,San Marcello Piteglio,PT,79,5,36,0,11,52,3,28,2,24,57
2020,47024,San Marcello Piteglio,PT,80,4,39,2,7,52,3,36,5,26,70
2020,47024,San Marcello Piteglio,PT,81,5,37,1,8,51,3,18,2,32,55
2020,47024,San Marcello Piteglio,PT,82,2,31,1,14,48,3,24,1,31,59
2020,47024,San Marcello Piteglio,PT,83,2,24,1,8,35,4,27,0,38,69
2020,47024,San Marcello Piteglio,PT,84,2,24,0,7,33,5,12,0,43,60
2020,47024,San Marcello Piteglio,PT,85,2,17,0,9,28,3,11,1,37,52
2020,47024,San Marcello Piteglio,PT,86,0,22,0,5,27,2,11,0,40,53
2020,47024,San Marcello Piteglio,PT,87,2,18,2,8,30,2,6,1,28,37
2020,47024,San Marcello Piteglio,PT,88,0,15,0,7,22,4,7,0,41,52
2020,47024,San Marcello Piteglio,PT,89,0,7,0,9,16,4,3,0,24,31
2020,47024,San Marcello Piteglio,PT,90,0,16,1,6,23,2,7,0,31,40
2020,47024,San Marcello Piteglio,PT,91,0,7,0,6,13,0,1,0,18,19
2020,47024,San Marcello Piteglio,PT,92,1,2,1,5,9,6,4,0,26,36
2020,47024,San Marcello Piteglio,PT,93,0,3,0,6,9,2,0,0,19,21
2020,47024,San Marcello Piteglio,PT,94,0,0,0,2,2,0,0,0,11,11
2020,47024,San Marcello Piteglio,PT,95,0,1,0,1,2,1,1,0,12,14
2020,47024,San Marcello Piteglio,PT,96,0,2,0,3,5,2,0,0,9,11
2020,47024,San Marcello Piteglio,PT,97,0,0,0,0,0,1,0,0,10,11
2020,47024,San Marcello Piteglio,PT,98,0,0,0,2,2,0,0,0,9,9
2020,47024,San Marcello Piteglio,PT,99,0,0,0,0,0,0,0,0,6,6
2020,47024,San Marcello Piteglio,PT,100 e più,0,0,0,1,1,0,0,0,7,7
2020,100001,Cantagallo,PO,0,6,0,0,0,6,6,0,0,0,6
2020,100001,Cantagallo,PO,1,10,0,0,0,10,7,0,0,0,7
2020,100001,Cantagallo,PO,2,12,0,0,0,12,5,0,0,0,5
2020,100001,Cantagallo,PO,3,10,0,0,0,10,11,0,0,0,11
2020,100001,Cantagallo,PO,4,10,0,0,0,10,10,0,0,0,10
2020,100001,Cantagallo,PO,5,13,0,0,0,13,7,0,0,0,7
2020,100001,Cantagallo,PO,6,12,0,0,0,12,14,0,0,0,14
2020,100001,Cantagallo,PO,7,10,0,0,0,10,12,0,0,0,12
2020,100001,Cantagallo,PO,8,9,0,0,0,9,13,0,0,0,13
2020,100001,Cantagallo,PO,9,15,0,0,0,15,9,0,0,0,9
2020,100001,Cantagallo,PO,10,20,0,0,0,20,17,0,0,0,17
2020,100001,Cantagallo,PO,11,20,0,0,0,20,9,0,0,0,9
2020,100001,Cantagallo,PO,12,21,0,0,0,21,21,0,0,0,21
2020,100001,Cantagallo,PO,13,11,0,0,0,11,14,0,0,0,14
2020,100001,Cantagallo,PO,14,19,0,0,0,19,15,0,0,0,15
2020,100001,Cantagallo,PO,15,15,0,0,0,15,14,0,0,0,14
2020,100001,Cantagallo,PO,16,9,0,0,0,9,7,0,0,0,7
2020,100001,Cantagallo,PO,17,13,0,0,0,13,18,0,0,0,18
2020,100001,Cantagallo,PO,18,17,0,0,0,17,9,0,0,0,9
2020,100001,Cantagallo,PO,19,9,0,0,0,9,10,0,0,0,10
2020,100001,Cantagallo,PO,20,18,0,0,0,18,17,0,0,0,17
2020,100001,Cantagallo,PO,21,15,0,0,0,15,10,0,0,0,10
2020,100001,Cantagallo,PO,22,19,0,0,0,19,13,1,0,0,14
2020,100001,Cantagallo,PO,23,14,0,0,0,14,12,0,0,0,12
2020,100001,Cantagallo,PO,24,14,0,0,0,14,8,0,0,0,8
2020,100001,Cantagallo,PO,25,17,0,0,0,17,10,0,0,0,10
2020,100001,Cantagallo,PO,26,11,0,0,0,11,9,0,0,0,9
2020,100001,Cantagallo,PO,27,15,0,0,0,15,8,0,0,0,8
2020,100001,Cantagallo,PO,28,16,0,0,0,16,14,4,0,0,18
2020,100001,Cantagallo,PO,29,12,0,0,0,12,5,0,0,0,5
2020,100001,Cantagallo,PO,30,17,4,0,0,21,5,1,0,0,6
2020,100001,Cantagallo,PO,31,16,0,0,0,16,3,3,0,0,6
2020,100001,Cantagallo,PO,32,7,2,0,0,9,7,3,0,0,10
2020,100001,Cantagallo,PO,33,9,3,0,0,12,4,5,0,0,9
2020,100001,Cantagallo,PO,34,14,1,0,0,15,15,6,0,0,21
2020,100001,Cantagallo,PO,35,11,1,1,0,13,5,9,0,0,14
2020,100001,Cantagallo,PO,36,12,6,0,0,18,13,9,0,0,22
2020,100001,Cantagallo,PO,37,10,3,0,0,13,11,9,1,0,21
2020,100001,Cantagallo,PO,38,14,12,0,0,26,7,8,0,1,16
2020,100001,Cantagallo,PO,39,9,4,0,0,13,9,12,0,0,21
2020,100001,Cantagallo,PO,40,10,12,0,0,22,10,13,0,0,23
2020,100001,Cantagallo,PO,41,12,6,0,0,18,4,13,0,0,17
2020,100001,Cantagallo,PO,42,3,11,1,0,15,7,10,1,1,19
2020,100001,Cantagallo,PO,43,8,15,1,0,24,16,20,2,0,38
2020,100001,Cantagallo,PO,44,17,8,2,0,27,5,24,0,0,29
2020,100001,Cantagallo,PO,45,10,11,1,1,23,4,9,0,0,13
2020,100001,Cantagallo,PO,46,12,17,2,0,31,6,22,3,0,31
2020,100001,Cantagallo,PO,47,17,19,1,0,37,8,23,6,0,37
2020,100001,Cantagallo,PO,48,13,11,2,0,26,15,17,0,0,32
2020,100001,Cantagallo,PO,49,9,19,1,0,29,7,13,3,0,23
2020,100001,Cantagallo,PO,50,9,25,0,0,34,0,12,1,0,13
2020,100001,Cantagallo,PO,51,7,20,3,0,30,6,18,2,0,26
2020,100001,Cantagallo,PO,52,10,18,2,0,30,4,22,3,0,29
2020,100001,Cantagallo,PO,53,4,28,3,0,35,1,22,2,1,26
2020,100001,Cantagallo,PO,54,6,22,3,0,31,2,17,1,0,20
2020,100001,Cantagallo,PO,55,4,31,1,0,36,4,21,6,2,33
2020,100001,Cantagallo,PO,56,3,25,1,0,29,1,17,2,1,21
2020,100001,Cantagallo,PO,57,6,20,1,0,27,4,23,4,2,33
2020,100001,Cantagallo,PO,58,3,14,2,0,19,5,11,3,0,19
2020,100001,Cantagallo,PO,59,2,12,4,0,18,3,17,3,1,24
2020,100001,Cantagallo,PO,60,2,19,0,0,21,2,17,1,1,21
2020,100001,Cantagallo,PO,61,4,20,3,2,29,4,19,1,0,24
2020,100001,Cantagallo,PO,62,3,19,2,0,24,2,22,1,0,25
2020,100001,Cantagallo,PO,63,1,13,6,1,21,2,13,2,2,19
2020,100001,Cantagallo,PO,64,2,19,3,1,25,4,11,0,1,16
2020,100001,Cantagallo,PO,65,1,21,1,0,23,0,16,1,3,20
2020,100001,Cantagallo,PO,66,0,13,0,1,14,0,19,0,3,22
2020,100001,Cantagallo,PO,67,0,18,2,1,21,1,12,0,2,15
2020,100001,Cantagallo,PO,68,6,12,1,1,20,1,13,0,6,20
2020,100001,Cantagallo,PO,69,2,12,1,2,17,0,14,0,4,18
2020,100001,Cantagallo,PO,70,3,18,1,0,22,0,11,1,2,14
2020,100001,Cantagallo,PO,71,1,11,3,0,15,1,13,0,2,16
2020,100001,Cantagallo,PO,72,4,16,1,1,22,2,10,0,6,18
2020,100001,Cantagallo,PO,73,0,18,1,0,19,2,15,0,4,21
2020,100001,Cantagallo,PO,74,2,10,1,3,16,3,9,1,6,19
2020,100001,Cantagallo,PO,75,1,10,0,0,11,1,7,0,4,12
2020,100001,Cantagallo,PO,76,1,11,0,2,14,0,9,0,4,13
2020,100001,Cantagallo,PO,77,0,11,0,1,12,0,8,0,6,14
2020,100001,Cantagallo,PO,78,1,10,1,3,15,0,10,0,5,15
2020,100001,Cantagallo,PO,79,1,11,0,0,12,0,9,0,7,16
2020,100001,Cantagallo,PO,80,5,12,0,3,20,0,4,0,11,15
2020,100001,Cantagallo,PO,81,0,15,0,5,20,0,6,0,2,8
2020,100001,Cantagallo,PO,82,1,5,1,2,9,1,10,1,5,17
2020,100001,Cantagallo,PO,83,4,11,0,2,17,1,4,0,5,10
2020,100001,Cantagallo,PO,84,0,5,0,7,12,0,4,0,10,14
2020,100001,Cantagallo,PO,85,4,5,1,3,13,1,1,0,7,9
2020,100001,Cantagallo,PO,86,0,6,0,2,8,0,3,0,9,12
2020,100001,Cantagallo,PO,87,1,0,0,1,2,1,1,0,4,6
2020,100001,Cantagallo,PO,88,0,6,0,2,8,0,2,0,8,10
2020,100001,Cantagallo,PO,89,0,5,1,0,6,0,0,0,6,6
2020,100001,Cantagallo,PO,90,1,3,0,0,4,0,0,0,5,5
2020,100001,Cantagallo,PO,91,1,2,0,1,4,0,0,0,5,5
2020,100001,Cantagallo,PO,92,0,0,0,0,0,0,2,0,2,4
2020,100001,Cantagallo,PO,93,0,0,0,2,2,0,0,0,3,3
2020,100001,Cantagallo,PO,94,0,0,0,1,1,0,1,0,2,3
2020,100001,Cantagallo,PO,95,0,0,0,1,1,0,0,0,3,3
2020,100001,Cantagallo,PO,96,0,1,0,0,1,0,0,0,3,3
2020,100001,Cantagallo,PO,97,0,0,0,0,0,0,0,0,4,4
2020,100001,Cantagallo,PO,98,0,0,0,0,0,1,0,0,4,5
2020,100001,Cantagallo,PO,99,0,0,0,1,1,0,0,0,0,0
2020,100001,Cantagallo,PO,100 e più,0,0,0,0,0,0,0,0,0,0
2020,100002,Carmignano,PO,0,44,0,0,0,44,47,0,0,0,47
2020,100002,Carmignano,PO,1,58,0,0,0,58,45,0,0,0,45
2020,100002,Carmignano,PO,2,61,0,0,0,61,48,0,0,0,48
2020,100002,Carmignano,PO,3,68,0,0,0,68,62,0,0,0,62
2020,100002,Carmignano,PO,4,60,0,0,0,60,66,0,0,0,66
2020,100002,Carmignano,PO,5,70,0,0,0,70,60,0,0,0,60
2020,100002,Carmignano,PO,6,67,0,0,0,67,56,0,0,0,56
2020,100002,Carmignano,PO,7,59,0,0,0,59,83,0,0,0,83
2020,100002,Carmignano,PO,8,71,0,0,0,71,57,0,0,0,57
2020,100002,Carmignano,PO,9,73,0,0,0,73,62,0,0,0,62
2020,100002,Carmignano,PO,10,86,0,0,0,86,68,0,0,0,68
2020,100002,Carmignano,PO,11,103,0,0,0,103,85,0,0,0,85
2020,100002,Carmignano,PO,12,97,0,0,0,97,79,0,0,0,79
2020,100002,Carmignano,PO,13,90,0,0,0,90,79,0,0,0,79
2020,100002,Carmignano,PO,14,82,0,0,0,82,93,0,0,0,93
2020,100002,Carmignano,PO,15,76,0,0,0,76,92,0,0,0,92
2020,100002,Carmignano,PO,16,83,0,0,0,83,71,0,0,0,71
2020,100002,Carmignano,PO,17,71,0,0,0,71,88,0,0,0,88
2020,100002,Carmignano,PO,18,92,0,0,0,92,83,0,0,0,83
2020,100002,Carmignano,PO,19,84,0,0,0,84,69,0,0,0,69
2020,100002,Carmignano,PO,20,72,0,0,0,72,70,0,0,0,70
2020,100002,Carmignano,PO,21,72,0,0,0,72,64,0,0,0,64
2020,100002,Carmignano,PO,22,77,0,0,0,77,59,0,0,0,59
2020,100002,Carmignano,PO,23,65,0,0,0,65,60,2,0,0,62
2020,100002,Carmignano,PO,24,73,0,0,0,73,74,4,0,0,78
2020,100002,Carmignano,PO,25,62,0,0,0,62,55,3,1,0,59
2020,100002,Carmignano,PO,26,62,1,0,0,63,47,2,0,0,49
2020,100002,Carmignano,PO,27,68,3,0,0,71,43,4,0,0,47
2020,100002,Carmignano,PO,28,79,2,0,0,81,60,8,0,0,68
2020,100002,Carmignano,PO,29,66,7,0,0,73,42,18,2,0,62
2020,100002,Carmignano,PO,30,59,5,0,0,64,49,12,0,0,61
2020,100002,Carmignano,PO,31,61,14,0,0,75,60,16,0,0,76
2020,100002,Carmignano,PO,32,55,15,0,0,70,39,22,1,0,62
2020,100002,Carmignano,PO,33,66,10,1,0,77,52,33,0,0,85
2020,100002,Carmignano,PO,34,57,23,0,0,80,45,33,0,0,78
2020,100002,Carmignano,PO,35,60,25,0,0,85,48,48,3,0,99
2020,100002,Carmignano,PO,36,55,30,2,0,87,44,64,2,0,110
2020,100002,Carmignano,PO,37,66,34,2,0,102,34,60,1,0,95
2020,100002,Carmignano,PO,38,59,55,6,0,120,69,51,3,0,123
2020,100002,Carmignano,PO,39,57,64,0,0,121,47,68,4,0,119
2020,100002,Carmignano,PO,40,40,73,2,0,115,33,56,0,2,91
2020,100002,Carmignano,PO,41,46,51,4,0,101,41,80,12,0,133
2020,100002,Carmignano,PO,42,40,68,3,0,111,42,65,7,2,116
2020,100002,Carmignano,PO,43,51,64,1,0,116,39,88,5,0,132
2020,100002,Carmignano,PO,44,54,86,3,0,143,37,84,3,1,125
2020,100002,Carmignano,PO,45,57,87,4,2,150,48,97,13,0,158
2020,100002,Carmignano,PO,46,53,88,6,0,147,37,107,12,2,158
2020,100002,Carmignano,PO,47,53,77,6,0,136,34,104,10,1,149
2020,100002,Carmignano,PO,48,39,85,8,1,133,26,112,14,1,153
2020,100002,Carmignano,PO,49,36,120,7,0,163,35,91,9,1,136
2020,100002,Carmignano,PO,50,39,91,12,0,142,21,83,6,0,110
2020,100002,Carmignano,PO,51,32,104,10,0,146,17,100,13,2,132
2020,100002,Carmignano,PO,52,24,89,9,0,122,21,102,3,2,128
2020,100002,Carmignano,PO,53,20,94,11,2,127,12,98,3,1,114
2020,100002,Carmignano,PO,54,25,98,5,0,128,16,102,8,6,132
2020,100002,Carmignano,PO,55,24,108,11,0,143,12,102,6,1,121
2020,100002,Carmignano,PO,56,10,91,8,0,109,9,90,4,2,105
2020,100002,Carmignano,PO,57,18,92,10,1,121,9,108,13,6,136
2020,100002,Carmignano,PO,58,10,105,11,1,127,14,93,10,7,124
2020,100002,Carmignano,PO,59,6,88,11,1,106,14,72,12,3,101
2020,100002,Carmignano,PO,60,13,84,8,1,106,7,67,5,3,82
2020,100002,Carmignano,PO,61,13,69,5,3,90,3,74,4,8,89
2020,100002,Carmignano,PO,62,3,62,7,4,76,4,67,6,6,83
2020,100002,Carmignano,PO,63,5,84,6,0,95,3,74,2,10,89
2020,100002,Carmignano,PO,64,8,72,3,1,84,5,66,2,8,81
2020,100002,Carmignano,PO,65,8,72,5,3,88,8,85,3,7,103
2020,100002,Carmignano,PO,66,8,69,6,4,87,4,76,5,11,96
2020,100002,Carmignano,PO,67,6,71,2,6,85,2,57,7,19,85
2020,100002,Carmignano,PO,68,3,63,3,2,71,1,67,6,6,80
2020,100002,Carmignano,PO,69,4,59,4,5,72,5,50,2,14,71
2020,100002,Carmignano,PO,70,3,72,3,8,86,5,66,2,17,90
2020,100002,Carmignano,PO,71,4,69,4,4,81,4,56,3,12,75
2020,100002,Carmignano,PO,72,8,60,2,3,73,2,57,3,12,74
2020,100002,Carmignano,PO,73,7,59,3,6,75,2,40,1,24,67
2020,100002,Carmignano,PO,74,5,78,1,5,89,4,53,2,20,79
2020,100002,Carmignano,PO,75,3,36,1,2,42,3,43,1,19,66
2020,100002,Carmignano,PO,76,3,41,0,10,54,4,33,2,22,61
2020,100002,Carmignano,PO,77,8,33,1,8,50,3,33,2,30,68
2020,100002,Carmignano,PO,78,5,51,0,6,62,2,30,3,20,55
2020,100002,Carmignano,PO,79,2,38,1,8,49,1,38,1,17,57
2020,100002,Carmignano,PO,80,5,47,1,4,57,3,21,1,28,53
2020,100002,Carmignano,PO,81,6,30,0,5,41,1,26,1,23,51
2020,100002,Carmignano,PO,82,3,36,0,10,49,2,21,0,32,55
2020,100002,Carmignano,PO,83,2,27,2,1,32,2,19,1,25,47
2020,100002,Carmignano,PO,84,1,19,0,8,28,2,10,1,24,37
2020,100002,Carmignano,PO,85,4,25,0,9,38,1,8,1,27,37
2020,100002,Carmignano,PO,86,0,9,0,6,15,0,4,0,29,33
2020,100002,Carmignano,PO,87,2,13,1,3,19,4,4,1,22,31
2020,100002,Carmignano,PO,88,3,9,1,8,21,5,3,1,17,26
2020,100002,Carmignano,PO,89,0,3,0,2,5,0,10,0,26,36
2020,100002,Carmignano,PO,90,0,6,0,2,8,1,2,0,17,20
2020,100002,Carmignano,PO,91,0,7,0,4,11,1,1,0,17,19
2020,100002,Carmignano,PO,92,2,3,1,6,12,2,2,0,25,29
2020,100002,Carmignano,PO,93,0,0,0,4,4,0,2,0,10,12
2020,100002,Carmignano,PO,94,0,0,0,3,3,2,1,0,14,17
2020,100002,Carmignano,PO,95,0,1,0,1,2,1,0,0,8,9
2020,100002,Carmignano,PO,96,0,0,0,1,1,1,0,0,9,10
2020,100002,Carmignano,PO,97,0,1,0,0,1,0,1,0,6,7
2020,100002,Carmignano,PO,98,0,0,0,0,0,0,0,0,6,6
2020,100002,Carmignano,PO,99,0,0,0,1,1,0,0,0,4,4
2020,100002,Carmignano,PO,100 e più,0,0,0,0,0,0,0,0,1,1
2020,100003,Montemurlo,PO,0,79,0,0,0,79,64,0,0,0,64
2020,100003,Montemurlo,PO,1,65,0,0,0,65,56,0,0,0,56
2020,100003,Montemurlo,PO,2,75,0,0,0,75,67,0,0,0,67
2020,100003,Montemurlo,PO,3,76,0,0,0,76,94,0,0,0,94
2020,100003,Montemurlo,PO,4,78,0,0,0,78,102,0,0,0,102
2020,100003,Montemurlo,PO,5,100,0,0,0,100,73,0,0,0,73
2020,100003,Montemurlo,PO,6,93,0,0,0,93,83,0,0,0,83
2020,100003,Montemurlo,PO,7,71,0,0,0,71,76,0,0,0,76
2020,100003,Montemurlo,PO,8,102,0,0,0,102,91,0,0,0,91
2020,100003,Montemurlo,PO,9,89,0,0,0,89,96,0,0,0,96
2020,100003,Montemurlo,PO,10,100,0,0,0,100,101,0,0,0,101
2020,100003,Montemurlo,PO,11,101,0,0,0,101,96,0,0,0,96
2020,100003,Montemurlo,PO,12,105,0,0,0,105,89,0,0,0,89
2020,100003,Montemurlo,PO,13,103,0,0,0,103,99,0,0,0,99
2020,100003,Montemurlo,PO,14,101,0,0,0,101,125,0,0,0,125
2020,100003,Montemurlo,PO,15,92,0,0,0,92,86,0,0,0,86
2020,100003,Montemurlo,PO,16,110,0,0,0,110,85,0,0,0,85
2020,100003,Montemurlo,PO,17,106,0,0,0,106,88,0,0,0,88
2020,100003,Montemurlo,PO,18,92,0,0,0,92,70,0,0,0,70
2020,100003,Montemurlo,PO,19,99,0,0,0,99,108,1,0,0,109
2020,100003,Montemurlo,PO,20,89,0,0,0,89,90,0,0,0,90
2020,100003,Montemurlo,PO,21,90,0,0,0,90,84,6,0,0,90
2020,100003,Montemurlo,PO,22,113,1,0,0,114,82,4,0,0,86
2020,100003,Montemurlo,PO,23,99,1,0,0,100,74,8,0,0,82
2020,100003,Montemurlo,PO,24,94,1,0,0,95,75,13,0,0,88
2020,100003,Montemurlo,PO,25,84,2,0,0,86,67,8,1,0,76
2020,100003,Montemurlo,PO,26,75,3,0,0,78,73,10,0,0,83
2020,100003,Montemurlo,PO,27,104,5,0,0,109,91,20,0,0,111
2020,100003,Montemurlo,PO,28,85,8,0,0,93,69,11,0,0,80
2020,100003,Montemurlo,PO,29,79,19,0,0,98,59,29,0,0,88
2020,100003,Montemurlo,PO,30,99,24,0,0,123,57,31,1,0,89
2020,100003,Montemurlo,PO,31,85,23,0,0,108,63,40,2,0,105
2020,100003,Montemurlo,PO,32,100,25,0,0,125,70,30,1,0,101
2020,100003,Montemurlo,PO,33,73,36,2,0,111,53,54,1,1,109
2020,100003,Montemurlo,PO,34,83,54,1,0,138,46,49,3,0,98
2020,100003,Montemurlo,PO,35,85,48,0,0,133,54,78,0,0,132
2020,100003,Montemurlo,PO,36,62,57,2,0,121,39,70,4,1,114
2020,100003,Montemurlo,PO,37,67,52,0,0,119,67,69,3,1,140
2020,100003,Montemurlo,PO,38,69,65,1,0,135,44,92,7,1,144
2020,100003,Montemurlo,PO,39,63,76,4,0,143,50,83,1,2,136
2020,100003,Montemurlo,PO,40,55,78,3,0,136,43,78,3,0,124
2020,100003,Montemurlo,PO,41,65,72,3,0,140,44,91,10,2,147
2020,100003,Montemurlo,PO,42,55,70,8,0,133,40,82,7,1,130
2020,100003,Montemurlo,PO,43,54,82,5,0,141,30,108,12,0,150
2020,100003,Montemurlo,PO,44,59,96,6,0,161,42,104,6,0,152
2020,100003,Montemurlo,PO,45,61,91,6,1,159,39,104,6,2,151
2020,100003,Montemurlo,PO,46,39,107,4,0,150,28,124,15,1,168
2020,100003,Montemurlo,PO,47,47,115,9,0,171,29,101,12,3,145
2020,100003,Montemurlo,PO,48,31,113,6,2,152,28,90,15,3,136
2020,100003,Montemurlo,PO,49,44,120,8,0,172,18,115,11,1,145
2020,100003,Montemurlo,PO,50,40,112,9,1,162,26,120,13,1,160
2020,100003,Montemurlo,PO,51,26,115,9,0,150,16,131,12,2,161
2020,100003,Montemurlo,PO,52,24,116,6,1,147,18,128,19,6,171
2020,100003,Montemurlo,PO,53,31,109,9,2,151,19,119,15,5,158
2020,100003,Montemurlo,PO,54,25,126,14,0,165,17,108,7,2,134
2020,100003,Montemurlo,PO,55,22,118,13,2,155,5,127,17,10,159
2020,100003,Montemurlo,PO,56,16,120,13,2,151,14,122,12,0,148
2020,100003,Montemurlo,PO,57,12,106,11,0,129,7,96,9,2,114
2020,100003,Montemurlo,PO,58,7,123,7,1,138,12,131,9,7,159
2020,100003,Montemurlo,PO,59,4,125,6,1,136,7,116,14,10,147
2020,100003,Montemurlo,PO,60,8,87,6,1,102,12,113,6,9,140
2020,100003,Montemurlo,PO,61,7,101,8,2,118,6,95,10,8,119
2020,100003,Montemurlo,PO,62,7,101,7,2,117,2,96,1,11,110
2020,100003,Montemurlo,PO,63,7,103,7,4,121,5,110,5,11,131
2020,100003,Montemurlo,PO,64,8,99,7,7,121,3,93,6,19,121
2020,100003,Montemurlo,PO,65,8,100,7,4,119,3,103,5,16,127
2020,100003,Montemurlo,PO,66,1,96,7,7,111,7,100,10,16,133
2020,100003,Montemurlo,PO,67,4,76,1,3,84,3,77,2,11,93
2020,100003,Montemurlo,PO,68,5,85,7,7,104,4,69,6,13,92
2020,100003,Montemurlo,PO,69,6,84,3,5,98,4,88,1,22,115
2020,100003,Montemurlo,PO,70,6,92,0,6,104,6,90,4,17,117
2020,100003,Montemurlo,PO,71,4,94,0,5,103,2,87,2,33,124
2020,100003,Montemurlo,PO,72,3,90,2,3,98,0,87,3,34,124
2020,100003,Montemurlo,PO,73,1,83,0,6,90,4,83,3,17,107
2020,100003,Montemurlo,PO,74,2,88,0,9,99,2,90,3,25,120
2020,100003,Montemurlo,PO,75,3,75,1,2,81,0,56,0,26,82
2020,100003,Montemurlo,PO,76,2,74,2,7,85,1,57,2,39,99
2020,100003,Montemurlo,PO,77,3,69,0,6,78,0,55,2,38,95
2020,100003,Montemurlo,PO,78,2,69,1,7,79,4,46,1,46,97
2020,100003,Montemurlo,PO,79,2,56,0,5,63,1,40,1,28,70
2020,100003,Montemurlo,PO,80,5,64,1,8,78,1,59,6,30,96
2020,100003,Montemurlo,PO,81,5,68,0,8,81,1,56,2,48,107
2020,100003,Montemurlo,PO,82,0,73,0,13,86,2,42,0,60,104
2020,100003,Montemurlo,PO,83,2,45,1,6,54,0,28,3,57,88
2020,100003,Montemurlo,PO,84,2,46,1,11,60,0,17,1,49,67
2020,100003,Montemurlo,PO,85,3,33,1,7,44,1,22,0,40,63
2020,100003,Montemurlo,PO,86,1,34,1,8,44,1,17,0,37,55
2020,100003,Montemurlo,PO,87,1,25,0,11,37,0,17,0,37,54
2020,100003,Montemurlo,PO,88,0,16,1,14,31,0,10,0,36,46
2020,100003,Montemurlo,PO,89,1,20,0,6,27,1,6,0,39,46
2020,100003,Montemurlo,PO,90,1,18,0,6,25,2,3,0,31,36
2020,100003,Montemurlo,PO,91,1,16,1,5,23,0,4,0,26,30
2020,100003,Montemurlo,PO,92,1,7,1,5,14,0,0,0,17,17
2020,100003,Montemurlo,PO,93,1,6,0,5,12,0,1,0,13,14
2020,100003,Montemurlo,PO,94,0,1,0,4,5,0,1,0,15,16
2020,100003,Montemurlo,PO,95,1,1,0,4,6,0,0,0,5,5
2020,100003,Montemurlo,PO,96,0,0,0,1,1,0,0,0,7,7
2020,100003,Montemurlo,PO,97,0,0,0,0,0,0,0,0,5,5
2020,100003,Montemurlo,PO,98,0,1,0,0,1,0,0,0,3,3
2020,100003,Montemurlo,PO,99,0,0,0,0,0,0,0,0,3,3
2020,100003,Montemurlo,PO,100 e più,0,0,0,0,0,0,0,0,0,0
2020,100004,Poggio a Caiano,PO,0,23,0,0,0,23,27,0,0,0,27
2020,100004,Poggio a Caiano,PO,1,31,0,0,0,31,23,0,0,0,23
2020,100004,Poggio a Caiano,PO,2,36,0,0,0,36,24,0,0,0,24
2020,100004,Poggio a Caiano,PO,3,39,0,0,0,39,41,0,0,0,41
2020,100004,Poggio a Caiano,PO,4,49,0,0,0,49,37,0,0,0,37
2020,100004,Poggio a Caiano,PO,5,54,0,0,0,54,37,0,0,0,37
2020,100004,Poggio a Caiano,PO,6,62,0,0,0,62,55,0,0,0,55
2020,100004,Poggio a Caiano,PO,7,45,0,0,0,45,46,0,0,0,46
2020,100004,Poggio a Caiano,PO,8,53,0,0,0,53,45,0,0,0,45
2020,100004,Poggio a Caiano,PO,9,52,0,0,0,52,63,0,0,0,63
2020,100004,Poggio a Caiano,PO,10,66,0,0,0,66,53,0,0,0,53
2020,100004,Poggio a Caiano,PO,11,62,0,0,0,62,61,0,0,0,61
2020,100004,Poggio a Caiano,PO,12,71,0,0,0,71,54,0,0,0,54
2020,100004,Poggio a Caiano,PO,13,52,0,0,0,52,44,0,0,0,44
2020,100004,Poggio a Caiano,PO,14,58,0,0,0,58,70,0,0,0,70
2020,100004,Poggio a Caiano,PO,15,58,0,0,0,58,65,0,0,0,65
2020,100004,Poggio a Caiano,PO,16,40,0,0,0,40,45,0,0,0,45
2020,100004,Poggio a Caiano,PO,17,56,0,0,0,56,57,0,0,0,57
2020,100004,Poggio a Caiano,PO,18,51,0,0,0,51,45,0,0,0,45
2020,100004,Poggio a Caiano,PO,19,37,0,0,0,37,36,0,0,0,36
2020,100004,Poggio a Caiano,PO,20,50,0,0,0,50,47,0,0,0,47
2020,100004,Poggio a Caiano,PO,21,50,0,0,0,50,41,0,0,0,41
2020,100004,Poggio a Caiano,PO,22,51,0,0,0,51,35,0,0,0,35
2020,100004,Poggio a Caiano,PO,23,50,0,0,0,50,41,0,0,0,41
2020,100004,Poggio a Caiano,PO,24,40,0,0,0,40,37,0,0,0,37
2020,100004,Poggio a Caiano,PO,25,50,1,0,0,51,41,3,0,0,44
2020,100004,Poggio a Caiano,PO,26,39,1,0,0,40,39,2,0,0,41
2020,100004,Poggio a Caiano,PO,27,54,2,0,0,56,38,3,0,0,41
2020,100004,Poggio a Caiano,PO,28,44,2,0,0,46,48,5,0,0,53
2020,100004,Poggio a Caiano,PO,29,51,3,0,0,54,39,9,0,0,48
2020,100004,Poggio a Caiano,PO,30,52,5,0,0,57,35,10,0,0,45
2020,100004,Poggio a Caiano,PO,31,54,10,0,0,64,36,21,0,0,57
2020,100004,Poggio a Caiano,PO,32,29,10,0,0,39,35,19,0,0,54
2020,100004,Poggio a Caiano,PO,33,42,9,0,0,51,28,13,2,0,43
2020,100004,Poggio a Caiano,PO,34,35,19,2,0,56,29,22,0,0,51
2020,100004,Poggio a Caiano,PO,35,22,23,0,0,45,32,25,0,0,57
2020,100004,Poggio a Caiano,PO,36,29,24,0,0,53,37,29,2,0,68
2020,100004,Poggio a Caiano,PO,37,40,30,1,0,71,23,31,2,0,56
2020,100004,Poggio a Caiano,PO,38,36,25,0,0,61,25,39,2,0,66
2020,100004,Poggio a Caiano,PO,39,28,44,3,0,75,24,55,1,0,80
2020,100004,Poggio a Caiano,PO,40,33,32,1,0,66,28,48,3,1,80
2020,100004,Poggio a Caiano,PO,41,28,36,0,0,64,20,48,1,1,70
2020,100004,Poggio a Caiano,PO,42,43,39,1,0,83,30,52,5,1,88
2020,100004,Poggio a Caiano,PO,43,15,45,6,0,66,27,61,3,0,91
2020,100004,Poggio a Caiano,PO,44,24,59,3,0,86,22,55,8,1,86
2020,100004,Poggio a Caiano,PO,45,33,45,4,0,82,19,60,6,1,86
2020,100004,Poggio a Caiano,PO,46,28,58,0,0,86,11,55,6,1,73
2020,100004,Poggio a Caiano,PO,47,25,54,3,0,82,22,66,1,2,91
2020,100004,Poggio a Caiano,PO,48,21,73,7,0,101,15,46,5,1,67
2020,100004,Poggio a Caiano,PO,49,16,62,6,0,84,17,67,2,1,87
2020,100004,Poggio a Caiano,PO,50,26,50,2,0,78,13,62,5,1,81
2020,100004,Poggio a Caiano,PO,51,23,69,5,1,98,18,56,7,4,85
2020,100004,Poggio a Caiano,PO,52,15,62,5,1,83,11,61,6,1,79
2020,100004,Poggio a Caiano,PO,53,12,50,4,0,66,9,61,5,3,78
2020,100004,Poggio a Caiano,PO,54,15,65,1,0,81,13,70,13,2,98
2020,100004,Poggio a Caiano,PO,55,9,52,7,1,69,8,53,6,4,71
2020,100004,Poggio a Caiano,PO,56,10,61,5,1,77,11,59,8,3,81
2020,100004,Poggio a Caiano,PO,57,10,59,4,1,74,6,49,10,5,70
2020,100004,Poggio a Caiano,PO,58,6,55,4,0,65,4,62,8,5,79
2020,100004,Poggio a Caiano,PO,59,4,52,5,2,63,9,58,8,1,76
2020,100004,Poggio a Caiano,PO,60,3,48,4,0,55,4,44,3,5,56
2020,100004,Poggio a Caiano,PO,61,7,52,6,1,66,2,55,5,3,65
2020,100004,Poggio a Caiano,PO,62,6,45,3,1,55,6,60,5,1,72
2020,100004,Poggio a Caiano,PO,63,4,52,3,5,64,6,64,3,4,77
2020,100004,Poggio a Caiano,PO,64,1,47,5,1,54,5,40,1,5,51
2020,100004,Poggio a Caiano,PO,65,4,57,4,0,65,3,62,2,7,74
2020,100004,Poggio a Caiano,PO,66,2,48,3,3,56,2,47,3,5,57
2020,100004,Poggio a Caiano,PO,67,6,38,4,2,50,2,64,2,8,76
2020,100004,Poggio a Caiano,PO,68,2,53,1,3,59,3,49,3,9,64
2020,100004,Poggio a Caiano,PO,69,4,64,1,3,72,7,61,2,11,81
2020,100004,Poggio a Caiano,PO,70,3,47,2,4,56,3,51,1,7,62
2020,100004,Poggio a Caiano,PO,71,5,54,0,2,61,2,41,3,10,56
2020,100004,Poggio a Caiano,PO,72,3,51,1,7,62,7,45,2,12,66
2020,100004,Poggio a Caiano,PO,73,1,47,1,3,52,1,51,0,31,83
2020,100004,Poggio a Caiano,PO,74,3,49,0,2,54,1,40,1,18,60
2020,100004,Poggio a Caiano,PO,75,1,38,0,3,42,1,30,2,16,49
2020,100004,Poggio a Caiano,PO,76,1,40,0,0,41,4,29,0,17,50
2020,100004,Poggio a Caiano,PO,77,1,40,0,2,43,1,37,0,17,55
2020,100004,Poggio a Caiano,PO,78,3,31,1,5,40,2,19,0,17,38
2020,100004,Poggio a Caiano,PO,79,2,36,0,4,42,2,21,0,16,39
2020,100004,Poggio a Caiano,PO,80,3,29,0,3,35,0,21,0,25,46
2020,100004,Poggio a Caiano,PO,81,2,29,0,10,41,2,16,1,22,41
2020,100004,Poggio a Caiano,PO,82,2,26,1,6,35,4,22,0,27,53
2020,100004,Poggio a Caiano,PO,83,1,24,1,2,28,1,14,1,22,38
2020,100004,Poggio a Caiano,PO,84,1,18,0,5,24,2,15,0,17,34
2020,100004,Poggio a Caiano,PO,85,1,13,0,6,20,2,9,0,15,26
2020,100004,Poggio a Caiano,PO,86,1,5,0,4,10,4,5,0,15,24
2020,100004,Poggio a Caiano,PO,87,0,13,0,0,13,3,7,1,16,27
2020,100004,Poggio a Caiano,PO,88,3,7,0,1,11,6,4,1,21,32
2020,100004,Poggio a Caiano,PO,89,0,9,0,1,10,2,3,0,17,22
2020,100004,Poggio a Caiano,PO,90,0,9,0,3,12,4,3,0,11,18
2020,100004,Poggio a Caiano,PO,91,0,1,0,1,2,0,1,0,18,19
2020,100004,Poggio a Caiano,PO,92,0,5,0,3,8,0,0,0,8,8
2020,100004,Poggio a Caiano,PO,93,0,2,0,3,5,0,1,0,7,8
2020,100004,Poggio a Caiano,PO,94,0,2,0,2,4,1,3,0,8,12
2020,100004,Poggio a Caiano,PO,95,0,2,0,1,3,0,0,0,6,6
2020,100004,Poggio a Caiano,PO,96,0,1,0,1,2,0,1,0,4,5
2020,100004,Poggio a Caiano,PO,97,0,0,0,1,1,0,0,0,3,3
2020,100004,Poggio a Caiano,PO,98,0,0,0,0,0,0,0,0,0,0
2020,100004,Poggio a Caiano,PO,99,0,0,0,0,0,0,0,0,0,0
2020,100004,Poggio a Caiano,PO,100 e più,0,0,0,1,1,0,0,0,3,3
2020,100005,Prato,PO,0,676,0,0,0,676,608,0,0,0,608
2020,100005,Prato,PO,1,730,0,0,0,730,671,0,0,0,671
2020,100005,Prato,PO,2,769,0,0,0,769,741,0,0,0,741
2020,100005,Prato,PO,3,866,0,0,0,866,760,0,0,0,760
2020,100005,Prato,PO,4,873,0,0,0,873,823,0,0,0,823
2020,100005,Prato,PO,5,853,0,0,0,853,822,0,0,0,822
2020,100005,Prato,PO,6,934,0,0,0,934,851,0,0,0,851
2020,100005,Prato,PO,7,946,0,0,0,946,849,0,0,0,849
2020,100005,Prato,PO,8,980,0,0,0,980,950,0,0,0,950
2020,100005,Prato,PO,9,988,0,0,0,988,922,0,0,0,922
2020,100005,Prato,PO,10,1083,0,0,0,1083,951,0,0,0,951
2020,100005,Prato,PO,11,1024,0,0,0,1024,938,0,0,0,938
2020,100005,Prato,PO,12,1086,0,0,0,1086,1022,0,0,0,1022
2020,100005,Prato,PO,13,1087,0,0,0,1087,1016,0,0,0,1016
2020,100005,Prato,PO,14,1123,0,0,0,1123,994,0,0,0,994
2020,100005,Prato,PO,15,1145,0,0,0,1145,996,0,0,0,996
2020,100005,Prato,PO,16,1009,0,0,0,1009,1007,0,0,0,1007
2020,100005,Prato,PO,17,1030,0,0,0,1030,923,0,0,0,923
2020,100005,Prato,PO,18,1006,0,0,0,1006,953,0,0,0,953
2020,100005,Prato,PO,19,1028,0,0,0,1028,893,5,0,0,898
2020,100005,Prato,PO,20,1059,0,0,0,1059,933,4,0,0,937
2020,100005,Prato,PO,21,1021,5,0,0,1026,848,12,0,0,860
2020,100005,Prato,PO,22,1017,0,0,0,1017,909,22,0,0,931
2020,100005,Prato,PO,23,1003,3,0,0,1006,804,24,0,0,828
2020,100005,Prato,PO,24,979,8,0,0,987,793,54,0,0,847
2020,100005,Prato,PO,25,968,16,0,0,984,756,83,0,0,839
2020,100005,Prato,PO,26,953,24,1,0,978,807,83,1,0,891
2020,100005,Prato,PO,27,956,42,0,0,999,798,124,4,0,926
2020,100005,Prato,PO,28,999,60,2,0,1061,807,188,2,2,999
2020,100005,Prato,PO,29,946,105,1,0,1052,768,239,4,0,1012
2020,100005,Prato,PO,30,1016,210,0,0,1227,776,276,6,0,1059
2020,100005,Prato,PO,31,979,199,5,0,1184,767,381,9,0,1159
2020,100005,Prato,PO,32,985,239,4,0,1228,739,466,16,1,1225
2020,100005,Prato,PO,33,954,357,9,0,1320,684,561,14,1,1262
2020,100005,Prato,PO,34,833,398,9,0,1241,678,641,15,0,1337
2020,100005,Prato,PO,35,773,508,17,1,1299,561,690,26,3,1282
2020,100005,Prato,PO,36,756,548,12,3,1319,572,763,18,6,1361
2020,100005,Prato,PO,37,799,587,12,2,1406,546,726,29,4,1305
2020,100005,Prato,PO,38,702,677,19,0,1398,562,824,31,2,1419
2020,100005,Prato,PO,39,679,751,30,1,1461,506,808,52,4,1372
2020,100005,Prato,PO,40,690,711,35,1,1437,477,843,48,5,1376
2020,100005,Prato,PO,41,607,793,32,3,1438,434,956,43,7,1441
2020,100005,Prato,PO,42,693,853,39,1,1587,529,954,57,8,1548
2020,100005,Prato,PO,43,656,878,36,2,1575,468,989,91,8,1558
2020,100005,Prato,PO,44,618,939,61,5,1627,508,1121,82,12,1725
2020,100005,Prato,PO,45,670,1028,38,2,1741,466,1156,91,15,1730
2020,100005,Prato,PO,46,616,1053,64,6,1746,427,1186,107,13,1734
2020,100005,Prato,PO,47,599,1118,81,9,1813,436,1224,134,10,1806
2020,100005,Prato,PO,48,550,1127,69,6,1754,383,1168,121,23,1696
2020,100005,Prato,PO,49,447,1204,75,9,1742,359,1289,137,32,1819
2020,100005,Prato,PO,50,440,1229,88,2,1763,330,1194,135,33,1692
2020,100005,Prato,PO,51,400,1273,86,9,1769,316,1197,128,28,1671
2020,100005,Prato,PO,52,358,1204,101,8,1674,304,1244,120,26,1695
2020,100005,Prato,PO,53,320,1133,105,5,1565,276,1202,137,38,1655
2020,100005,Prato,PO,54,332,1148,121,14,1618,269,1233,137,37,1677
2020,100005,Prato,PO,55,290,1197,115,18,1622,237,1201,142,55,1635
2020,100005,Prato,PO,56,292,1187,106,12,1600,184,1254,144,67,1650
2020,100005,Prato,PO,57,221,1092,110,18,1442,189,1090,137,59,1476
2020,100005,Prato,PO,58,197,1058,101,15,1371,147,1043,137,76,1403
2020,100005,Prato,PO,59,168,959,73,14,1216,156,997,141,65,1359
2020,100005,Prato,PO,60,146,1001,77,19,1243,138,991,140,86,1355
2020,100005,Prato,PO,61,148,908,83,27,1166,136,925,103,66,1230
2020,100005,Prato,PO,62,128,925,91,27,1173,109,924,126,96,1255
2020,100005,Prato,PO,63,110,912,57,26,1105,113,845,103,113,1174
2020,100005,Prato,PO,64,93,875,58,30,1056,109,893,96,125,1223
2020,100005,Prato,PO,65,93,843,49,31,1016,99,860,79,125,1163
2020,100005,Prato,PO,66,72,797,71,37,977,71,820,88,143,1123
2020,100005,Prato,PO,67,55,787,45,47,934,89,780,67,123,1060
2020,100005,Prato,PO,68,73,766,42,36,918,74,815,63,142,1094
2020,100005,Prato,PO,69,64,747,37,34,882,49,715,58,183,1005
2020,100005,Prato,PO,70,39,753,35,34,862,50,744,62,194,1050
2020,100005,Prato,PO,71,59,800,39,49,947,60,814,55,242,1171
2020,100005,Prato,PO,72,51,886,24,52,1013,64,749,54,249,1116
2020,100005,Prato,PO,73,46,824,34,58,962,50,752,57,284,1143
2020,100005,Prato,PO,74,50,837,27,55,970,66,712,55,325,1158
2020,100005,Prato,PO,75,51,659,18,53,781,45,554,38,251,888
2020,100005,Prato,PO,76,22,595,17,67,701,51,517,36,300,904
2020,100005,Prato,PO,77,29,607,14,81,731,50,516,28,320,914
2020,100005,Prato,PO,78,41,508,16,68,633,44,433,31,332,840
2020,100005,Prato,PO,79,40,526,10,79,655,46,419,21,382,868
2020,100005,Prato,PO,80,34,561,10,96,701,41,468,22,471,1002
2020,100005,Prato,PO,81,42,553,8,111,714,48,366,23,481,918
2020,100005,Prato,PO,82,31,509,7,100,647,49,334,19,554,956
2020,100005,Prato,PO,83,21,391,7,81,500,33,250,17,464,764
2020,100005,Prato,PO,84,23,339,8,100,470,26,229,12,409,676
2020,100005,Prato,PO,85,17,313,5,80,415,26,206,14,467,713
2020,100005,Prato,PO,86,13,265,6,83,367,21,142,7,416,586
2020,100005,Prato,PO,87,12,245,1,93,351,38,105,9,392,544
2020,100005,Prato,PO,88,14,179,2,77,272,19,74,6,390,489
2020,100005,Prato,PO,89,11,146,4,64,225,16,74,2,330,422
2020,100005,Prato,PO,90,7,124,2,79,212,30,42,4,346,422
2020,100005,Prato,PO,91,5,86,0,57,148,16,34,6,290,346
2020,100005,Prato,PO,92,3,68,1,38,110,18,18,1,266,303
2020,100005,Prato,PO,93,1,50,1,47,99,19,16,2,187,224
2020,100005,Prato,PO,94,1,39,1,32,73,10,5,0,157,172
2020,100005,Prato,PO,95,4,23,1,24,52,8,3,1,151,163
2020,100005,Prato,PO,96,0,15,1,19,35,9,6,2,94,111
2020,100005,Prato,PO,97,1,5,0,12,18,7,1,0,74,82
2020,100005,Prato,PO,98,2,3,0,6,11,3,0,0,49,52
2020,100005,Prato,PO,99,1,3,0,7,11,3,0,0,41,44
2020,100005,Prato,PO,100 e più,0,0,0,6,6,4,0,0,41,45
2020,100006,Vaiano,PO,0,22,0,0,0,22,29,0,0,0,29
2020,100006,Vaiano,PO,1,37,0,0,0,37,24,0,0,0,24
2020,100006,Vaiano,PO,2,38,0,0,0,38,25,0,0,0,25
2020,100006,Vaiano,PO,3,34,0,0,0,34,30,0,0,0,30
2020,100006,Vaiano,PO,4,46,0,0,0,46,38,0,0,0,38
2020,100006,Vaiano,PO,5,34,0,0,0,34,32,0,0,0,32
2020,100006,Vaiano,PO,6,32,0,0,0,32,30,0,0,0,30
2020,100006,Vaiano,PO,7,44,0,0,0,44,35,0,0,0,35
2020,100006,Vaiano,PO,8,36,0,0,0,36,38,0,0,0,38
2020,100006,Vaiano,PO,9,41,0,0,0,41,41,0,0,0,41
2020,100006,Vaiano,PO,10,44,0,0,0,44,40,0,0,0,40
2020,100006,Vaiano,PO,11,47,0,0,0,47,41,0,0,0,41
2020,100006,Vaiano,PO,12,44,0,0,0,44,41,0,0,0,41
2020,100006,Vaiano,PO,13,51,0,0,0,51,44,0,0,0,44
2020,100006,Vaiano,PO,14,48,0,0,0,48,49,0,0,0,49
2020,100006,Vaiano,PO,15,40,0,0,0,40,45,0,0,0,45
2020,100006,Vaiano,PO,16,51,0,0,0,51,42,0,0,0,42
2020,100006,Vaiano,PO,17,39,0,0,0,39,44,0,0,0,44
2020,100006,Vaiano,PO,18,55,0,0,0,55,35,0,0,0,35
2020,100006,Vaiano,PO,19,45,0,0,0,45,43,0,0,0,43
2020,100006,Vaiano,PO,20,44,0,0,0,44,42,0,0,0,42
2020,100006,Vaiano,PO,21,38,0,0,0,38,35,0,0,0,35
2020,100006,Vaiano,PO,22,35,0,0,0,35,38,0,0,0,38
2020,100006,Vaiano,PO,23,45,0,0,0,45,34,2,0,0,36
2020,100006,Vaiano,PO,24,54,0,0,0,54,34,3,0,0,37
2020,100006,Vaiano,PO,25,49,0,0,0,49,42,1,0,0,43
2020,100006,Vaiano,PO,26,35,0,0,0,35,28,7,0,0,35
2020,100006,Vaiano,PO,27,39,2,0,0,41,28,2,0,0,30
2020,100006,Vaiano,PO,28,43,2,0,0,45,46,6,0,0,52
2020,100006,Vaiano,PO,29,39,5,0,0,44,46,10,1,0,57
2020,100006,Vaiano,PO,30,49,4,0,0,53,27,7,1,0,35
2020,100006,Vaiano,PO,31,42,6,0,0,48,33,21,0,0,54
2020,100006,Vaiano,PO,32,40,8,1,0,49,39,14,2,0,55
2020,100006,Vaiano,PO,33,45,10,0,0,55,35,18,0,0,53
2020,100006,Vaiano,PO,34,31,17,1,0,49,31,20,0,0,51
2020,100006,Vaiano,PO,35,41,7,1,0,49,35,23,2,0,60
2020,100006,Vaiano,PO,36,34,12,1,0,47,23,32,0,0,55
2020,100006,Vaiano,PO,37,30,22,1,0,53,27,22,0,0,49
2020,100006,Vaiano,PO,38,27,22,1,0,50,26,23,2,0,51
2020,100006,Vaiano,PO,39,32,33,1,0,66,27,26,3,0,56
2020,100006,Vaiano,PO,40,36,33,2,0,71,26,32,3,1,62
2020,100006,Vaiano,PO,41,32,39,2,0,73,26,44,3,0,73
2020,100006,Vaiano,PO,42,40,27,1,0,68,19,40,5,1,65
2020,100006,Vaiano,PO,43,29,39,3,0,71,23,23,3,1,50
2020,100006,Vaiano,PO,44,27,33,4,0,64,24,51,8,0,83
2020,100006,Vaiano,PO,45,23,47,5,0,75,25,45,6,1,77
2020,100006,Vaiano,PO,46,31,44,4,0,79,17,42,0,1,60
2020,100006,Vaiano,PO,47,28,50,4,0,82,24,63,4,1,92
2020,100006,Vaiano,PO,48,32,45,7,0,84,32,69,3,0,104
2020,100006,Vaiano,PO,49,27,50,2,0,79,12,65,6,0,83
2020,100006,Vaiano,PO,50,21,46,2,0,69,20,62,2,0,84
2020,100006,Vaiano,PO,51,21,54,3,1,79,15,65,4,0,84
2020,100006,Vaiano,PO,52,12,63,4,0,79,11,46,5,2,64
2020,100006,Vaiano,PO,53,20,52,6,2,80,7,67,7,1,82
2020,100006,Vaiano,PO,54,19,60,8,1,88,11,59,9,3,82
2020,100006,Vaiano,PO,55,13,60,8,0,81,9,83,7,4,103
2020,100006,Vaiano,PO,56,8,65,4,2,79,11,59,7,3,80
2020,100006,Vaiano,PO,57,7,54,7,1,69,10,60,6,4,80
2020,100006,Vaiano,PO,58,8,55,9,2,74,6,72,3,3,84
2020,100006,Vaiano,PO,59,3,50,0,0,53,3,66,8,2,79
2020,100006,Vaiano,PO,60,4,58,9,3,74,6,50,6,4,66
2020,100006,Vaiano,PO,61,5,57,5,0,67,11,57,4,4,76
2020,100006,Vaiano,PO,62,5,45,5,1,56,3,63,4,6,76
2020,100006,Vaiano,PO,63,2,61,6,0,69,3,55,10,2,70
2020,100006,Vaiano,PO,64,4,69,2,1,76,4,64,10,8,86
2020,100006,Vaiano,PO,65,4,62,1,3,70,2,54,4,6,66
2020,100006,Vaiano,PO,66,6,52,4,2,64,4,38,6,9,57
2020,100006,Vaiano,PO,67,2,53,4,2,61,2,47,4,8,61
2020,100006,Vaiano,PO,68,3,53,3,2,61,1,55,0,6,62
2020,100006,Vaiano,PO,69,2,53,4,4,63,5,62,2,11,80
2020,100006,Vaiano,PO,70,3,56,3,6,68,3,61,3,11,78
2020,100006,Vaiano,PO,71,8,59,4,2,73,1,46,1,18,66
2020,100006,Vaiano,PO,72,5,58,3,5,71,0,55,4,23,82
2020,100006,Vaiano,PO,73,8,64,4,6,82,2,45,1,16,64
2020,100006,Vaiano,PO,74,4,57,4,8,73,2,46,2,20,70
2020,100006,Vaiano,PO,75,4,41,2,2,49,2,40,2,19,63
2020,100006,Vaiano,PO,76,2,29,0,5,36,3,34,5,13,55
2020,100006,Vaiano,PO,77,1,40,2,2,45,2,25,1,20,48
2020,100006,Vaiano,PO,78,4,40,0,6,50,3,31,2,22,58
2020,100006,Vaiano,PO,79,1,36,0,5,42,2,29,0,22,53
2020,100006,Vaiano,PO,80,3,30,1,3,37,3,23,0,27,53
2020,100006,Vaiano,PO,81,2,30,0,5,37,2,21,1,26,50
2020,100006,Vaiano,PO,82,3,35,1,14,53,2,22,0,29,53
2020,100006,Vaiano,PO,83,3,19,0,6,28,1,17,1,30,49
2020,100006,Vaiano,PO,84,2,19,0,7,28,2,16,0,22,40
2020,100006,Vaiano,PO,85,0,20,0,1,21,2,10,0,22,34
2020,100006,Vaiano,PO,86,1,21,0,3,25,2,10,0,28,40
2020,100006,Vaiano,PO,87,1,16,0,3,20,0,3,0,20,23
2020,100006,Vaiano,PO,88,0,13,1,2,16,1,9,0,23,33
2020,100006,Vaiano,PO,89,1,12,0,5,18,0,7,0,25,32
2020,100006,Vaiano,PO,90,2,11,0,3,16,1,3,0,27,31
2020,100006,Vaiano,PO,91,0,5,0,1,6,1,1,0,16,18
2020,100006,Vaiano,PO,92,0,5,0,5,10,1,0,0,19,20
2020,100006,Vaiano,PO,93,0,3,0,6,9,2,1,0,13,16
2020,100006,Vaiano,PO,94,1,3,0,1,5,4,0,0,14,18
2020,100006,Vaiano,PO,95,0,0,0,2,2,1,0,0,9,10
2020,100006,Vaiano,PO,96,0,2,0,2,4,1,0,0,3,4
2020,100006,Vaiano,PO,97,0,1,0,0,1,0,0,0,4,4
2020,100006,Vaiano,PO,98,0,0,0,2,2,0,0,0,2,2
2020,100006,Vaiano,PO,99,1,0,0,0,1,0,0,0,2,2
2020,100006,Vaiano,PO,100 e più,0,0,0,1,1,0,0,0,1,1
2020,100007,Vernio,PO,0,22,0,0,0,22,22,0,0,0,22
2020,100007,Vernio,PO,1,16,0,0,0,16,23,0,0,0,23
2020,100007,Vernio,PO,2,12,0,0,0,12,24,0,0,0,24
2020,100007,Vernio,PO,3,26,0,0,0,26,18,0,0,0,18
2020,100007,Vernio,PO,4,12,0,0,0,12,11,0,0,0,11
2020,100007,Vernio,PO,5,23,0,0,0,23,26,0,0,0,26
2020,100007,Vernio,PO,6,16,0,0,0,16,17,0,0,0,17
2020,100007,Vernio,PO,7,18,0,0,0,18,25,0,0,0,25
2020,100007,Vernio,PO,8,23,0,0,0,23,10,0,0,0,10
2020,100007,Vernio,PO,9,25,0,0,0,25,26,0,0,0,26
2020,100007,Vernio,PO,10,28,0,0,0,28,18,0,0,0,18
2020,100007,Vernio,PO,11,27,0,0,0,27,43,0,0,0,43
2020,100007,Vernio,PO,12,19,0,0,0,19,23,0,0,0,23
2020,100007,Vernio,PO,13,20,0,0,0,20,20,0,0,0,20
2020,100007,Vernio,PO,14,33,0,0,0,33,14,0,0,0,14
2020,100007,Vernio,PO,15,22,0,0,0,22,25,0,0,0,25
2020,100007,Vernio,PO,16,26,0,0,0,26,24,0,0,0,24
2020,100007,Vernio,PO,17,29,0,0,0,29,30,0,0,0,30
2020,100007,Vernio,PO,18,27,0,0,0,27,25,0,0,0,25
2020,100007,Vernio,PO,19,24,0,0,0,24,17,0,0,0,17
2020,100007,Vernio,PO,20,28,0,0,0,28,21,0,0,0,21
2020,100007,Vernio,PO,21,26,0,0,0,26,24,0,0,0,24
2020,100007,Vernio,PO,22,27,0,0,0,27,27,0,0,0,27
2020,100007,Vernio,PO,23,20,0,0,0,20,25,1,0,0,26
2020,100007,Vernio,PO,24,19,0,0,0,19,21,1,0,0,22
2020,100007,Vernio,PO,25,28,1,0,0,29,28,2,0,0,30
2020,100007,Vernio,PO,26,22,2,0,0,24,24,6,0,0,30
2020,100007,Vernio,PO,27,23,2,0,0,25,15,5,0,0,20
2020,100007,Vernio,PO,28,27,3,0,0,30,20,3,1,0,24
2020,100007,Vernio,PO,29,32,1,0,0,33,14,5,1,0,20
2020,100007,Vernio,PO,30,21,2,0,0,23,26,9,0,0,35
2020,100007,Vernio,PO,31,22,6,0,0,28,17,12,1,0,30
2020,100007,Vernio,PO,32,21,3,0,0,24,14,10,0,0,24
2020,100007,Vernio,PO,33,20,8,0,0,28,18,12,0,0,30
2020,100007,Vernio,PO,34,21,8,0,0,29,17,8,1,0,26
2020,100007,Vernio,PO,35,16,9,0,0,25,20,12,0,0,32
2020,100007,Vernio,PO,36,16,14,0,0,30,19,7,0,0,26
2020,100007,Vernio,PO,37,10,11,0,0,21,18,14,1,0,33
2020,100007,Vernio,PO,38,20,8,4,0,32,10,17,1,0,28
2020,100007,Vernio,PO,39,16,12,0,0,28,12,15,1,0,28
2020,100007,Vernio,PO,40,25,10,1,0,36,19,19,2,0,40
2020,100007,Vernio,PO,41,16,10,0,0,26,11,21,3,0,35
2020,100007,Vernio,PO,42,26,19,1,0,46,13,14,2,1,30
2020,100007,Vernio,PO,43,16,14,2,0,32,14,20,0,0,34
2020,100007,Vernio,PO,44,31,26,2,0,59,10,31,3,0,44
2020,100007,Vernio,PO,45,19,25,3,0,47,17,25,0,1,43
2020,100007,Vernio,PO,46,21,24,3,0,48,14,34,2,0,50
2020,100007,Vernio,PO,47,30,29,1,0,60,12,34,5,1,52
2020,100007,Vernio,PO,48,19,37,2,0,58,8,30,7,1,46
2020,100007,Vernio,PO,49,14,25,4,0,43,5,32,5,0,42
2020,100007,Vernio,PO,50,17,38,1,0,56,8,33,4,1,46
2020,100007,Vernio,PO,51,17,30,4,0,51,11,26,6,2,45
2020,100007,Vernio,PO,52,15,40,6,0,61,5,47,5,2,59
2020,100007,Vernio,PO,53,14,25,2,0,41,12,35,9,1,57
2020,100007,Vernio,PO,54,21,28,7,0,56,9,33,2,3,47
2020,100007,Vernio,PO,55,13,37,4,1,55,8,38,6,1,53
2020,100007,Vernio,PO,56,8,40,2,0,50,7,41,3,2,53
2020,100007,Vernio,PO,57,12,34,4,1,51,9,52,6,4,71
2020,100007,Vernio,PO,58,13,41,7,0,61,5,47,6,4,62
2020,100007,Vernio,PO,59,8,35,7,1,51,5,44,2,1,52
2020,100007,Vernio,PO,60,7,36,4,2,49,4,33,3,2,42
2020,100007,Vernio,PO,61,7,38,2,0,47,3,33,3,3,42
2020,100007,Vernio,PO,62,8,34,5,1,48,2,34,1,6,43
2020,100007,Vernio,PO,63,7,31,2,2,42,5,24,3,3,35
2020,100007,Vernio,PO,64,7,38,2,0,47,4,36,0,2,42
2020,100007,Vernio,PO,65,4,39,3,2,48,2,25,2,5,34
2020,100007,Vernio,PO,66,6,25,6,2,39,3,31,2,4,40
2020,100007,Vernio,PO,67,5,38,5,3,51,2,29,3,6,40
2020,100007,Vernio,PO,68,3,45,5,1,54,2,29,3,7,41
2020,100007,Vernio,PO,69,2,27,3,3,35,2,24,2,8,36
2020,100007,Vernio,PO,70,3,39,2,2,46,0,36,0,13,49
2020,100007,Vernio,PO,71,3,35,2,1,41,1,29,0,15,45
2020,100007,Vernio,PO,72,4,51,4,2,61,0,33,1,10,44
2020,100007,Vernio,PO,73,5,25,1,0,31,3,36,2,14,55
2020,100007,Vernio,PO,74,2,32,1,2,37,3,20,2,9,34
2020,100007,Vernio,PO,75,2,26,0,2,30,1,26,0,7,34
2020,100007,Vernio,PO,76,0,14,2,6,22,0,16,0,12,28
2020,100007,Vernio,PO,77,2,24,2,0,28,1,10,1,6,18
2020,100007,Vernio,PO,78,0,19,0,5,24,1,15,0,6,22
2020,100007,Vernio,PO,79,1,20,1,5,27,1,18,4,12,35
2020,100007,Vernio,PO,80,4,25,1,4,34,1,19,1,12,33
2020,100007,Vernio,PO,81,1,14,0,4,19,5,8,1,19,33
2020,100007,Vernio,PO,82,2,16,0,7,25,0,8,0,12,20
2020,100007,Vernio,PO,83,3,20,1,4,28,3,17,0,22,42
2020,100007,Vernio,PO,84,2,9,0,9,20,3,8,0,14,25
2020,100007,Vernio,PO,85,2,8,1,7,18,0,11,0,15,26
2020,100007,Vernio,PO,86,1,10,0,5,16,1,5,0,26,32
2020,100007,Vernio,PO,87,1,4,1,2,8,1,1,0,14,16
2020,100007,Vernio,PO,88,2,10,0,3,15,0,2,0,17,19
2020,100007,Vernio,PO,89,1,9,0,1,11,0,4,0,11,15
2020,100007,Vernio,PO,90,0,4,0,2,6,0,3,1,15,19
2020,100007,Vernio,PO,91,0,4,0,2,6,0,0,0,18,18
2020,100007,Vernio,PO,92,0,2,0,2,4,0,1,0,15,16
2020,100007,Vernio,PO,93,0,3,0,2,5,0,0,0,8,8
2020,100007,Vernio,PO,94,0,2,0,1,3,1,0,0,7,8
2020,100007,Vernio,PO,95,0,0,0,0,0,0,0,0,5,5
2020,100007,Vernio,PO,96,0,2,0,1,3,0,0,0,3,3
2020,100007,Vernio,PO,97,0,0,0,2,2,0,0,1,2,3
2020,100007,Vernio,PO,98,0,0,0,0,0,0,0,0,1,1
2020,100007,Vernio,PO,99,0,0,0,0,0,0,0,0,3,3
2020,100007,Vernio,PO,100 e più,0,0,0,0,0,0,0,0,1,1
2020,52001,Abbadia San Salvatore,SI,0,20,0,0,0,20,11,0,0,0,11
2020,52001,Abbadia San Salvatore,SI,1,15,0,0,0,15,18,0,0,0,18
2020,52001,Abbadia San Salvatore,SI,2,15,0,0,0,15,21,0,0,0,21
2020,52001,Abbadia San Salvatore,SI,3,14,0,0,0,14,16,0,0,0,16
2020,52001,Abbadia San Salvatore,SI,4,19,0,0,0,19,16,0,0,0,16
2020,52001,Abbadia San Salvatore,SI,5,19,0,0,0,19,22,0,0,0,22
2020,52001,Abbadia San Salvatore,SI,6,19,0,0,0,19,17,0,0,0,17
2020,52001,Abbadia San Salvatore,SI,7,19,0,0,0,19,18,0,0,0,18
2020,52001,Abbadia San Salvatore,SI,8,28,0,0,0,28,19,0,0,0,19
2020,52001,Abbadia San Salvatore,SI,9,35,0,0,0,35,27,0,0,0,27
2020,52001,Abbadia San Salvatore,SI,10,20,0,0,0,20,27,0,0,0,27
2020,52001,Abbadia San Salvatore,SI,11,23,0,0,0,23,20,0,0,0,20
2020,52001,Abbadia San Salvatore,SI,12,26,0,0,0,26,21,0,0,0,21
2020,52001,Abbadia San Salvatore,SI,13,26,0,0,0,26,26,0,0,0,26
2020,52001,Abbadia San Salvatore,SI,14,19,0,0,0,19,21,0,0,0,21
2020,52001,Abbadia San Salvatore,SI,15,17,0,0,0,17,18,0,0,0,18
2020,52001,Abbadia San Salvatore,SI,16,26,0,0,0,26,25,0,0,0,25
2020,52001,Abbadia San Salvatore,SI,17,23,0,0,0,23,17,0,0,0,17
2020,52001,Abbadia San Salvatore,SI,18,22,0,0,0,22,22,0,0,0,22
2020,52001,Abbadia San Salvatore,SI,19,17,0,0,0,17,33,0,0,0,33
2020,52001,Abbadia San Salvatore,SI,20,27,0,0,0,27,33,2,0,0,35
2020,52001,Abbadia San Salvatore,SI,21,29,0,0,0,29,23,2,0,0,25
2020,52001,Abbadia San Salvatore,SI,22,31,0,0,0,31,24,0,0,0,24
2020,52001,Abbadia San Salvatore,SI,23,26,0,0,0,26,20,3,0,0,23
2020,52001,Abbadia San Salvatore,SI,24,35,1,0,0,36,19,2,0,0,21
2020,52001,Abbadia San Salvatore,SI,25,23,0,0,0,23,18,2,0,0,20
2020,52001,Abbadia San Salvatore,SI,26,23,1,0,0,24,22,3,0,0,25
2020,52001,Abbadia San Salvatore,SI,27,28,3,0,0,31,23,7,0,0,30
2020,52001,Abbadia San Salvatore,SI,28,26,2,0,0,28,17,6,0,0,23
2020,52001,Abbadia San Salvatore,SI,29,29,8,0,0,37,23,5,1,0,29
2020,52001,Abbadia San Salvatore,SI,30,31,8,0,0,39,18,8,0,0,26
2020,52001,Abbadia San Salvatore,SI,31,20,5,0,0,25,11,8,0,0,19
2020,52001,Abbadia San Salvatore,SI,32,31,4,0,0,35,13,11,0,0,24
2020,52001,Abbadia San Salvatore,SI,33,18,6,0,0,24,9,11,1,0,21
2020,52001,Abbadia San Salvatore,SI,34,18,9,0,0,27,23,14,1,0,38
2020,52001,Abbadia San Salvatore,SI,35,29,10,0,0,39,12,7,3,2,24
2020,52001,Abbadia San Salvatore,SI,36,17,9,0,0,26,14,18,0,0,32
2020,52001,Abbadia San Salvatore,SI,37,25,6,1,0,32,9,15,0,0,24
2020,52001,Abbadia San Salvatore,SI,38,20,12,0,0,32,15,16,1,0,32
2020,52001,Abbadia San Salvatore,SI,39,18,12,0,0,30,14,16,0,0,30
2020,52001,Abbadia San Salvatore,SI,40,20,16,0,0,36,13,15,1,0,29
2020,52001,Abbadia San Salvatore,SI,41,16,18,0,0,34,6,20,1,0,27
2020,52001,Abbadia San Salvatore,SI,42,16,16,0,0,32,10,18,2,0,30
2020,52001,Abbadia San Salvatore,SI,43,17,18,1,0,36,9,25,1,0,35
2020,52001,Abbadia San Salvatore,SI,44,18,22,1,0,41,10,29,3,1,43
2020,52001,Abbadia San Salvatore,SI,45,20,18,0,0,38,8,19,4,0,31
2020,52001,Abbadia San Salvatore,SI,46,21,28,2,0,51,8,20,7,1,36
2020,52001,Abbadia San Salvatore,SI,47,21,27,1,0,49,15,32,5,0,52
2020,52001,Abbadia San Salvatore,SI,48,19,27,0,0,46,14,32,4,0,50
2020,52001,Abbadia San Salvatore,SI,49,18,29,3,0,50,13,30,6,0,49
2020,52001,Abbadia San Salvatore,SI,50,22,28,5,0,55,7,45,2,1,55
2020,52001,Abbadia San Salvatore,SI,51,12,30,5,0,47,12,34,6,4,56
2020,52001,Abbadia San Salvatore,SI,52,13,24,4,0,41,11,39,6,0,56
2020,52001,Abbadia San Salvatore,SI,53,16,24,6,0,46,7,35,3,2,47
2020,52001,Abbadia San Salvatore,SI,54,13,35,2,1,51,5,34,2,1,42
2020,52001,Abbadia San Salvatore,SI,55,7,32,4,1,44,12,38,3,3,56
2020,52001,Abbadia San Salvatore,SI,56,5,36,3,0,44,5,27,4,4,40
2020,52001,Abbadia San Salvatore,SI,57,6,30,5,0,41,4,40,7,2,53
2020,52001,Abbadia San Salvatore,SI,58,8,26,0,0,34,3,53,5,3,64
2020,52001,Abbadia San Salvatore,SI,59,8,26,3,0,37,4,47,5,3,59
2020,52001,Abbadia San Salvatore,SI,60,6,32,2,0,40,5,30,6,3,44
2020,52001,Abbadia San Salvatore,SI,61,4,44,4,0,52,4,41,5,2,52
2020,52001,Abbadia San Salvatore,SI,62,4,40,2,1,47,3,38,6,4,51
2020,52001,Abbadia San Salvatore,SI,63,7,34,6,4,51,3,33,5,0,41
2020,52001,Abbadia San Salvatore,SI,64,3,35,1,1,40,4,31,8,5,48
2020,52001,Abbadia San Salvatore,SI,65,3,40,5,0,48,1,41,4,1,47
2020,52001,Abbadia San Salvatore,SI,66,4,27,1,1,33,1,28,5,7,41
2020,52001,Abbadia San Salvatore,SI,67,4,31,2,1,38,2,35,4,9,50
2020,52001,Abbadia San Salvatore,SI,68,5,34,0,3,42,1,41,1,3,46
2020,52001,Abbadia San Salvatore,SI,69,5,38,2,1,46,2,27,1,6,36
2020,52001,Abbadia San Salvatore,SI,70,1,30,2,2,35,1,36,2,4,43
2020,52001,Abbadia San Salvatore,SI,71,2,30,2,0,34,0,30,1,6,37
2020,52001,Abbadia San Salvatore,SI,72,4,37,2,2,45,0,34,1,12,47
2020,52001,Abbadia San Salvatore,SI,73,4,36,0,5,45,3,28,1,12,44
2020,52001,Abbadia San Salvatore,SI,74,5,32,1,3,41,2,33,3,18,56
2020,52001,Abbadia San Salvatore,SI,75,2,29,2,4,37,4,22,2,14,42
2020,52001,Abbadia San Salvatore,SI,76,5,19,0,0,24,0,35,1,22,58
2020,52001,Abbadia San Salvatore,SI,77,2,19,1,0,22,2,22,3,13,40
2020,52001,Abbadia San Salvatore,SI,78,7,26,0,4,37,1,12,1,13,27
2020,52001,Abbadia San Salvatore,SI,79,1,31,1,2,35,0,14,0,17,31
2020,52001,Abbadia San Salvatore,SI,80,0,36,2,3,41,0,16,0,30,46
2020,52001,Abbadia San Salvatore,SI,81,3,18,0,8,29,0,14,0,27,41
2020,52001,Abbadia San Salvatore,SI,82,0,17,0,2,19,1,15,2,19,37
2020,52001,Abbadia San Salvatore,SI,83,0,17,0,6,23,0,15,1,26,42
2020,52001,Abbadia San Salvatore,SI,84,2,11,0,2,15,0,11,0,17,28
2020,52001,Abbadia San Salvatore,SI,85,1,17,0,5,23,1,8,0,22,31
2020,52001,Abbadia San Salvatore,SI,86,2,11,0,6,19,0,5,0,28,33
2020,52001,Abbadia San Salvatore,SI,87,1,12,0,6,19,2,3,1,23,29
2020,52001,Abbadia San Salvatore,SI,88,0,12,0,6,18,0,4,0,29,33
2020,52001,Abbadia San Salvatore,SI,89,1,3,0,8,12,2,2,0,22,26
2020,52001,Abbadia San Salvatore,SI,90,1,5,0,7,13,0,5,0,28,33
2020,52001,Abbadia San Salvatore,SI,91,0,4,0,5,9,0,4,0,16,20
2020,52001,Abbadia San Salvatore,SI,92,0,1,0,2,3,1,0,0,13,14
2020,52001,Abbadia San Salvatore,SI,93,1,0,0,2,3,0,1,0,9,10
2020,52001,Abbadia San Salvatore,SI,94,0,3,0,5,8,0,1,1,7,9
2020,52001,Abbadia San Salvatore,SI,95,0,0,0,1,1,0,0,0,6,6
2020,52001,Abbadia San Salvatore,SI,96,1,1,0,1,3,0,0,0,10,10
2020,52001,Abbadia San Salvatore,SI,97,0,1,0,0,1,0,0,0,4,4
2020,52001,Abbadia San Salvatore,SI,98,0,1,0,0,1,0,0,0,4,4
2020,52001,Abbadia San Salvatore,SI,99,0,0,0,1,1,0,0,0,3,3
2020,52001,Abbadia San Salvatore,SI,100 e più,0,1,0,0,1,0,0,0,1,1
2020,52002,Asciano,SI,0,14,0,0,0,14,31,0,0,0,31
2020,52002,Asciano,SI,1,27,0,0,0,27,23,0,0,0,23
2020,52002,Asciano,SI,2,27,0,0,0,27,15,0,0,0,15
2020,52002,Asciano,SI,3,26,0,0,0,26,24,0,0,0,24
2020,52002,Asciano,SI,4,20,0,0,0,20,23,0,0,0,23
2020,52002,Asciano,SI,5,30,0,0,0,30,33,0,0,0,33
2020,52002,Asciano,SI,6,28,0,0,0,28,28,0,0,0,28
2020,52002,Asciano,SI,7,19,0,0,0,19,24,0,0,0,24
2020,52002,Asciano,SI,8,32,0,0,0,32,38,0,0,0,38
2020,52002,Asciano,SI,9,45,0,0,0,45,37,0,0,0,37
2020,52002,Asciano,SI,10,34,0,0,0,34,30,0,0,0,30
2020,52002,Asciano,SI,11,24,0,0,0,24,32,0,0,0,32
2020,52002,Asciano,SI,12,22,0,0,0,22,33,0,0,0,33
2020,52002,Asciano,SI,13,37,0,0,0,37,37,0,0,0,37
2020,52002,Asciano,SI,14,42,0,0,0,42,30,0,0,0,30
2020,52002,Asciano,SI,15,40,0,0,0,40,31,0,0,0,31
2020,52002,Asciano,SI,16,32,0,0,0,32,39,0,0,0,39
2020,52002,Asciano,SI,17,26,0,0,0,26,36,0,0,0,36
2020,52002,Asciano,SI,18,32,0,0,0,32,36,0,0,0,36
2020,52002,Asciano,SI,19,36,0,0,0,36,35,0,0,0,35
2020,52002,Asciano,SI,20,33,0,0,0,33,31,1,0,0,32
2020,52002,Asciano,SI,21,33,0,0,0,33,33,3,0,0,36
2020,52002,Asciano,SI,22,36,0,0,0,36,34,1,0,0,35
2020,52002,Asciano,SI,23,33,1,0,0,34,28,1,0,0,29
2020,52002,Asciano,SI,24,18,1,0,0,19,30,2,0,0,32
2020,52002,Asciano,SI,25,33,0,0,0,33,22,2,0,0,24
2020,52002,Asciano,SI,26,29,2,0,0,31,29,4,0,0,33
2020,52002,Asciano,SI,27,27,2,0,0,29,28,2,0,0,30
2020,52002,Asciano,SI,28,39,2,0,0,41,24,9,0,0,33
2020,52002,Asciano,SI,29,26,3,0,0,29,24,6,1,0,31
2020,52002,Asciano,SI,30,25,5,0,0,30,14,10,1,0,25
2020,52002,Asciano,SI,31,29,8,1,0,38,23,11,0,0,34
2020,52002,Asciano,SI,32,21,8,0,0,29,12,19,0,0,31
2020,52002,Asciano,SI,33,23,7,0,0,30,18,19,0,0,37
2020,52002,Asciano,SI,34,25,10,0,0,35,15,15,2,0,32
2020,52002,Asciano,SI,35,20,16,0,0,36,15,11,2,0,28
2020,52002,Asciano,SI,36,18,9,0,0,27,10,18,1,0,29
2020,52002,Asciano,SI,37,24,14,0,0,38,18,13,0,0,31
2020,52002,Asciano,SI,38,15,17,1,0,33,17,29,0,0,46
2020,52002,Asciano,SI,39,23,19,0,0,42,13,33,0,0,46
2020,52002,Asciano,SI,40,23,31,0,0,54,7,34,2,0,43
2020,52002,Asciano,SI,41,15,17,0,0,32,17,19,0,0,36
2020,52002,Asciano,SI,42,32,18,1,0,51,15,33,3,0,51
2020,52002,Asciano,SI,43,17,23,5,0,45,10,27,4,0,41
2020,52002,Asciano,SI,44,23,37,3,0,63,13,41,4,0,58
2020,52002,Asciano,SI,45,18,27,2,0,47,22,37,5,0,64
2020,52002,Asciano,SI,46,10,32,3,0,45,12,41,2,1,56
2020,52002,Asciano,SI,47,13,37,0,0,50,14,45,1,0,60
2020,52002,Asciano,SI,48,17,53,1,0,71,14,49,4,1,68
2020,52002,Asciano,SI,49,13,39,4,0,56,13,37,4,0,54
2020,52002,Asciano,SI,50,19,30,1,0,50,14,37,4,0,55
2020,52002,Asciano,SI,51,18,36,2,0,56,12,51,1,0,64
2020,52002,Asciano,SI,52,9,35,4,0,48,12,46,5,0,63
2020,52002,Asciano,SI,53,18,53,3,0,74,14,34,1,2,51
2020,52002,Asciano,SI,54,12,44,4,0,60,11,47,4,2,64
2020,52002,Asciano,SI,55,9,43,2,1,55,8,44,3,0,55
2020,52002,Asciano,SI,56,5,47,4,0,56,13,41,1,2,57
2020,52002,Asciano,SI,57,12,42,5,0,59,8,33,1,0,42
2020,52002,Asciano,SI,58,6,44,1,0,51,7,45,3,0,55
2020,52002,Asciano,SI,59,8,30,2,0,40,6,32,6,0,44
2020,52002,Asciano,SI,60,13,39,4,0,56,3,39,0,1,43
2020,52002,Asciano,SI,61,9,42,1,0,52,3,36,3,0,42
2020,52002,Asciano,SI,62,6,34,2,1,43,8,44,2,1,55
2020,52002,Asciano,SI,63,5,34,2,0,41,3,38,2,1,44
2020,52002,Asciano,SI,64,6,27,2,0,35,6,31,2,1,40
2020,52002,Asciano,SI,65,4,30,5,0,39,4,30,1,2,37
2020,52002,Asciano,SI,66,8,39,1,0,48,4,34,1,2,41
2020,52002,Asciano,SI,67,8,29,1,0,38,1,48,3,2,54
2020,52002,Asciano,SI,68,3,28,4,0,35,4,32,0,5,41
2020,52002,Asciano,SI,69,5,28,0,0,33,3,39,0,0,42
2020,52002,Asciano,SI,70,4,31,0,0,35,6,36,2,4,48
2020,52002,Asciano,SI,71,2,38,2,1,43,4,44,2,1,51
2020,52002,Asciano,SI,72,4,34,0,0,38,3,48,2,2,55
2020,52002,Asciano,SI,73,5,40,2,1,48,4,42,1,5,52
2020,52002,Asciano,SI,74,3,35,1,0,39,9,38,1,0,48
2020,52002,Asciano,SI,75,4,30,0,0,34,2,20,5,3,30
2020,52002,Asciano,SI,76,3,29,1,1,34,3,22,0,3,28
2020,52002,Asciano,SI,77,6,28,1,0,35,0,25,0,0,25
2020,52002,Asciano,SI,78,1,25,0,1,27,5,17,2,2,26
2020,52002,Asciano,SI,79,6,19,1,0,26,3,29,0,1,33
2020,52002,Asciano,SI,80,5,37,1,1,44,6,25,0,3,34
2020,52002,Asciano,SI,81,5,18,0,1,24,3,33,0,3,39
2020,52002,Asciano,SI,82,1,18,0,0,19,4,24,0,3,31
2020,52002,Asciano,SI,83,7,22,0,0,29,4,18,3,9,34
2020,52002,Asciano,SI,84,1,13,0,0,14,1,17,0,2,20
2020,52002,Asciano,SI,85,1,24,0,0,25,4,27,0,7,38
2020,52002,Asciano,SI,86,1,10,0,0,11,3,21,0,6,30
2020,52002,Asciano,SI,87,3,15,0,0,18,0,16,0,15,31
2020,52002,Asciano,SI,88,0,8,0,2,10,6,11,0,6,23
2020,52002,Asciano,SI,89,1,12,0,0,13,4,8,0,11,23
2020,52002,Asciano,SI,90,1,10,0,0,11,0,9,0,6,15
2020,52002,Asciano,SI,91,0,10,0,1,11,0,5,0,12,17
2020,52002,Asciano,SI,92,1,5,0,1,7,2,3,0,5,10
2020,52002,Asciano,SI,93,0,10,0,0,10,0,3,0,12,15
2020,52002,Asciano,SI,94,0,2,0,0,2,0,5,0,5,10
2020,52002,Asciano,SI,95,0,5,0,0,5,0,3,0,2,5
2020,52002,Asciano,SI,96,0,3,0,1,4,0,0,1,9,10
2020,52002,Asciano,SI,97,0,1,0,1,2,0,0,0,4,4
2020,52002,Asciano,SI,98,0,1,0,0,1,0,1,0,1,2
2020,52002,Asciano,SI,99,0,1,0,0,1,0,0,0,0,0
2020,52002,Asciano,SI,100 e più,0,0,0,1,1,0,0,0,4,4
2020,52003,Buonconvento,SI,0,6,0,0,0,6,13,0,0,0,13
2020,52003,Buonconvento,SI,1,13,0,0,0,13,9,0,0,0,9
2020,52003,Buonconvento,SI,2,8,0,0,0,8,5,0,0,0,5
2020,52003,Buonconvento,SI,3,16,0,0,0,16,15,0,0,0,15
2020,52003,Buonconvento,SI,4,12,0,0,0,12,9,0,0,0,9
2020,52003,Buonconvento,SI,5,16,0,0,0,16,6,0,0,0,6
2020,52003,Buonconvento,SI,6,25,0,0,0,25,12,0,0,0,12
2020,52003,Buonconvento,SI,7,8,0,0,0,8,21,0,0,0,21
2020,52003,Buonconvento,SI,8,11,0,0,0,11,16,0,0,0,16
2020,52003,Buonconvento,SI,9,17,0,0,0,17,8,0,0,0,8
2020,52003,Buonconvento,SI,10,10,0,0,0,10,19,0,0,0,19
2020,52003,Buonconvento,SI,11,17,0,0,0,17,11,0,0,0,11
2020,52003,Buonconvento,SI,12,16,0,0,0,16,20,0,0,0,20
2020,52003,Buonconvento,SI,13,18,0,0,0,18,14,0,0,0,14
2020,52003,Buonconvento,SI,14,15,0,0,0,15,9,0,0,0,9
2020,52003,Buonconvento,SI,15,13,0,0,0,13,11,0,0,0,11
2020,52003,Buonconvento,SI,16,13,0,0,0,13,14,0,0,0,14
2020,52003,Buonconvento,SI,17,18,0,0,0,18,12,0,0,0,12
2020,52003,Buonconvento,SI,18,15,0,0,0,15,13,0,0,0,13
2020,52003,Buonconvento,SI,19,12,0,0,0,12,17,0,0,0,17
2020,52003,Buonconvento,SI,20,13,0,0,0,13,16,0,0,0,16
2020,52003,Buonconvento,SI,21,10,0,0,0,10,19,0,0,0,19
2020,52003,Buonconvento,SI,22,16,0,0,0,16,20,1,0,0,21
2020,52003,Buonconvento,SI,23,14,0,0,0,14,10,3,0,0,13
2020,52003,Buonconvento,SI,24,17,2,0,0,19,18,1,0,0,19
2020,52003,Buonconvento,SI,25,11,0,0,0,11,15,3,0,0,18
2020,52003,Buonconvento,SI,26,9,0,0,0,9,13,1,0,0,14
2020,52003,Buonconvento,SI,27,28,4,0,0,32,16,2,0,0,18
2020,52003,Buonconvento,SI,28,8,4,0,0,12,12,5,0,0,17
2020,52003,Buonconvento,SI,29,12,1,0,0,13,8,1,0,0,9
2020,52003,Buonconvento,SI,30,7,1,0,0,8,11,4,1,0,16
2020,52003,Buonconvento,SI,31,15,1,0,0,16,7,6,0,0,13
2020,52003,Buonconvento,SI,32,10,1,0,0,11,11,3,0,0,14
2020,52003,Buonconvento,SI,33,13,6,0,0,19,13,6,0,0,19
2020,52003,Buonconvento,SI,34,12,3,0,0,15,5,4,1,0,10
2020,52003,Buonconvento,SI,35,6,6,0,0,12,11,10,0,0,21
2020,52003,Buonconvento,SI,36,16,5,0,0,21,12,8,0,0,20
2020,52003,Buonconvento,SI,37,10,6,1,0,17,5,14,1,0,20
2020,52003,Buonconvento,SI,38,12,11,0,1,24,7,13,0,0,20
2020,52003,Buonconvento,SI,39,8,6,0,0,14,9,11,2,0,22
2020,52003,Buonconvento,SI,40,13,15,0,0,28,6,12,1,0,19
2020,52003,Buonconvento,SI,41,4,17,0,0,21,11,9,0,0,20
2020,52003,Buonconvento,SI,42,7,11,0,0,18,4,13,0,0,17
2020,52003,Buonconvento,SI,43,11,7,0,0,18,6,13,0,0,19
2020,52003,Buonconvento,SI,44,6,11,0,0,17,6,16,1,0,23
2020,52003,Buonconvento,SI,45,11,13,1,0,25,4,13,1,1,19
2020,52003,Buonconvento,SI,46,9,14,0,0,23,5,15,0,1,21
2020,52003,Buonconvento,SI,47,6,9,0,0,15,6,20,4,0,30
2020,52003,Buonconvento,SI,48,5,20,0,0,25,5,16,2,1,24
2020,52003,Buonconvento,SI,49,11,13,2,0,26,1,15,2,0,18
2020,52003,Buonconvento,SI,50,7,17,3,0,27,3,20,3,0,26
2020,52003,Buonconvento,SI,51,2,25,2,0,29,9,14,2,1,26
2020,52003,Buonconvento,SI,52,3,9,5,0,17,2,16,0,2,20
2020,52003,Buonconvento,SI,53,1,20,0,0,21,4,22,0,1,27
2020,52003,Buonconvento,SI,54,6,16,2,0,24,2,26,1,2,31
2020,52003,Buonconvento,SI,55,5,14,0,0,19,4,18,1,0,23
2020,52003,Buonconvento,SI,56,5,25,1,0,31,4,21,1,4,30
2020,52003,Buonconvento,SI,57,2,11,1,0,14,1,15,2,1,19
2020,52003,Buonconvento,SI,58,5,8,1,0,14,2,15,3,5,25
2020,52003,Buonconvento,SI,59,1,21,0,0,22,1,16,4,0,21
2020,52003,Buonconvento,SI,60,4,15,4,0,23,0,15,1,2,18
2020,52003,Buonconvento,SI,61,2,25,2,0,29,1,16,2,3,22
2020,52003,Buonconvento,SI,62,3,13,1,1,18,2,11,1,2,16
2020,52003,Buonconvento,SI,63,0,16,2,0,18,1,17,0,1,19
2020,52003,Buonconvento,SI,64,3,11,1,1,16,4,13,2,1,20
2020,52003,Buonconvento,SI,65,1,13,0,0,14,3,14,2,5,24
2020,52003,Buonconvento,SI,66,1,17,1,0,19,0,17,0,3,20
2020,52003,Buonconvento,SI,67,0,13,1,0,14,1,12,0,3,16
2020,52003,Buonconvento,SI,68,1,16,0,1,18,0,13,0,5,18
2020,52003,Buonconvento,SI,69,1,11,2,0,14,0,6,2,1,9
2020,52003,Buonconvento,SI,70,5,9,3,0,17,2,17,1,3,23
2020,52003,Buonconvento,SI,71,2,17,0,0,19,2,13,0,7,22
2020,52003,Buonconvento,SI,72,1,15,0,4,20,2,23,0,6,31
2020,52003,Buonconvento,SI,73,4,23,1,2,30,1,16,0,4,21
2020,52003,Buonconvento,SI,74,1,19,2,3,25,1,11,0,8,20
2020,52003,Buonconvento,SI,75,0,7,0,4,11,1,12,0,5,18
2020,52003,Buonconvento,SI,76,0,15,0,1,16,1,7,0,3,11
2020,52003,Buonconvento,SI,77,1,14,0,0,15,1,10,0,3,14
2020,52003,Buonconvento,SI,78,1,5,0,3,9,0,2,1,8,11
2020,52003,Buonconvento,SI,79,0,10,0,1,11,0,6,2,6,14
2020,52003,Buonconvento,SI,80,0,5,0,0,5,0,10,0,4,14
2020,52003,Buonconvento,SI,81,3,7,0,1,11,0,6,0,11,17
2020,52003,Buonconvento,SI,82,3,17,0,1,21,0,7,1,10,18
2020,52003,Buonconvento,SI,83,0,6,0,6,12,0,2,0,9,11
2020,52003,Buonconvento,SI,84,2,5,0,3,10,0,3,0,13,16
2020,52003,Buonconvento,SI,85,0,4,0,0,4,1,1,0,9,11
2020,52003,Buonconvento,SI,86,0,5,0,0,5,0,3,0,8,11
2020,52003,Buonconvento,SI,87,0,6,0,1,7,1,0,0,9,10
2020,52003,Buonconvento,SI,88,1,1,0,2,4,1,1,0,7,9
2020,52003,Buonconvento,SI,89,1,5,0,2,8,0,1,0,10,11
2020,52003,Buonconvento,SI,90,0,4,0,0,4,0,2,0,6,8
2020,52003,Buonconvento,SI,91,0,2,0,3,5,0,0,0,7,7
2020,52003,Buonconvento,SI,92,0,0,0,1,1,0,0,0,3,3
2020,52003,Buonconvento,SI,93,1,1,0,0,2,1,1,0,5,7
2020,52003,Buonconvento,SI,94,1,0,0,1,2,0,0,0,6,6
2020,52003,Buonconvento,SI,95,0,0,0,1,1,0,0,0,0,0
2020,52003,Buonconvento,SI,96,0,1,0,0,1,0,0,0,1,1
2020,52003,Buonconvento,SI,97,0,0,0,0,0,0,0,0,0,0
2020,52003,Buonconvento,SI,98,0,0,0,0,0,0,0,0,0,0
2020,52003,Buonconvento,SI,99,0,0,0,0,0,0,0,0,0,0
2020,52003,Buonconvento,SI,100 e più,0,1,0,0,1,0,0,0,1,1
2020,52004,Casole d'Elsa,SI,0,14,0,0,0,14,9,0,0,0,9
2020,52004,Casole d'Elsa,SI,1,9,0,0,0,9,8,0,0,0,8
2020,52004,Casole d'Elsa,SI,2,11,0,0,0,11,15,0,0,0,15
2020,52004,Casole d'Elsa,SI,3,13,0,0,0,13,14,0,0,0,14
2020,52004,Casole d'Elsa,SI,4,20,0,0,0,20,20,0,0,0,20
2020,52004,Casole d'Elsa,SI,5,15,0,0,0,15,13,0,0,0,13
2020,52004,Casole d'Elsa,SI,6,20,0,0,0,20,12,0,0,0,12
2020,52004,Casole d'Elsa,SI,7,12,0,0,0,12,11,0,0,0,11
2020,52004,Casole d'Elsa,SI,8,23,0,0,0,23,14,0,0,0,14
2020,52004,Casole d'Elsa,SI,9,20,0,0,0,20,17,0,0,0,17
2020,52004,Casole d'Elsa,SI,10,13,0,0,0,13,23,0,0,0,23
2020,52004,Casole d'Elsa,SI,11,20,0,0,0,20,14,0,0,0,14
2020,52004,Casole d'Elsa,SI,12,24,0,0,0,24,25,0,0,0,25
2020,52004,Casole d'Elsa,SI,13,21,0,0,0,21,22,0,0,0,22
2020,52004,Casole d'Elsa,SI,14,19,0,0,0,19,15,0,0,0,15
2020,52004,Casole d'Elsa,SI,15,20,0,0,0,20,11,0,0,0,11
2020,52004,Casole d'Elsa,SI,16,17,0,0,0,17,11,0,0,0,11
2020,52004,Casole d'Elsa,SI,17,11,0,0,0,11,15,0,0,0,15
2020,52004,Casole d'Elsa,SI,18,16,0,0,0,16,11,0,0,0,11
2020,52004,Casole d'Elsa,SI,19,16,0,0,0,16,15,0,0,0,15
2020,52004,Casole d'Elsa,SI,20,24,0,0,0,24,18,0,0,0,18
2020,52004,Casole d'Elsa,SI,21,21,0,0,0,21,16,0,0,0,16
2020,52004,Casole d'Elsa,SI,22,22,0,0,0,22,12,1,0,0,13
2020,52004,Casole d'Elsa,SI,23,13,0,0,0,13,22,0,0,0,22
2020,52004,Casole d'Elsa,SI,24,18,0,0,0,18,20,1,0,0,21
2020,52004,Casole d'Elsa,SI,25,17,1,0,0,18,12,0,0,0,12
2020,52004,Casole d'Elsa,SI,26,16,0,0,0,16,10,4,0,0,14
2020,52004,Casole d'Elsa,SI,27,18,0,0,0,18,16,4,0,0,20
2020,52004,Casole d'Elsa,SI,28,20,1,0,0,21,13,3,0,0,16
2020,52004,Casole d'Elsa,SI,29,18,2,0,0,20,13,2,0,0,15
2020,52004,Casole d'Elsa,SI,30,9,2,0,0,11,11,8,0,0,19
2020,52004,Casole d'Elsa,SI,31,14,3,0,0,17,9,7,0,0,16
2020,52004,Casole d'Elsa,SI,32,5,8,0,0,13,12,4,1,0,17
2020,52004,Casole d'Elsa,SI,33,7,9,0,0,16,4,15,0,0,19
2020,52004,Casole d'Elsa,SI,34,12,7,0,0,19,6,10,0,0,16
2020,52004,Casole d'Elsa,SI,35,10,6,0,0,16,9,16,0,0,25
2020,52004,Casole d'Elsa,SI,36,8,9,0,0,17,11,10,0,0,21
2020,52004,Casole d'Elsa,SI,37,9,3,0,0,12,17,11,1,0,29
2020,52004,Casole d'Elsa,SI,38,10,15,0,0,25,13,16,2,0,31
2020,52004,Casole d'Elsa,SI,39,9,13,1,0,23,9,11,1,0,21
2020,52004,Casole d'Elsa,SI,40,5,11,0,0,16,3,11,0,0,14
2020,52004,Casole d'Elsa,SI,41,13,11,1,0,25,9,9,2,0,20
2020,52004,Casole d'Elsa,SI,42,10,21,1,0,32,10,21,1,0,32
2020,52004,Casole d'Elsa,SI,43,19,19,1,0,39,11,17,0,0,28
2020,52004,Casole d'Elsa,SI,44,20,11,0,0,31,10,27,2,0,39
2020,52004,Casole d'Elsa,SI,45,12,21,0,0,33,15,22,0,2,39
2020,52004,Casole d'Elsa,SI,46,12,11,0,0,23,16,20,2,0,38
2020,52004,Casole d'Elsa,SI,47,9,16,1,0,26,8,23,2,0,33
2020,52004,Casole d'Elsa,SI,48,8,24,1,0,33,8,24,1,0,33
2020,52004,Casole d'Elsa,SI,49,13,18,6,0,37,4,20,2,1,27
2020,52004,Casole d'Elsa,SI,50,11,19,0,0,30,3,20,2,0,25
2020,52004,Casole d'Elsa,SI,51,8,26,3,0,37,4,23,4,0,31
2020,52004,Casole d'Elsa,SI,52,7,33,3,0,43,5,27,4,0,36
2020,52004,Casole d'Elsa,SI,53,7,27,3,1,38,6,28,2,0,36
2020,52004,Casole d'Elsa,SI,54,6,22,4,0,32,9,29,3,2,43
2020,52004,Casole d'Elsa,SI,55,7,22,1,0,30,10,17,4,2,33
2020,52004,Casole d'Elsa,SI,56,6,26,2,0,34,4,21,3,1,29
2020,52004,Casole d'Elsa,SI,57,9,23,3,0,35,4,18,2,0,24
2020,52004,Casole d'Elsa,SI,58,5,20,2,0,27,3,29,1,1,34
2020,52004,Casole d'Elsa,SI,59,3,22,1,0,26,1,22,1,0,24
2020,52004,Casole d'Elsa,SI,60,6,21,1,0,28,3,22,2,2,29
2020,52004,Casole d'Elsa,SI,61,3,17,0,1,21,4,13,3,0,20
2020,52004,Casole d'Elsa,SI,62,4,22,1,0,27,3,26,2,3,34
2020,52004,Casole d'Elsa,SI,63,5,23,2,0,30,2,19,2,1,24
2020,52004,Casole d'Elsa,SI,64,3,17,1,0,21,3,13,1,2,19
2020,52004,Casole d'Elsa,SI,65,4,15,2,3,24,3,20,3,5,31
2020,52004,Casole d'Elsa,SI,66,2,20,1,0,23,1,14,1,3,19
2020,52004,Casole d'Elsa,SI,67,1,15,0,1,17,1,16,1,2,20
2020,52004,Casole d'Elsa,SI,68,3,12,3,1,19,2,10,2,4,18
2020,52004,Casole d'Elsa,SI,69,2,17,1,1,21,1,18,2,4,25
2020,52004,Casole d'Elsa,SI,70,7,22,0,0,29,1,16,1,4,22
2020,52004,Casole d'Elsa,SI,71,3,19,0,2,24,1,10,0,2,13
2020,52004,Casole d'Elsa,SI,72,3,16,0,0,19,1,15,1,4,21
2020,52004,Casole d'Elsa,SI,73,3,11,2,0,16,1,15,0,5,21
2020,52004,Casole d'Elsa,SI,74,2,13,1,0,16,0,19,1,5,25
2020,52004,Casole d'Elsa,SI,75,1,16,0,0,17,0,11,0,2,13
2020,52004,Casole d'Elsa,SI,76,3,12,3,0,18,0,16,0,4,20
2020,52004,Casole d'Elsa,SI,77,0,7,0,0,7,1,12,0,3,16
2020,52004,Casole d'Elsa,SI,78,0,11,0,2,13,0,5,0,9,14
2020,52004,Casole d'Elsa,SI,79,0,10,0,0,10,1,7,1,6,15
2020,52004,Casole d'Elsa,SI,80,1,11,0,0,12,0,7,1,6,14
2020,52004,Casole d'Elsa,SI,81,3,9,0,3,15,0,3,1,7,11
2020,52004,Casole d'Elsa,SI,82,2,16,0,0,18,0,5,0,7,12
2020,52004,Casole d'Elsa,SI,83,1,6,0,2,9,0,4,1,7,12
2020,52004,Casole d'Elsa,SI,84,2,7,0,1,10,2,3,0,4,9
2020,52004,Casole d'Elsa,SI,85,1,5,1,3,10,0,5,0,12,17
2020,52004,Casole d'Elsa,SI,86,0,7,0,0,7,1,1,0,11,13
2020,52004,Casole d'Elsa,SI,87,1,6,0,4,11,0,3,0,10,13
2020,52004,Casole d'Elsa,SI,88,1,6,0,2,9,0,1,0,11,12
2020,52004,Casole d'Elsa,SI,89,0,4,0,2,6,0,1,0,8,9
2020,52004,Casole d'Elsa,SI,90,0,0,0,4,4,0,0,1,5,6
2020,52004,Casole d'Elsa,SI,91,0,2,0,2,4,0,0,0,9,9
2020,52004,Casole d'Elsa,SI,92,0,1,0,3,4,0,1,0,5,6
2020,52004,Casole d'Elsa,SI,93,0,0,0,1,1,1,0,0,5,6
2020,52004,Casole d'Elsa,SI,94,0,1,0,1,2,0,0,0,1,1
2020,52004,Casole d'Elsa,SI,95,0,1,0,0,1,0,0,0,3,3
2020,52004,Casole d'Elsa,SI,96,0,0,0,0,0,0,0,0,4,4
2020,52004,Casole d'Elsa,SI,97,0,0,0,0,0,0,0,0,3,3
2020,52004,Casole d'Elsa,SI,98,0,0,0,0,0,0,0,0,2,2
2020,52004,Casole d'Elsa,SI,99,0,0,0,0,0,0,0,0,1,1
2020,52004,Casole d'Elsa,SI,100 e più,0,0,0,0,0,0,0,0,0,0
2020,52005,Castellina in Chianti,SI,0,11,0,0,0,11,9,0,0,0,9
2020,52005,Castellina in Chianti,SI,1,13,0,0,0,13,10,0,0,0,10
2020,52005,Castellina in Chianti,SI,2,16,0,0,0,16,9,0,0,0,9
2020,52005,Castellina in Chianti,SI,3,12,0,0,0,12,8,0,0,0,8
2020,52005,Castellina in Chianti,SI,4,12,0,0,0,12,11,0,0,0,11
2020,52005,Castellina in Chianti,SI,5,14,0,0,0,14,11,0,0,0,11
2020,52005,Castellina in Chianti,SI,6,14,0,0,0,14,11,0,0,0,11
2020,52005,Castellina in Chianti,SI,7,12,0,0,0,12,9,0,0,0,9
2020,52005,Castellina in Chianti,SI,8,8,0,0,0,8,10,0,0,0,10
2020,52005,Castellina in Chianti,SI,9,11,0,0,0,11,14,0,0,0,14
2020,52005,Castellina in Chianti,SI,10,16,0,0,0,16,13,0,0,0,13
2020,52005,Castellina in Chianti,SI,11,10,0,0,0,10,6,0,0,0,6
2020,52005,Castellina in Chianti,SI,12,10,0,0,0,10,6,0,0,0,6
2020,52005,Castellina in Chianti,SI,13,14,0,0,0,14,17,0,0,0,17
2020,52005,Castellina in Chianti,SI,14,13,0,0,0,13,15,0,0,0,15
2020,52005,Castellina in Chianti,SI,15,10,0,0,0,10,11,0,0,0,11
2020,52005,Castellina in Chianti,SI,16,13,0,0,0,13,10,0,0,0,10
2020,52005,Castellina in Chianti,SI,17,12,0,0,0,12,14,0,0,0,14
2020,52005,Castellina in Chianti,SI,18,17,0,0,0,17,13,0,0,0,13
2020,52005,Castellina in Chianti,SI,19,15,0,0,0,15,9,0,0,0,9
2020,52005,Castellina in Chianti,SI,20,17,0,0,0,17,9,0,0,0,9
2020,52005,Castellina in Chianti,SI,21,21,0,0,0,21,6,0,0,0,6
2020,52005,Castellina in Chianti,SI,22,22,0,0,0,22,8,2,0,0,10
2020,52005,Castellina in Chianti,SI,23,10,0,0,0,10,9,4,0,0,13
2020,52005,Castellina in Chianti,SI,24,16,0,0,0,16,14,1,0,0,15
2020,52005,Castellina in Chianti,SI,25,9,1,0,0,10,14,3,0,0,17
2020,52005,Castellina in Chianti,SI,26,11,0,0,0,11,7,2,0,0,9
2020,52005,Castellina in Chianti,SI,27,8,5,0,0,13,7,4,0,0,11
2020,52005,Castellina in Chianti,SI,28,14,0,0,0,14,8,6,0,0,14
2020,52005,Castellina in Chianti,SI,29,14,4,0,0,18,9,3,0,0,12
2020,52005,Castellina in Chianti,SI,30,13,3,0,0,16,5,6,0,0,11
2020,52005,Castellina in Chianti,SI,31,9,6,0,0,15,6,2,0,0,8
2020,52005,Castellina in Chianti,SI,32,17,3,0,0,20,6,7,0,0,13
2020,52005,Castellina in Chianti,SI,33,8,2,0,0,10,7,9,0,0,16
2020,52005,Castellina in Chianti,SI,34,9,9,0,0,18,7,6,0,0,13
2020,52005,Castellina in Chianti,SI,35,4,9,0,0,13,10,8,0,0,18
2020,52005,Castellina in Chianti,SI,36,5,6,0,0,11,5,7,1,0,13
2020,52005,Castellina in Chianti,SI,37,10,9,0,0,19,6,7,0,0,13
2020,52005,Castellina in Chianti,SI,38,6,12,0,0,18,12,15,0,0,27
2020,52005,Castellina in Chianti,SI,39,12,7,0,0,19,6,8,2,0,16
2020,52005,Castellina in Chianti,SI,40,8,7,0,2,17,6,6,1,0,13
2020,52005,Castellina in Chianti,SI,41,4,9,0,0,13,7,7,0,0,14
2020,52005,Castellina in Chianti,SI,42,9,9,0,0,18,4,11,1,0,16
2020,52005,Castellina in Chianti,SI,43,9,7,1,0,17,2,14,0,0,16
2020,52005,Castellina in Chianti,SI,44,14,16,2,0,32,6,6,0,0,12
2020,52005,Castellina in Chianti,SI,45,7,12,1,0,20,6,12,2,0,20
2020,52005,Castellina in Chianti,SI,46,12,9,1,0,22,4,11,1,0,16
2020,52005,Castellina in Chianti,SI,47,9,11,4,0,24,6,12,2,0,20
2020,52005,Castellina in Chianti,SI,48,14,9,1,0,24,2,18,3,1,24
2020,52005,Castellina in Chianti,SI,49,7,11,0,0,18,3,9,3,0,15
2020,52005,Castellina in Chianti,SI,50,6,21,0,0,27,4,15,3,0,22
2020,52005,Castellina in Chianti,SI,51,11,13,2,0,26,3,23,0,0,26
2020,52005,Castellina in Chianti,SI,52,3,13,1,0,17,6,16,0,1,23
2020,52005,Castellina in Chianti,SI,53,10,17,0,0,27,4,16,1,0,21
2020,52005,Castellina in Chianti,SI,54,9,24,2,0,35,4,11,1,1,17
2020,52005,Castellina in Chianti,SI,55,7,18,1,1,27,2,17,0,0,19
2020,52005,Castellina in Chianti,SI,56,4,26,3,0,33,4,16,3,3,26
2020,52005,Castellina in Chianti,SI,57,5,16,1,0,22,4,18,2,2,26
2020,52005,Castellina in Chianti,SI,58,9,9,3,1,22,5,10,3,0,18
2020,52005,Castellina in Chianti,SI,59,4,16,2,0,22,2,14,1,1,18
2020,52005,Castellina in Chianti,SI,60,5,10,0,0,15,3,18,3,1,25
2020,52005,Castellina in Chianti,SI,61,4,21,1,1,27,4,12,0,2,18
2020,52005,Castellina in Chianti,SI,62,1,19,2,0,22,3,19,3,1,26
2020,52005,Castellina in Chianti,SI,63,2,9,1,0,12,0,14,1,1,16
2020,52005,Castellina in Chianti,SI,64,3,19,0,0,22,2,9,1,1,13
2020,52005,Castellina in Chianti,SI,65,2,12,0,1,15,0,13,1,0,14
2020,52005,Castellina in Chianti,SI,66,3,14,0,0,17,0,8,0,4,12
2020,52005,Castellina in Chianti,SI,67,3,10,2,1,16,4,11,1,2,18
2020,52005,Castellina in Chianti,SI,68,0,13,0,1,14,2,14,0,1,17
2020,52005,Castellina in Chianti,SI,69,0,14,0,2,16,0,12,1,3,16
2020,52005,Castellina in Chianti,SI,70,1,13,1,0,15,1,16,0,0,17
2020,52005,Castellina in Chianti,SI,71,5,13,0,1,19,1,15,0,7,23
2020,52005,Castellina in Chianti,SI,72,2,11,1,0,14,1,2,0,2,5
2020,52005,Castellina in Chianti,SI,73,0,17,0,1,18,1,9,0,7,17
2020,52005,Castellina in Chianti,SI,74,0,6,1,1,8,2,6,1,4,13
2020,52005,Castellina in Chianti,SI,75,2,5,2,0,9,0,8,1,7,16
2020,52005,Castellina in Chianti,SI,76,0,11,2,1,14,0,5,0,2,7
2020,52005,Castellina in Chianti,SI,77,1,6,0,2,9,1,6,0,5,12
2020,52005,Castellina in Chianti,SI,78,0,2,0,0,2,0,4,1,5,10
2020,52005,Castellina in Chianti,SI,79,1,10,0,1,12,0,3,0,7,10
2020,52005,Castellina in Chianti,SI,80,2,10,0,3,15,0,8,0,10,18
2020,52005,Castellina in Chianti,SI,81,3,7,1,2,13,0,5,0,7,12
2020,52005,Castellina in Chianti,SI,82,1,11,1,2,15,0,1,0,6,7
2020,52005,Castellina in Chianti,SI,83,1,8,0,3,12,0,3,0,7,10
2020,52005,Castellina in Chianti,SI,84,1,4,0,1,6,0,3,0,7,10
2020,52005,Castellina in Chianti,SI,85,1,5,0,1,7,0,1,0,7,8
2020,52005,Castellina in Chianti,SI,86,0,3,0,1,4,0,3,0,9,12
2020,52005,Castellina in Chianti,SI,87,2,2,0,1,5,1,0,0,10,11
2020,52005,Castellina in Chianti,SI,88,0,3,0,0,3,0,1,0,9,10
2020,52005,Castellina in Chianti,SI,89,1,0,0,1,2,0,2,0,10,12
2020,52005,Castellina in Chianti,SI,90,0,0,0,2,2,2,0,0,3,5
2020,52005,Castellina in Chianti,SI,91,2,0,0,0,2,0,0,0,11,11
2020,52005,Castellina in Chianti,SI,92,0,0,0,0,0,0,0,0,4,4
2020,52005,Castellina in Chianti,SI,93,0,0,0,3,3,1,0,0,6,7
2020,52005,Castellina in Chianti,SI,94,1,1,0,0,2,0,0,0,0,0
2020,52005,Castellina in Chianti,SI,95,0,0,0,0,0,0,0,0,3,3
2020,52005,Castellina in Chianti,SI,96,0,0,0,1,1,0,0,0,2,2
2020,52005,Castellina in Chianti,SI,97,0,0,0,0,0,0,1,0,2,3
2020,52005,Castellina in Chianti,SI,98,0,0,0,0,0,0,0,0,2,2
2020,52005,Castellina in Chianti,SI,99,0,0,0,0,0,0,0,0,2,2
2020,52005,Castellina in Chianti,SI,100 e più,0,1,0,0,1,0,0,0,1,1
2020,52006,Castelnuovo Berardenga,SI,0,26,0,0,0,26,32,0,0,0,32
2020,52006,Castelnuovo Berardenga,SI,1,29,0,0,0,29,39,0,0,0,39
2020,52006,Castelnuovo Berardenga,SI,2,33,0,0,0,33,34,0,0,0,34
2020,52006,Castelnuovo Berardenga,SI,3,30,0,0,0,30,27,0,0,0,27
2020,52006,Castelnuovo Berardenga,SI,4,38,0,0,0,38,39,0,0,0,39
2020,52006,Castelnuovo Berardenga,SI,5,33,0,0,0,33,32,0,0,0,32
2020,52006,Castelnuovo Berardenga,SI,6,34,0,0,0,34,48,0,0,0,48
2020,52006,Castelnuovo Berardenga,SI,7,35,0,0,0,35,41,0,0,0,41
2020,52006,Castelnuovo Berardenga,SI,8,50,0,0,0,50,48,0,0,0,48
2020,52006,Castelnuovo Berardenga,SI,9,38,0,0,0,38,39,0,0,0,39
2020,52006,Castelnuovo Berardenga,SI,10,39,0,0,0,39,45,0,0,0,45
2020,52006,Castelnuovo Berardenga,SI,11,47,0,0,0,47,36,0,0,0,36
2020,52006,Castelnuovo Berardenga,SI,12,44,0,0,0,44,51,0,0,0,51
2020,52006,Castelnuovo Berardenga,SI,13,46,0,0,0,46,44,0,0,0,44
2020,52006,Castelnuovo Berardenga,SI,14,41,0,0,0,41,44,0,0,0,44
2020,52006,Castelnuovo Berardenga,SI,15,44,0,0,0,44,40,0,0,0,40
2020,52006,Castelnuovo Berardenga,SI,16,45,0,0,0,45,42,0,0,0,42
2020,52006,Castelnuovo Berardenga,SI,17,51,0,0,0,51,37,0,0,0,37
2020,52006,Castelnuovo Berardenga,SI,18,38,0,0,0,38,51,0,0,0,51
2020,52006,Castelnuovo Berardenga,SI,19,46,0,0,0,46,44,0,0,0,44
2020,52006,Castelnuovo Berardenga,SI,20,49,0,0,0,49,27,0,0,0,27
2020,52006,Castelnuovo Berardenga,SI,21,41,0,0,0,41,37,3,0,0,40
2020,52006,Castelnuovo Berardenga,SI,22,41,0,0,0,41,32,3,0,0,35
2020,52006,Castelnuovo Berardenga,SI,23,42,1,0,0,43,45,2,0,0,47
2020,52006,Castelnuovo Berardenga,SI,24,31,3,0,0,34,32,0,0,0,32
2020,52006,Castelnuovo Berardenga,SI,25,41,0,0,0,41,34,7,0,0,41
2020,52006,Castelnuovo Berardenga,SI,26,32,2,0,0,34,34,5,0,0,39
2020,52006,Castelnuovo Berardenga,SI,27,42,8,0,0,50,31,5,0,0,36
2020,52006,Castelnuovo Berardenga,SI,28,46,4,0,0,50,43,9,0,0,52
2020,52006,Castelnuovo Berardenga,SI,29,44,4,0,0,48,39,11,0,0,50
2020,52006,Castelnuovo Berardenga,SI,30,25,2,0,0,27,34,10,0,0,44
2020,52006,Castelnuovo Berardenga,SI,31,45,8,0,0,53,32,23,0,0,55
2020,52006,Castelnuovo Berardenga,SI,32,39,10,0,0,49,27,22,0,1,50
2020,52006,Castelnuovo Berardenga,SI,33,26,18,0,0,44,32,18,0,0,50
2020,52006,Castelnuovo Berardenga,SI,34,37,19,0,0,56,30,19,3,0,52
2020,52006,Castelnuovo Berardenga,SI,35,34,18,0,0,52,37,26,1,0,64
2020,52006,Castelnuovo Berardenga,SI,36,36,26,2,0,64,28,32,1,0,61
2020,52006,Castelnuovo Berardenga,SI,37,30,22,0,0,52,30,27,1,0,58
2020,52006,Castelnuovo Berardenga,SI,38,37,19,3,0,59,24,32,0,0,56
2020,52006,Castelnuovo Berardenga,SI,39,24,29,2,0,55,14,19,1,0,34
2020,52006,Castelnuovo Berardenga,SI,40,23,20,4,0,47,29,35,1,0,65
2020,52006,Castelnuovo Berardenga,SI,41,29,29,1,0,59,28,38,0,0,66
2020,52006,Castelnuovo Berardenga,SI,42,20,36,2,1,59,22,37,2,0,61
2020,52006,Castelnuovo Berardenga,SI,43,35,33,2,0,70,15,40,1,0,56
2020,52006,Castelnuovo Berardenga,SI,44,26,39,0,0,65,17,54,5,0,76
2020,52006,Castelnuovo Berardenga,SI,45,19,34,3,1,57,24,46,2,1,73
2020,52006,Castelnuovo Berardenga,SI,46,19,41,1,0,61,26,48,7,0,81
2020,52006,Castelnuovo Berardenga,SI,47,25,53,2,1,81,24,54,3,1,82
2020,52006,Castelnuovo Berardenga,SI,48,30,48,3,1,82,12,49,7,1,69
2020,52006,Castelnuovo Berardenga,SI,49,27,51,2,0,80,19,49,8,3,79
2020,52006,Castelnuovo Berardenga,SI,50,17,70,2,0,89,23,59,6,0,88
2020,52006,Castelnuovo Berardenga,SI,51,17,56,2,0,75,21,51,6,1,79
2020,52006,Castelnuovo Berardenga,SI,52,21,48,5,1,75,6,46,1,0,53
2020,52006,Castelnuovo Berardenga,SI,53,13,54,4,0,71,12,66,11,0,89
2020,52006,Castelnuovo Berardenga,SI,54,14,51,7,1,73,12,56,3,2,73
2020,52006,Castelnuovo Berardenga,SI,55,13,46,8,0,67,12,59,4,2,77
2020,52006,Castelnuovo Berardenga,SI,56,14,61,9,0,84,13,56,13,3,85
2020,52006,Castelnuovo Berardenga,SI,57,13,60,4,0,77,5,60,4,3,72
2020,52006,Castelnuovo Berardenga,SI,58,7,52,10,3,72,8,55,7,4,74
2020,52006,Castelnuovo Berardenga,SI,59,10,53,5,0,68,8,51,10,2,71
2020,52006,Castelnuovo Berardenga,SI,60,8,47,1,0,56,8,45,9,6,68
2020,52006,Castelnuovo Berardenga,SI,61,8,47,2,1,58,1,55,4,3,63
2020,52006,Castelnuovo Berardenga,SI,62,5,47,3,1,56,6,48,8,3,65
2020,52006,Castelnuovo Berardenga,SI,63,5,61,4,2,72,5,49,2,7,63
2020,52006,Castelnuovo Berardenga,SI,64,7,46,3,2,58,2,37,5,9,53
2020,52006,Castelnuovo Berardenga,SI,65,9,34,5,1,49,7,45,4,9,65
2020,52006,Castelnuovo Berardenga,SI,66,4,41,3,0,48,3,49,9,8,69
2020,52006,Castelnuovo Berardenga,SI,67,3,58,3,3,67,1,44,2,9,56
2020,52006,Castelnuovo Berardenga,SI,68,5,47,2,1,55,2,47,0,11,60
2020,52006,Castelnuovo Berardenga,SI,69,4,35,2,1,42,2,40,0,7,49
2020,52006,Castelnuovo Berardenga,SI,70,3,42,2,4,51,0,40,1,13,54
2020,52006,Castelnuovo Berardenga,SI,71,4,47,1,2,54,4,43,1,11,59
2020,52006,Castelnuovo Berardenga,SI,72,3,50,1,4,58,1,32,3,15,51
2020,52006,Castelnuovo Berardenga,SI,73,3,44,4,2,53,2,35,0,16,53
2020,52006,Castelnuovo Berardenga,SI,74,1,33,0,2,36,2,31,0,12,45
2020,52006,Castelnuovo Berardenga,SI,75,2,24,0,2,28,4,27,2,12,45
2020,52006,Castelnuovo Berardenga,SI,76,1,15,1,2,19,3,21,3,9,36
2020,52006,Castelnuovo Berardenga,SI,77,2,31,0,4,37,2,27,0,12,41
2020,52006,Castelnuovo Berardenga,SI,78,2,25,0,3,30,2,24,3,14,43
2020,52006,Castelnuovo Berardenga,SI,79,4,26,0,1,31,0,15,1,13,29
2020,52006,Castelnuovo Berardenga,SI,80,5,32,2,3,42,2,18,0,24,44
2020,52006,Castelnuovo Berardenga,SI,81,2,24,1,1,28,2,9,0,17,28
2020,52006,Castelnuovo Berardenga,SI,82,1,23,2,6,32,1,11,0,19,31
2020,52006,Castelnuovo Berardenga,SI,83,1,19,1,2,23,0,9,0,22,31
2020,52006,Castelnuovo Berardenga,SI,84,0,15,0,5,20,1,7,0,14,22
2020,52006,Castelnuovo Berardenga,SI,85,1,10,0,4,15,1,6,0,12,19
2020,52006,Castelnuovo Berardenga,SI,86,1,11,0,2,14,0,4,0,22,26
2020,52006,Castelnuovo Berardenga,SI,87,1,10,0,7,18,0,0,0,12,12
2020,52006,Castelnuovo Berardenga,SI,88,1,6,0,4,11,0,5,0,18,23
2020,52006,Castelnuovo Berardenga,SI,89,2,9,0,2,13,1,6,0,13,20
2020,52006,Castelnuovo Berardenga,SI,90,1,5,0,3,9,1,2,0,15,18
2020,52006,Castelnuovo Berardenga,SI,91,0,6,0,2,8,0,3,0,6,9
2020,52006,Castelnuovo Berardenga,SI,92,1,3,0,1,5,0,1,0,7,8
2020,52006,Castelnuovo Berardenga,SI,93,2,1,0,4,7,0,0,0,7,7
2020,52006,Castelnuovo Berardenga,SI,94,1,0,0,0,1,0,2,1,11,14
2020,52006,Castelnuovo Berardenga,SI,95,0,1,0,0,1,0,0,0,4,4
2020,52006,Castelnuovo Berardenga,SI,96,0,1,0,1,2,1,0,0,2,3
2020,52006,Castelnuovo Berardenga,SI,97,0,1,0,1,2,1,0,0,4,5
2020,52006,Castelnuovo Berardenga,SI,98,0,0,0,1,1,0,1,0,1,2
2020,52006,Castelnuovo Berardenga,SI,99,0,0,0,0,0,0,1,1,3,5
2020,52006,Castelnuovo Berardenga,SI,100 e più,0,0,0,2,2,1,0,0,3,4
2020,52007,Castiglione d'Orcia,SI,0,8,0,0,0,8,7,0,0,0,7
2020,52007,Castiglione d'Orcia,SI,1,6,0,0,0,6,8,0,0,0,8
2020,52007,Castiglione d'Orcia,SI,2,6,0,0,0,6,3,0,0,0,3
2020,52007,Castiglione d'Orcia,SI,3,7,0,0,0,7,6,0,0,0,6
2020,52007,Castiglione d'Orcia,SI,4,4,0,0,0,4,6,0,0,0,6
2020,52007,Castiglione d'Orcia,SI,5,9,0,0,0,9,2,0,0,0,2
2020,52007,Castiglione d'Orcia,SI,6,7,0,0,0,7,7,0,0,0,7
2020,52007,Castiglione d'Orcia,SI,7,3,0,0,0,3,3,0,0,0,3
2020,52007,Castiglione d'Orcia,SI,8,4,0,0,0,4,5,0,0,0,5
2020,52007,Castiglione d'Orcia,SI,9,10,0,0,0,10,6,0,0,0,6
2020,52007,Castiglione d'Orcia,SI,10,9,0,0,0,9,9,0,0,0,9
2020,52007,Castiglione d'Orcia,SI,11,7,0,0,0,7,9,0,0,0,9
2020,52007,Castiglione d'Orcia,SI,12,10,0,0,0,10,10,0,0,0,10
2020,52007,Castiglione d'Orcia,SI,13,8,0,0,0,8,8,0,0,0,8
2020,52007,Castiglione d'Orcia,SI,14,3,0,0,0,3,7,0,0,0,7
2020,52007,Castiglione d'Orcia,SI,15,11,0,0,0,11,8,0,0,0,8
2020,52007,Castiglione d'Orcia,SI,16,12,0,0,0,12,9,0,0,0,9
2020,52007,Castiglione d'Orcia,SI,17,8,0,0,0,8,6,0,0,0,6
2020,52007,Castiglione d'Orcia,SI,18,5,0,0,0,5,6,0,0,0,6
2020,52007,Castiglione d'Orcia,SI,19,10,0,0,0,10,9,0,0,0,9
2020,52007,Castiglione d'Orcia,SI,20,7,0,0,0,7,11,0,0,0,11
2020,52007,Castiglione d'Orcia,SI,21,9,0,0,0,9,11,0,0,0,11
2020,52007,Castiglione d'Orcia,SI,22,7,0,0,0,7,5,0,0,0,5
2020,52007,Castiglione d'Orcia,SI,23,11,0,0,0,11,10,2,0,0,12
2020,52007,Castiglione d'Orcia,SI,24,12,0,0,0,12,8,1,0,0,9
2020,52007,Castiglione d'Orcia,SI,25,8,0,0,0,8,7,0,0,0,7
2020,52007,Castiglione d'Orcia,SI,26,6,0,0,0,6,8,0,0,0,8
2020,52007,Castiglione d'Orcia,SI,27,10,0,0,0,10,6,0,0,0,6
2020,52007,Castiglione d'Orcia,SI,28,7,0,0,0,7,4,0,0,0,4
2020,52007,Castiglione d'Orcia,SI,29,4,2,0,0,6,8,3,0,0,11
2020,52007,Castiglione d'Orcia,SI,30,7,1,0,0,8,4,4,0,0,8
2020,52007,Castiglione d'Orcia,SI,31,7,2,0,0,9,11,0,0,0,11
2020,52007,Castiglione d'Orcia,SI,32,4,1,1,0,6,7,1,1,0,9
2020,52007,Castiglione d'Orcia,SI,33,1,3,0,0,4,3,2,0,0,5
2020,52007,Castiglione d'Orcia,SI,34,12,2,0,0,14,4,5,0,0,9
2020,52007,Castiglione d'Orcia,SI,35,7,2,0,0,9,0,2,0,0,2
2020,52007,Castiglione d'Orcia,SI,36,9,1,0,0,10,2,5,0,0,7
2020,52007,Castiglione d'Orcia,SI,37,8,1,0,0,9,6,2,0,0,8
2020,52007,Castiglione d'Orcia,SI,38,2,1,0,0,3,9,8,0,0,17
2020,52007,Castiglione d'Orcia,SI,39,8,6,0,0,14,14,6,0,0,20
2020,52007,Castiglione d'Orcia,SI,40,8,2,0,0,10,6,7,0,0,13
2020,52007,Castiglione d'Orcia,SI,41,5,4,0,0,9,5,9,1,0,15
2020,52007,Castiglione d'Orcia,SI,42,7,3,1,1,12,5,6,0,0,11
2020,52007,Castiglione d'Orcia,SI,43,8,13,1,0,22,5,12,1,0,18
2020,52007,Castiglione d'Orcia,SI,44,5,6,0,0,11,7,4,0,0,11
2020,52007,Castiglione d'Orcia,SI,45,5,9,0,0,14,9,8,0,2,19
2020,52007,Castiglione d'Orcia,SI,46,7,6,0,0,13,5,10,1,0,16
2020,52007,Castiglione d'Orcia,SI,47,4,8,3,0,15,5,12,0,0,17
2020,52007,Castiglione d'Orcia,SI,48,4,13,0,0,17,3,9,0,0,12
2020,52007,Castiglione d'Orcia,SI,49,12,17,2,0,31,4,11,2,0,17
2020,52007,Castiglione d'Orcia,SI,50,9,10,1,0,20,3,12,1,0,16
2020,52007,Castiglione d'Orcia,SI,51,12,5,1,0,18,6,7,5,0,18
2020,52007,Castiglione d'Orcia,SI,52,3,5,0,0,8,5,14,1,1,21
2020,52007,Castiglione d'Orcia,SI,53,4,8,3,0,15,3,11,0,2,16
2020,52007,Castiglione d'Orcia,SI,54,2,8,0,0,10,4,15,2,0,21
2020,52007,Castiglione d'Orcia,SI,55,5,11,0,0,16,3,14,2,0,19
2020,52007,Castiglione d'Orcia,SI,56,4,15,2,0,21,0,18,1,1,20
2020,52007,Castiglione d'Orcia,SI,57,1,16,1,1,19,1,16,1,1,19
2020,52007,Castiglione d'Orcia,SI,58,4,11,1,0,16,0,9,1,0,10
2020,52007,Castiglione d'Orcia,SI,59,1,12,0,0,13,0,13,1,0,14
2020,52007,Castiglione d'Orcia,SI,60,2,11,2,1,16,1,9,0,2,12
2020,52007,Castiglione d'Orcia,SI,61,2,11,1,0,14,0,13,1,2,16
2020,52007,Castiglione d'Orcia,SI,62,0,8,0,0,8,1,17,1,4,23
2020,52007,Castiglione d'Orcia,SI,63,2,8,0,0,10,2,15,1,2,20
2020,52007,Castiglione d'Orcia,SI,64,3,17,2,0,22,0,11,1,2,14
2020,52007,Castiglione d'Orcia,SI,65,2,13,1,0,16,1,5,1,5,12
2020,52007,Castiglione d'Orcia,SI,66,3,15,2,2,22,2,9,0,3,14
2020,52007,Castiglione d'Orcia,SI,67,4,9,2,0,15,1,12,2,2,17
2020,52007,Castiglione d'Orcia,SI,68,3,12,1,1,17,0,16,0,3,19
2020,52007,Castiglione d'Orcia,SI,69,5,10,2,0,17,2,8,1,5,16
2020,52007,Castiglione d'Orcia,SI,70,2,14,1,1,18,0,10,0,1,11
2020,52007,Castiglione d'Orcia,SI,71,2,15,1,1,19,0,16,0,4,20
2020,52007,Castiglione d'Orcia,SI,72,2,17,0,5,24,1,14,0,7,22
2020,52007,Castiglione d'Orcia,SI,73,0,15,0,2,17,1,9,0,5,15
2020,52007,Castiglione d'Orcia,SI,74,0,13,0,3,16,0,6,1,1,8
2020,52007,Castiglione d'Orcia,SI,75,2,13,1,1,17,0,7,1,6,14
2020,52007,Castiglione d'Orcia,SI,76,1,10,0,1,12,0,8,0,1,9
2020,52007,Castiglione d'Orcia,SI,77,1,9,0,0,10,0,6,0,5,11
2020,52007,Castiglione d'Orcia,SI,78,0,4,0,1,5,0,9,1,2,12
2020,52007,Castiglione d'Orcia,SI,79,1,10,0,1,12,0,6,0,5,11
2020,52007,Castiglione d'Orcia,SI,80,0,6,1,0,7,0,4,0,6,10
2020,52007,Castiglione d'Orcia,SI,81,2,9,0,3,14,0,9,0,12,21
2020,52007,Castiglione d'Orcia,SI,82,0,8,0,0,8,0,6,0,7,13
2020,52007,Castiglione d'Orcia,SI,83,3,3,0,2,8,0,5,0,7,12
2020,52007,Castiglione d'Orcia,SI,84,1,5,0,3,9,0,2,0,6,8
2020,52007,Castiglione d'Orcia,SI,85,0,5,0,1,6,0,6,0,11,17
2020,52007,Castiglione d'Orcia,SI,86,2,10,0,2,14,0,5,0,11,16
2020,52007,Castiglione d'Orcia,SI,87,0,6,1,1,8,0,1,0,9,10
2020,52007,Castiglione d'Orcia,SI,88,0,5,0,3,8,0,1,0,6,7
2020,52007,Castiglione d'Orcia,SI,89,0,7,0,2,9,0,0,0,9,9
2020,52007,Castiglione d'Orcia,SI,90,0,2,0,2,4,0,2,0,14,16
2020,52007,Castiglione d'Orcia,SI,91,0,4,0,1,5,1,2,0,6,9
2020,52007,Castiglione d'Orcia,SI,92,0,2,0,1,3,0,1,0,7,8
2020,52007,Castiglione d'Orcia,SI,93,0,3,0,1,4,0,0,0,7,7
2020,52007,Castiglione d'Orcia,SI,94,0,1,0,2,3,0,1,0,1,2
2020,52007,Castiglione d'Orcia,SI,95,0,1,0,0,1,0,0,0,5,5
2020,52007,Castiglione d'Orcia,SI,96,0,0,0,0,0,0,1,0,1,2
2020,52007,Castiglione d'Orcia,SI,97,0,1,0,0,1,0,0,0,3,3
2020,52007,Castiglione d'Orcia,SI,98,0,0,0,0,0,0,0,0,2,2
2020,52007,Castiglione d'Orcia,SI,99,0,0,0,0,0,0,0,0,0,0
2020,52007,Castiglione d'Orcia,SI,100 e più,0,0,0,0,0,0,0,0,2,2
2020,52008,Cetona,SI,0,4,0,0,0,4,6,0,0,0,6
2020,52008,Cetona,SI,1,4,0,0,0,4,7,0,0,0,7
2020,52008,Cetona,SI,2,1,0,0,0,1,6,0,0,0,6
2020,52008,Cetona,SI,3,7,0,0,0,7,5,0,0,0,5
2020,52008,Cetona,SI,4,8,0,0,0,8,12,0,0,0,12
2020,52008,Cetona,SI,5,9,0,0,0,9,6,0,0,0,6
2020,52008,Cetona,SI,6,8,0,0,0,8,6,0,0,0,6
2020,52008,Cetona,SI,7,7,0,0,0,7,11,0,0,0,11
2020,52008,Cetona,SI,8,6,0,0,0,6,10,0,0,0,10
2020,52008,Cetona,SI,9,12,0,0,0,12,10,0,0,0,10
2020,52008,Cetona,SI,10,12,0,0,0,12,9,0,0,0,9
2020,52008,Cetona,SI,11,14,0,0,0,14,14,0,0,0,14
2020,52008,Cetona,SI,12,6,0,0,0,6,9,0,0,0,9
2020,52008,Cetona,SI,13,9,0,0,0,9,11,0,0,0,11
2020,52008,Cetona,SI,14,10,0,0,0,10,10,0,0,0,10
2020,52008,Cetona,SI,15,8,0,0,0,8,7,0,0,0,7
2020,52008,Cetona,SI,16,11,0,0,0,11,8,0,0,0,8
2020,52008,Cetona,SI,17,10,0,0,0,10,10,0,0,0,10
2020,52008,Cetona,SI,18,10,0,0,0,10,6,0,0,0,6
2020,52008,Cetona,SI,19,10,0,0,0,10,15,0,0,0,15
2020,52008,Cetona,SI,20,13,0,0,0,13,8,0,0,0,8
2020,52008,Cetona,SI,21,8,0,0,0,8,6,0,0,0,6
2020,52008,Cetona,SI,22,11,0,0,0,11,13,1,0,0,14
2020,52008,Cetona,SI,23,10,0,0,0,10,5,0,0,0,5
2020,52008,Cetona,SI,24,18,0,0,0,18,8,0,0,0,8
2020,52008,Cetona,SI,25,17,0,0,0,17,7,0,0,0,7
2020,52008,Cetona,SI,26,8,0,0,0,8,9,1,0,0,10
2020,52008,Cetona,SI,27,10,0,0,0,10,13,0,0,0,13
2020,52008,Cetona,SI,28,9,0,0,0,9,11,1,0,0,12
2020,52008,Cetona,SI,29,7,1,0,0,8,8,1,0,0,9
2020,52008,Cetona,SI,30,12,1,0,0,13,7,6,0,0,13
2020,52008,Cetona,SI,31,10,1,0,0,11,2,5,0,0,7
2020,52008,Cetona,SI,32,7,0,0,0,7,4,4,0,0,8
2020,52008,Cetona,SI,33,12,2,0,0,14,4,3,0,0,7
2020,52008,Cetona,SI,34,6,2,0,0,8,7,5,0,0,12
2020,52008,Cetona,SI,35,6,2,0,0,8,7,3,0,0,10
2020,52008,Cetona,SI,36,7,7,0,0,14,8,5,0,0,13
2020,52008,Cetona,SI,37,5,8,0,0,13,5,5,0,0,10
2020,52008,Cetona,SI,38,7,3,0,0,10,8,3,0,0,11
2020,52008,Cetona,SI,39,3,3,0,0,6,6,2,0,0,8
2020,52008,Cetona,SI,40,6,7,0,0,13,9,4,1,0,14
2020,52008,Cetona,SI,41,12,6,0,0,18,7,8,0,0,15
2020,52008,Cetona,SI,42,2,5,0,0,7,4,13,0,0,17
2020,52008,Cetona,SI,43,11,2,0,0,13,8,9,0,0,17
2020,52008,Cetona,SI,44,7,13,0,0,20,4,14,0,1,19
2020,52008,Cetona,SI,45,11,7,1,0,19,2,13,0,0,15
2020,52008,Cetona,SI,46,10,7,1,0,18,7,9,2,0,18
2020,52008,Cetona,SI,47,9,8,0,0,17,5,13,0,1,19
2020,52008,Cetona,SI,48,4,11,3,0,18,1,18,2,0,21
2020,52008,Cetona,SI,49,8,10,0,0,18,9,14,0,1,24
2020,52008,Cetona,SI,50,2,6,0,0,8,6,12,1,0,19
2020,52008,Cetona,SI,51,4,13,1,0,18,1,7,2,1,11
2020,52008,Cetona,SI,52,6,22,2,0,30,4,14,1,1,20
2020,52008,Cetona,SI,53,3,17,1,1,22,4,20,1,1,26
2020,52008,Cetona,SI,54,10,14,0,0,24,1,16,2,1,20
2020,52008,Cetona,SI,55,9,14,2,0,25,5,13,2,1,21
2020,52008,Cetona,SI,56,5,18,2,0,25,2,8,3,1,14
2020,52008,Cetona,SI,57,3,10,1,0,14,1,21,3,1,26
2020,52008,Cetona,SI,58,5,14,0,0,19,2,12,1,2,17
2020,52008,Cetona,SI,59,4,11,1,0,16,2,15,1,4,22
2020,52008,Cetona,SI,60,1,19,2,0,22,2,15,1,1,19
2020,52008,Cetona,SI,61,2,17,0,0,19,1,14,1,3,19
2020,52008,Cetona,SI,62,3,13,1,1,18,3,19,2,3,27
2020,52008,Cetona,SI,63,1,8,0,0,9,2,19,2,1,24
2020,52008,Cetona,SI,64,1,18,0,0,19,2,10,0,2,14
2020,52008,Cetona,SI,65,3,12,1,0,16,0,11,1,2,14
2020,52008,Cetona,SI,66,4,12,2,0,18,2,16,1,3,22
2020,52008,Cetona,SI,67,2,18,1,1,22,1,23,0,2,26
2020,52008,Cetona,SI,68,0,23,0,1,24,1,19,0,3,23
2020,52008,Cetona,SI,69,3,13,0,0,16,0,12,1,4,17
2020,52008,Cetona,SI,70,2,19,2,1,24,0,11,0,2,13
2020,52008,Cetona,SI,71,1,13,0,2,16,3,11,2,6,22
2020,52008,Cetona,SI,72,1,18,2,1,22,2,18,1,4,25
2020,52008,Cetona,SI,73,2,20,1,3,26,2,9,1,3,15
2020,52008,Cetona,SI,74,5,12,1,0,18,0,8,1,9,18
2020,52008,Cetona,SI,75,4,6,0,1,11,0,6,0,5,11
2020,52008,Cetona,SI,76,2,9,0,2,13,2,6,0,3,11
2020,52008,Cetona,SI,77,4,11,0,2,17,0,7,0,11,18
2020,52008,Cetona,SI,78,0,5,0,0,5,1,3,0,10,14
2020,52008,Cetona,SI,79,0,6,0,1,7,1,8,0,11,20
2020,52008,Cetona,SI,80,1,11,0,1,13,0,13,0,10,23
2020,52008,Cetona,SI,81,2,7,0,2,11,1,7,0,12,20
2020,52008,Cetona,SI,82,1,8,1,1,11,1,5,0,14,20
2020,52008,Cetona,SI,83,1,6,0,2,9,1,3,0,12,16
2020,52008,Cetona,SI,84,1,9,0,2,12,1,4,0,10,15
2020,52008,Cetona,SI,85,1,9,1,0,11,0,3,0,8,11
2020,52008,Cetona,SI,86,0,9,0,0,9,0,2,0,15,17
2020,52008,Cetona,SI,87,0,5,0,1,6,0,1,0,7,8
2020,52008,Cetona,SI,88,0,1,1,1,3,0,1,0,5,6
2020,52008,Cetona,SI,89,1,6,0,1,8,0,3,0,7,10
2020,52008,Cetona,SI,90,0,4,0,1,5,0,1,0,13,14
2020,52008,Cetona,SI,91,0,2,0,2,4,1,1,0,7,9
2020,52008,Cetona,SI,92,0,4,0,0,4,0,1,0,4,5
2020,52008,Cetona,SI,93,0,2,0,2,4,0,1,0,10,11
2020,52008,Cetona,SI,94,1,0,0,0,1,0,1,0,4,5
2020,52008,Cetona,SI,95,0,0,0,0,0,0,1,0,4,5
2020,52008,Cetona,SI,96,0,0,0,0,0,0,0,0,3,3
2020,52008,Cetona,SI,97,0,0,0,1,1,0,0,0,2,2
2020,52008,Cetona,SI,98,0,0,0,0,0,0,0,0,1,1
2020,52008,Cetona,SI,99,0,0,0,0,0,0,1,0,0,1
2020,52008,Cetona,SI,100 e più,0,0,0,0,0,0,0,0,0,0
2020,52009,Chianciano Terme,SI,0,14,0,0,0,14,14,0,0,0,14
2020,52009,Chianciano Terme,SI,1,24,0,0,0,24,21,0,0,0,21
2020,52009,Chianciano Terme,SI,2,20,0,0,0,20,15,0,0,0,15
2020,52009,Chianciano Terme,SI,3,23,0,0,0,23,24,0,0,0,24
2020,52009,Chianciano Terme,SI,4,26,0,0,0,26,18,0,0,0,18
2020,52009,Chianciano Terme,SI,5,23,0,0,0,23,15,0,0,0,15
2020,52009,Chianciano Terme,SI,6,29,0,0,0,29,20,0,0,0,20
2020,52009,Chianciano Terme,SI,7,23,0,0,0,23,13,0,0,0,13
2020,52009,Chianciano Terme,SI,8,21,0,0,0,21,20,0,0,0,20
2020,52009,Chianciano Terme,SI,9,19,0,0,0,19,35,0,0,0,35
2020,52009,Chianciano Terme,SI,10,22,0,0,0,22,22,0,0,0,22
2020,52009,Chianciano Terme,SI,11,26,0,0,0,26,28,0,0,0,28
2020,52009,Chianciano Terme,SI,12,29,0,0,0,29,23,0,0,0,23
2020,52009,Chianciano Terme,SI,13,33,0,0,0,33,18,0,0,0,18
2020,52009,Chianciano Terme,SI,14,28,0,0,0,28,29,0,0,0,29
2020,52009,Chianciano Terme,SI,15,29,0,0,0,29,39,0,0,0,39
2020,52009,Chianciano Terme,SI,16,22,0,0,0,22,26,0,0,0,26
2020,52009,Chianciano Terme,SI,17,34,0,0,0,34,31,0,0,0,31
2020,52009,Chianciano Terme,SI,18,23,0,0,0,23,24,0,0,0,24
2020,52009,Chianciano Terme,SI,19,36,0,0,0,36,25,0,0,0,25
2020,52009,Chianciano Terme,SI,20,31,1,0,0,32,24,0,0,0,24
2020,52009,Chianciano Terme,SI,21,36,0,0,0,36,34,1,0,0,35
2020,52009,Chianciano Terme,SI,22,31,0,0,0,31,26,0,0,0,26
2020,52009,Chianciano Terme,SI,23,39,0,0,0,39,35,1,0,0,36
2020,52009,Chianciano Terme,SI,24,34,1,0,0,35,27,1,0,0,28
2020,52009,Chianciano Terme,SI,25,32,1,0,0,33,24,4,0,0,28
2020,52009,Chianciano Terme,SI,26,33,1,0,0,34,18,0,1,0,19
2020,52009,Chianciano Terme,SI,27,33,2,0,0,35,24,3,0,0,27
2020,52009,Chianciano Terme,SI,28,32,1,2,0,35,24,7,0,0,31
2020,52009,Chianciano Terme,SI,29,26,1,0,0,27,15,4,0,0,19
2020,52009,Chianciano Terme,SI,30,34,10,0,0,44,24,9,0,0,33
2020,52009,Chianciano Terme,SI,31,21,8,1,0,30,16,8,0,0,24
2020,52009,Chianciano Terme,SI,32,30,7,0,0,37,23,6,0,0,29
2020,52009,Chianciano Terme,SI,33,29,9,0,0,38,20,8,0,0,28
2020,52009,Chianciano Terme,SI,34,28,6,0,0,34,21,18,0,0,39
2020,52009,Chianciano Terme,SI,35,25,9,0,0,34,15,13,0,0,28
2020,52009,Chianciano Terme,SI,36,23,14,0,0,37,22,12,2,0,36
2020,52009,Chianciano Terme,SI,37,21,6,1,0,28,20,17,2,1,40
2020,52009,Chianciano Terme,SI,38,33,12,1,0,46,15,25,4,0,44
2020,52009,Chianciano Terme,SI,39,29,11,1,0,41,16,12,3,0,31
2020,52009,Chianciano Terme,SI,40,33,8,0,0,41,14,18,0,0,32
2020,52009,Chianciano Terme,SI,41,25,8,0,0,33,26,29,1,0,56
2020,52009,Chianciano Terme,SI,42,27,16,0,0,43,19,26,2,0,47
2020,52009,Chianciano Terme,SI,43,13,30,1,0,44,26,24,1,0,51
2020,52009,Chianciano Terme,SI,44,23,27,0,0,50,25,28,2,0,55
2020,52009,Chianciano Terme,SI,45,17,25,2,0,44,24,31,4,0,59
2020,52009,Chianciano Terme,SI,46,18,26,3,0,47,16,33,5,0,54
2020,52009,Chianciano Terme,SI,47,17,44,2,0,63,14,38,0,1,53
2020,52009,Chianciano Terme,SI,48,25,31,1,1,58,17,36,5,0,58
2020,52009,Chianciano Terme,SI,49,20,24,2,0,46,12,32,4,0,48
2020,52009,Chianciano Terme,SI,50,14,29,3,1,47,10,29,7,1,47
2020,52009,Chianciano Terme,SI,51,19,40,7,0,66,16,45,6,0,67
2020,52009,Chianciano Terme,SI,52,14,30,3,0,47,15,43,11,1,70
2020,52009,Chianciano Terme,SI,53,15,40,4,3,62,10,48,4,1,63
2020,52009,Chianciano Terme,SI,54,16,50,4,1,71,10,35,9,3,57
2020,52009,Chianciano Terme,SI,55,15,36,6,0,57,9,30,4,1,44
2020,52009,Chianciano Terme,SI,56,10,37,4,0,51,8,47,2,1,58
2020,52009,Chianciano Terme,SI,57,14,35,3,0,52,19,37,6,3,65
2020,52009,Chianciano Terme,SI,58,6,34,4,0,44,15,25,6,4,50
2020,52009,Chianciano Terme,SI,59,7,40,3,0,50,3,33,6,4,46
2020,52009,Chianciano Terme,SI,60,1,29,6,0,36,9,32,4,2,47
2020,52009,Chianciano Terme,SI,61,3,28,2,0,33,2,33,5,6,46
2020,52009,Chianciano Terme,SI,62,6,21,3,1,31,3,33,5,2,43
2020,52009,Chianciano Terme,SI,63,4,25,3,2,34,8,32,10,7,57
2020,52009,Chianciano Terme,SI,64,8,33,6,0,47,4,32,4,4,44
2020,52009,Chianciano Terme,SI,65,7,24,4,3,38,6,39,4,9,58
2020,52009,Chianciano Terme,SI,66,0,39,1,0,40,9,30,6,4,49
2020,52009,Chianciano Terme,SI,67,0,34,4,2,40,3,26,5,3,37
2020,52009,Chianciano Terme,SI,68,2,35,3,0,40,3,28,6,9,46
2020,52009,Chianciano Terme,SI,69,2,29,2,2,35,4,28,10,6,48
2020,52009,Chianciano Terme,SI,70,1,30,7,1,39,2,26,3,15,46
2020,52009,Chianciano Terme,SI,71,3,29,4,1,37,3,46,7,10,66
2020,52009,Chianciano Terme,SI,72,4,35,5,3,47,1,36,3,12,52
2020,52009,Chianciano Terme,SI,73,2,32,2,4,40,5,26,2,12,45
2020,52009,Chianciano Terme,SI,74,1,36,3,4,44,6,27,3,23,59
2020,52009,Chianciano Terme,SI,75,1,20,3,1,25,4,32,1,17,54
2020,52009,Chianciano Terme,SI,76,1,27,0,2,30,0,22,2,17,41
2020,52009,Chianciano Terme,SI,77,1,22,1,2,26,1,18,3,17,39
2020,52009,Chianciano Terme,SI,78,1,27,0,3,31,6,18,0,15,39
2020,52009,Chianciano Terme,SI,79,2,27,1,2,32,2,18,2,20,42
2020,52009,Chianciano Terme,SI,80,1,26,1,8,36,4,21,3,28,56
2020,52009,Chianciano Terme,SI,81,1,20,1,7,29,3,13,2,29,47
2020,52009,Chianciano Terme,SI,82,1,25,0,6,32,0,16,0,30,46
2020,52009,Chianciano Terme,SI,83,2,18,1,4,25,3,16,3,27,49
2020,52009,Chianciano Terme,SI,84,0,20,0,4,24,0,9,3,20,32
2020,52009,Chianciano Terme,SI,85,0,13,0,8,21,3,7,0,16,26
2020,52009,Chianciano Terme,SI,86,1,17,1,4,23,2,13,0,29,44
2020,52009,Chianciano Terme,SI,87,0,14,1,2,17,1,2,0,25,28
2020,52009,Chianciano Terme,SI,88,2,6,0,7,15,3,6,0,16,25
2020,52009,Chianciano Terme,SI,89,1,13,0,4,18,1,0,1,15,17
2020,52009,Chianciano Terme,SI,90,1,7,1,4,13,1,0,0,25,26
2020,52009,Chianciano Terme,SI,91,0,5,0,3,8,0,1,1,16,18
2020,52009,Chianciano Terme,SI,92,0,4,0,5,9,0,0,0,10,10
2020,52009,Chianciano Terme,SI,93,0,2,0,3,5,1,0,0,13,14
2020,52009,Chianciano Terme,SI,94,0,1,0,3,4,0,1,0,13,14
2020,52009,Chianciano Terme,SI,95,0,0,0,0,0,0,1,0,7,8
2020,52009,Chianciano Terme,SI,96,0,0,0,0,0,1,0,0,4,5
2020,52009,Chianciano Terme,SI,97,0,2,0,0,2,0,1,1,2,4
2020,52009,Chianciano Terme,SI,98,0,0,0,0,0,0,0,0,3,3
2020,52009,Chianciano Terme,SI,99,0,0,0,2,2,0,0,0,3,3
2020,52009,Chianciano Terme,SI,100 e più,0,0,0,0,0,0,0,0,1,1
2020,52010,Chiusdino,SI,0,8,0,0,0,8,11,0,0,0,11
2020,52010,Chiusdino,SI,1,5,0,0,0,5,12,0,0,0,12
2020,52010,Chiusdino,SI,2,4,0,0,0,4,8,0,0,0,8
2020,52010,Chiusdino,SI,3,9,0,0,0,9,7,0,0,0,7
2020,52010,Chiusdino,SI,4,8,0,0,0,8,6,0,0,0,6
2020,52010,Chiusdino,SI,5,8,0,0,0,8,7,0,0,0,7
2020,52010,Chiusdino,SI,6,11,0,0,0,11,14,0,0,0,14
2020,52010,Chiusdino,SI,7,14,0,0,0,14,10,0,0,0,10
2020,52010,Chiusdino,SI,8,9,0,0,0,9,5,0,0,0,5
2020,52010,Chiusdino,SI,9,6,0,0,0,6,6,0,0,0,6
2020,52010,Chiusdino,SI,10,6,0,0,0,6,5,0,0,0,5
2020,52010,Chiusdino,SI,11,6,0,0,0,6,7,0,0,0,7
2020,52010,Chiusdino,SI,12,10,0,0,0,10,3,0,0,0,3
2020,52010,Chiusdino,SI,13,8,0,0,0,8,7,0,0,0,7
2020,52010,Chiusdino,SI,14,6,0,0,0,6,5,0,0,0,5
2020,52010,Chiusdino,SI,15,6,0,0,0,6,6,0,0,0,6
2020,52010,Chiusdino,SI,16,8,0,0,0,8,6,0,0,0,6
2020,52010,Chiusdino,SI,17,5,0,0,0,5,8,0,0,0,8
2020,52010,Chiusdino,SI,18,9,0,0,0,9,9,0,0,0,9
2020,52010,Chiusdino,SI,19,7,1,0,0,8,8,0,0,0,8
2020,52010,Chiusdino,SI,20,11,1,0,0,12,9,0,0,0,9
2020,52010,Chiusdino,SI,21,11,0,0,0,11,10,0,0,0,10
2020,52010,Chiusdino,SI,22,4,0,0,0,4,4,2,0,0,6
2020,52010,Chiusdino,SI,23,6,0,0,0,6,6,1,0,0,7
2020,52010,Chiusdino,SI,24,3,4,0,0,7,9,0,0,0,9
2020,52010,Chiusdino,SI,25,6,1,0,0,7,12,1,0,0,13
2020,52010,Chiusdino,SI,26,5,0,0,0,5,4,0,1,0,5
2020,52010,Chiusdino,SI,27,10,3,0,0,13,4,4,0,0,8
2020,52010,Chiusdino,SI,28,7,1,0,0,8,12,3,0,0,15
2020,52010,Chiusdino,SI,29,7,1,0,0,8,7,4,1,0,12
2020,52010,Chiusdino,SI,30,5,6,0,0,11,6,3,0,0,9
2020,52010,Chiusdino,SI,31,6,4,0,0,10,4,3,0,0,7
2020,52010,Chiusdino,SI,32,7,1,0,0,8,3,4,0,0,7
2020,52010,Chiusdino,SI,33,8,1,0,0,9,4,12,0,0,16
2020,52010,Chiusdino,SI,34,7,2,0,0,9,4,5,1,0,10
2020,52010,Chiusdino,SI,35,12,4,0,0,16,4,9,0,0,13
2020,52010,Chiusdino,SI,36,6,9,0,0,15,4,7,1,0,12
2020,52010,Chiusdino,SI,37,4,6,0,0,10,2,6,0,0,8
2020,52010,Chiusdino,SI,38,7,7,0,0,14,5,3,1,0,9
2020,52010,Chiusdino,SI,39,4,7,0,0,11,5,6,0,0,11
2020,52010,Chiusdino,SI,40,7,7,0,0,14,2,7,0,0,9
2020,52010,Chiusdino,SI,41,7,4,2,0,13,8,5,0,0,13
2020,52010,Chiusdino,SI,42,10,5,0,0,15,4,9,1,0,14
2020,52010,Chiusdino,SI,43,4,8,0,0,12,3,6,3,0,12
2020,52010,Chiusdino,SI,44,1,5,0,0,6,3,7,0,0,10
2020,52010,Chiusdino,SI,45,3,7,1,0,11,2,4,0,0,6
2020,52010,Chiusdino,SI,46,4,14,0,0,18,5,7,1,0,13
2020,52010,Chiusdino,SI,47,5,5,0,0,10,5,9,0,0,14
2020,52010,Chiusdino,SI,48,5,5,2,0,12,1,11,0,0,12
2020,52010,Chiusdino,SI,49,5,2,1,0,8,1,9,1,0,11
2020,52010,Chiusdino,SI,50,6,6,0,0,12,4,6,1,0,11
2020,52010,Chiusdino,SI,51,3,11,0,0,14,0,10,0,0,10
2020,52010,Chiusdino,SI,52,2,10,1,0,13,1,5,1,1,8
2020,52010,Chiusdino,SI,53,6,16,0,0,22,1,10,0,0,11
2020,52010,Chiusdino,SI,54,2,10,1,1,14,1,19,1,0,21
2020,52010,Chiusdino,SI,55,2,9,2,0,13,2,9,1,0,12
2020,52010,Chiusdino,SI,56,4,14,0,1,19,0,6,1,0,7
2020,52010,Chiusdino,SI,57,5,14,0,0,19,1,6,1,1,9
2020,52010,Chiusdino,SI,58,1,11,0,0,12,1,14,1,0,16
2020,52010,Chiusdino,SI,59,1,10,1,0,12,0,12,0,3,15
2020,52010,Chiusdino,SI,60,2,8,1,0,11,4,8,1,0,13
2020,52010,Chiusdino,SI,61,2,3,1,1,7,2,12,1,0,15
2020,52010,Chiusdino,SI,62,1,9,1,0,11,0,11,1,0,12
2020,52010,Chiusdino,SI,63,1,9,1,0,11,1,10,0,0,11
2020,52010,Chiusdino,SI,64,1,8,1,0,10,4,8,1,2,15
2020,52010,Chiusdino,SI,65,1,13,0,0,14,1,6,1,1,9
2020,52010,Chiusdino,SI,66,1,15,0,1,17,1,8,1,0,10
2020,52010,Chiusdino,SI,67,1,8,0,0,9,1,4,4,2,11
2020,52010,Chiusdino,SI,68,2,8,3,0,13,0,6,2,0,8
2020,52010,Chiusdino,SI,69,1,13,1,0,15,0,7,1,2,10
2020,52010,Chiusdino,SI,70,0,12,0,0,12,0,7,1,2,10
2020,52010,Chiusdino,SI,71,1,6,0,1,8,2,11,2,1,16
2020,52010,Chiusdino,SI,72,0,5,1,2,8,2,9,0,1,12
2020,52010,Chiusdino,SI,73,2,8,1,0,11,1,4,0,1,6
2020,52010,Chiusdino,SI,74,1,5,1,2,9,1,5,0,3,9
2020,52010,Chiusdino,SI,75,0,7,0,2,9,1,3,0,4,8
2020,52010,Chiusdino,SI,76,0,2,0,1,3,0,2,2,3,7
2020,52010,Chiusdino,SI,77,0,4,1,1,6,0,5,1,1,7
2020,52010,Chiusdino,SI,78,2,4,1,2,9,0,3,0,2,5
2020,52010,Chiusdino,SI,79,0,6,0,0,6,1,4,0,3,8
2020,52010,Chiusdino,SI,80,1,5,0,1,7,0,10,1,9,20
2020,52010,Chiusdino,SI,81,1,4,0,1,6,0,5,0,4,9
2020,52010,Chiusdino,SI,82,1,10,0,1,12,1,3,1,7,12
2020,52010,Chiusdino,SI,83,0,6,0,1,7,0,2,0,6,8
2020,52010,Chiusdino,SI,84,0,3,0,1,4,2,3,0,7,12
2020,52010,Chiusdino,SI,85,0,3,0,1,4,0,1,0,8,9
2020,52010,Chiusdino,SI,86,1,4,0,1,6,0,2,0,8,10
2020,52010,Chiusdino,SI,87,0,4,0,0,4,1,1,0,5,7
2020,52010,Chiusdino,SI,88,0,2,0,1,3,0,1,0,7,8
2020,52010,Chiusdino,SI,89,1,2,0,1,4,0,0,0,7,7
2020,52010,Chiusdino,SI,90,2,1,0,1,4,0,1,0,9,10
2020,52010,Chiusdino,SI,91,0,1,0,0,1,1,1,0,2,4
2020,52010,Chiusdino,SI,92,0,1,0,1,2,0,0,0,5,5
2020,52010,Chiusdino,SI,93,0,1,0,0,1,0,0,0,2,2
2020,52010,Chiusdino,SI,94,0,0,0,0,0,0,0,0,5,5
2020,52010,Chiusdino,SI,95,0,0,0,0,0,0,0,0,3,3
2020,52010,Chiusdino,SI,96,0,0,0,0,0,0,0,1,0,1
2020,52010,Chiusdino,SI,97,0,0,0,1,1,0,0,0,1,1
2020,52010,Chiusdino,SI,98,0,0,0,0,0,0,0,0,2,2
2020,52010,Chiusdino,SI,99,0,0,0,1,1,0,0,0,1,1
2020,52010,Chiusdino,SI,100 e più,0,0,0,0,0,0,0,0,0,0
2020,52011,Chiusi,SI,0,11,0,0,0,11,23,0,0,0,23
2020,52011,Chiusi,SI,1,24,0,0,0,24,24,0,0,0,24
2020,52011,Chiusi,SI,2,28,0,0,0,28,23,0,0,0,23
2020,52011,Chiusi,SI,3,30,0,0,0,30,22,0,0,0,22
2020,52011,Chiusi,SI,4,35,0,0,0,35,28,0,0,0,28
2020,52011,Chiusi,SI,5,34,0,0,0,34,30,0,0,0,30
2020,52011,Chiusi,SI,6,28,0,0,0,28,29,0,0,0,29
2020,52011,Chiusi,SI,7,32,0,0,0,32,31,0,0,0,31
2020,52011,Chiusi,SI,8,28,0,0,0,28,19,0,0,0,19
2020,52011,Chiusi,SI,9,40,0,0,0,40,35,0,0,0,35
2020,52011,Chiusi,SI,10,28,0,0,0,28,36,0,0,0,36
2020,52011,Chiusi,SI,11,26,0,0,0,26,38,0,0,0,38
2020,52011,Chiusi,SI,12,36,0,0,0,36,36,0,0,0,36
2020,52011,Chiusi,SI,13,34,0,0,0,34,31,0,0,0,31
2020,52011,Chiusi,SI,14,32,0,0,0,32,24,0,0,0,24
2020,52011,Chiusi,SI,15,34,0,0,0,34,31,0,0,0,31
2020,52011,Chiusi,SI,16,41,0,0,0,41,37,0,0,0,37
2020,52011,Chiusi,SI,17,36,0,0,0,36,24,0,0,0,24
2020,52011,Chiusi,SI,18,44,0,0,0,44,40,0,0,0,40
2020,52011,Chiusi,SI,19,28,0,0,0,28,31,0,0,0,31
2020,52011,Chiusi,SI,20,38,0,0,0,38,29,1,0,0,30
2020,52011,Chiusi,SI,21,29,0,0,0,29,32,0,0,0,32
2020,52011,Chiusi,SI,22,41,1,0,0,42,28,1,0,0,29
2020,52011,Chiusi,SI,23,47,0,0,0,47,29,3,0,0,32
2020,52011,Chiusi,SI,24,31,1,0,0,32,29,2,1,0,32
2020,52011,Chiusi,SI,25,31,0,0,0,31,34,4,0,0,38
2020,52011,Chiusi,SI,26,47,1,0,0,48,31,5,0,0,36
2020,52011,Chiusi,SI,27,37,1,0,0,38,33,2,0,0,35
2020,52011,Chiusi,SI,28,41,4,0,0,45,34,12,0,0,46
2020,52011,Chiusi,SI,29,46,6,0,0,52,30,10,0,0,40
2020,52011,Chiusi,SI,30,38,4,0,0,42,28,15,0,0,43
2020,52011,Chiusi,SI,31,41,12,0,0,53,29,17,0,0,46
2020,52011,Chiusi,SI,32,36,11,0,0,47,25,10,1,0,36
2020,52011,Chiusi,SI,33,37,7,0,0,44,23,12,0,0,35
2020,52011,Chiusi,SI,34,28,11,1,0,40,26,16,2,0,44
2020,52011,Chiusi,SI,35,26,21,0,0,47,26,22,1,0,49
2020,52011,Chiusi,SI,36,22,19,1,0,42,19,16,0,0,35
2020,52011,Chiusi,SI,37,19,18,0,0,37,21,19,1,0,41
2020,52011,Chiusi,SI,38,17,15,0,0,32,18,30,2,0,50
2020,52011,Chiusi,SI,39,23,14,2,0,39,20,27,0,0,47
2020,52011,Chiusi,SI,40,20,23,1,0,44,12,25,2,0,39
2020,52011,Chiusi,SI,41,26,22,0,0,48,16,31,0,0,47
2020,52011,Chiusi,SI,42,28,20,4,1,53,17,32,4,1,54
2020,52011,Chiusi,SI,43,21,31,0,0,52,21,40,1,0,62
2020,52011,Chiusi,SI,44,20,29,1,0,50,14,32,6,0,52
2020,52011,Chiusi,SI,45,27,37,2,0,66,17,36,5,0,58
2020,52011,Chiusi,SI,46,20,44,2,0,66,17,38,3,1,59
2020,52011,Chiusi,SI,47,16,29,5,0,50,9,49,5,0,63
2020,52011,Chiusi,SI,48,16,35,0,0,51,20,42,0,0,62
2020,52011,Chiusi,SI,49,22,42,1,0,65,18,35,4,0,57
2020,52011,Chiusi,SI,50,18,40,1,0,59,15,38,8,2,63
2020,52011,Chiusi,SI,51,20,42,3,0,65,10,45,2,1,58
2020,52011,Chiusi,SI,52,14,33,4,0,51,8,44,2,0,54
2020,52011,Chiusi,SI,53,13,43,1,0,57,3,42,6,2,53
2020,52011,Chiusi,SI,54,14,64,3,0,81,8,42,5,2,57
2020,52011,Chiusi,SI,55,14,44,3,0,61,8,53,5,3,69
2020,52011,Chiusi,SI,56,13,55,1,1,70,4,52,2,4,62
2020,52011,Chiusi,SI,57,11,50,4,2,67,3,47,6,4,60
2020,52011,Chiusi,SI,58,6,39,3,3,51,6,43,8,5,62
2020,52011,Chiusi,SI,59,12,59,2,0,73,7,67,7,2,83
2020,52011,Chiusi,SI,60,4,34,4,4,46,4,41,3,1,49
2020,52011,Chiusi,SI,61,4,45,5,0,54,5,49,7,2,63
2020,52011,Chiusi,SI,62,7,33,4,2,46,6,40,3,11,60
2020,52011,Chiusi,SI,63,7,42,2,0,51,3,47,3,5,58
2020,52011,Chiusi,SI,64,2,44,5,1,52,5,46,2,2,55
2020,52011,Chiusi,SI,65,5,45,2,2,54,6,39,4,7,56
2020,52011,Chiusi,SI,66,7,40,4,3,54,6,48,4,10,68
2020,52011,Chiusi,SI,67,3,42,1,1,47,3,48,0,4,55
2020,52011,Chiusi,SI,68,2,50,1,4,57,2,45,3,5,55
2020,52011,Chiusi,SI,69,4,43,2,4,53,4,41,2,10,57
2020,52011,Chiusi,SI,70,6,51,3,2,62,3,30,4,6,43
2020,52011,Chiusi,SI,71,7,50,0,2,59,2,54,0,7,63
2020,52011,Chiusi,SI,72,4,51,2,7,64,3,44,1,24,72
2020,52011,Chiusi,SI,73,2,49,1,6,58,1,44,0,5,50
2020,52011,Chiusi,SI,74,3,42,1,8,54,1,37,0,32,70
2020,52011,Chiusi,SI,75,1,35,2,5,43,1,22,0,15,38
2020,52011,Chiusi,SI,76,6,41,0,2,49,3,30,1,10,44
2020,52011,Chiusi,SI,77,4,28,1,6,39,4,23,2,14,43
2020,52011,Chiusi,SI,78,1,28,0,9,38,5,25,0,17,47
2020,52011,Chiusi,SI,79,4,34,0,3,41,2,17,2,22,43
2020,52011,Chiusi,SI,80,6,31,1,5,43,2,30,0,31,63
2020,52011,Chiusi,SI,81,1,30,0,2,33,3,14,0,30,47
2020,52011,Chiusi,SI,82,1,26,0,0,27,1,19,0,35,55
2020,52011,Chiusi,SI,83,2,23,1,4,30,4,10,0,24,38
2020,52011,Chiusi,SI,84,0,22,0,7,29,0,4,0,20,24
2020,52011,Chiusi,SI,85,2,14,1,5,22,0,15,1,36,52
2020,52011,Chiusi,SI,86,1,14,0,7,22,0,6,0,33,39
2020,52011,Chiusi,SI,87,2,14,0,4,20,1,4,0,26,31
2020,52011,Chiusi,SI,88,0,19,0,4,23,2,2,0,23,27
2020,52011,Chiusi,SI,89,0,9,0,7,16,0,5,1,20,26
2020,52011,Chiusi,SI,90,1,7,0,2,10,1,4,0,19,24
2020,52011,Chiusi,SI,91,1,5,0,2,8,1,2,0,26,29
2020,52011,Chiusi,SI,92,1,4,0,2,7,2,1,0,20,23
2020,52011,Chiusi,SI,93,0,0,0,2,2,0,0,0,11,11
2020,52011,Chiusi,SI,94,0,4,0,4,8,0,0,0,7,7
2020,52011,Chiusi,SI,95,1,0,0,1,2,0,2,0,10,12
2020,52011,Chiusi,SI,96,0,0,0,0,0,2,0,0,8,10
2020,52011,Chiusi,SI,97,0,0,0,0,0,0,0,0,7,7
2020,52011,Chiusi,SI,98,0,1,0,0,1,0,0,0,5,5
2020,52011,Chiusi,SI,99,0,1,0,0,1,0,0,0,2,2
2020,52011,Chiusi,SI,100 e più,0,0,0,0,0,0,0,0,2,2
2020,52012,Colle di Val d'Elsa,SI,0,83,0,0,0,83,66,0,0,0,66
2020,52012,Colle di Val d'Elsa,SI,1,70,0,0,0,70,91,0,0,0,91
2020,52012,Colle di Val d'Elsa,SI,2,77,0,0,0,77,85,0,0,0,85
2020,52012,Colle di Val d'Elsa,SI,3,70,0,0,0,70,108,0,0,0,108
2020,52012,Colle di Val d'Elsa,SI,4,106,0,0,0,106,91,0,0,0,91
2020,52012,Colle di Val d'Elsa,SI,5,89,0,0,0,89,87,0,0,0,87
2020,52012,Colle di Val d'Elsa,SI,6,91,0,0,0,91,111,0,0,0,111
2020,52012,Colle di Val d'Elsa,SI,7,95,0,0,0,95,102,0,0,0,102
2020,52012,Colle di Val d'Elsa,SI,8,115,0,0,0,115,107,0,0,0,107
2020,52012,Colle di Val d'Elsa,SI,9,107,0,0,0,107,95,0,0,0,95
2020,52012,Colle di Val d'Elsa,SI,10,92,0,0,0,92,116,0,0,0,116
2020,52012,Colle di Val d'Elsa,SI,11,112,0,0,0,112,116,0,0,0,116
2020,52012,Colle di Val d'Elsa,SI,12,112,0,0,0,112,84,0,0,0,84
2020,52012,Colle di Val d'Elsa,SI,13,116,0,0,0,116,95,0,0,0,95
2020,52012,Colle di Val d'Elsa,SI,14,113,0,0,0,113,98,0,0,0,98
2020,52012,Colle di Val d'Elsa,SI,15,118,0,0,0,118,94,0,0,0,94
2020,52012,Colle di Val d'Elsa,SI,16,87,0,0,0,87,97,0,0,0,97
2020,52012,Colle di Val d'Elsa,SI,17,106,0,0,0,106,104,0,0,0,104
2020,52012,Colle di Val d'Elsa,SI,18,113,0,0,0,113,99,0,0,0,99
2020,52012,Colle di Val d'Elsa,SI,19,101,0,0,0,101,102,0,0,0,102
2020,52012,Colle di Val d'Elsa,SI,20,114,1,0,0,115,112,4,0,0,116
2020,52012,Colle di Val d'Elsa,SI,21,110,0,0,0,110,107,4,0,0,111
2020,52012,Colle di Val d'Elsa,SI,22,108,0,0,0,108,96,9,0,0,105
2020,52012,Colle di Val d'Elsa,SI,23,135,3,0,0,138,106,6,1,0,113
2020,52012,Colle di Val d'Elsa,SI,24,112,4,0,0,116,111,4,0,0,115
2020,52012,Colle di Val d'Elsa,SI,25,115,5,0,0,120,95,11,0,0,106
2020,52012,Colle di Val d'Elsa,SI,26,111,5,0,0,116,89,11,0,0,100
2020,52012,Colle di Val d'Elsa,SI,27,101,9,0,0,110,98,20,0,0,119
2020,52012,Colle di Val d'Elsa,SI,28,117,9,1,0,127,76,25,0,0,101
2020,52012,Colle di Val d'Elsa,SI,29,103,14,0,0,117,79,32,1,1,113
2020,52012,Colle di Val d'Elsa,SI,30,102,23,1,0,126,74,49,2,0,125
2020,52012,Colle di Val d'Elsa,SI,31,95,26,0,0,121,64,49,1,1,116
2020,52012,Colle di Val d'Elsa,SI,32,104,34,0,0,138,53,63,1,0,117
2020,52012,Colle di Val d'Elsa,SI,33,64,42,2,0,108,74,49,2,0,125
2020,52012,Colle di Val d'Elsa,SI,34,87,46,0,0,133,48,65,1,0,114
2020,52012,Colle di Val d'Elsa,SI,35,61,55,1,0,117,42,61,4,1,108
2020,52012,Colle di Val d'Elsa,SI,36,76,54,0,0,130,35,78,3,0,116
2020,52012,Colle di Val d'Elsa,SI,37,73,58,1,0,133,52,85,4,0,141
2020,52012,Colle di Val d'Elsa,SI,38,64,70,2,0,136,72,80,3,1,156
2020,52012,Colle di Val d'Elsa,SI,39,53,52,2,0,107,50,89,3,0,142
2020,52012,Colle di Val d'Elsa,SI,40,57,71,5,0,133,38,97,7,0,142
2020,52012,Colle di Val d'Elsa,SI,41,62,94,5,0,161,46,97,4,1,148
2020,52012,Colle di Val d'Elsa,SI,42,48,94,2,0,145,64,82,4,2,152
2020,52012,Colle di Val d'Elsa,SI,43,75,95,7,0,177,46,123,9,0,178
2020,52012,Colle di Val d'Elsa,SI,44,53,83,3,1,140,45,111,16,0,172
2020,52012,Colle di Val d'Elsa,SI,45,78,105,2,0,185,42,118,12,3,175
2020,52012,Colle di Val d'Elsa,SI,46,53,103,5,1,162,32,128,9,1,170
2020,52012,Colle di Val d'Elsa,SI,47,52,109,6,1,168,38,118,16,1,174
2020,52012,Colle di Val d'Elsa,SI,48,48,120,11,0,179,35,121,9,2,167
2020,52012,Colle di Val d'Elsa,SI,49,46,118,11,1,176,29,136,10,2,177
2020,52012,Colle di Val d'Elsa,SI,50,44,131,4,0,179,37,111,12,2,162
2020,52012,Colle di Val d'Elsa,SI,51,41,129,8,0,178,24,132,12,2,170
2020,52012,Colle di Val d'Elsa,SI,52,41,144,13,1,199,31,134,17,1,183
2020,52012,Colle di Val d'Elsa,SI,53,35,118,11,2,166,29,126,15,6,176
2020,52012,Colle di Val d'Elsa,SI,54,31,150,10,2,193,28,148,19,6,201
2020,52012,Colle di Val d'Elsa,SI,55,24,141,12,0,178,25,126,16,5,172
2020,52012,Colle di Val d'Elsa,SI,56,24,111,13,0,148,19,143,21,8,191
2020,52012,Colle di Val d'Elsa,SI,57,18,130,19,1,168,22,119,21,9,171
2020,52012,Colle di Val d'Elsa,SI,58,14,122,9,1,146,22,125,15,10,172
2020,52012,Colle di Val d'Elsa,SI,59,14,115,10,1,140,17,121,10,5,153
2020,52012,Colle di Val d'Elsa,SI,60,24,118,9,3,154,9,105,12,10,136
2020,52012,Colle di Val d'Elsa,SI,61,14,127,14,5,160,13,125,10,10,158
2020,52012,Colle di Val d'Elsa,SI,62,3,93,7,4,108,12,107,12,15,146
2020,52012,Colle di Val d'Elsa,SI,63,13,104,17,1,135,11,93,10,9,123
2020,52012,Colle di Val d'Elsa,SI,64,13,93,8,1,115,8,106,5,13,132
2020,52012,Colle di Val d'Elsa,SI,65,10,86,5,1,103,8,95,10,22,135
2020,52012,Colle di Val d'Elsa,SI,66,3,80,8,3,94,12,86,7,13,118
2020,52012,Colle di Val d'Elsa,SI,67,8,96,7,1,112,7,99,4,14,124
2020,52012,Colle di Val d'Elsa,SI,68,10,108,2,8,128,7,96,7,18,128
2020,52012,Colle di Val d'Elsa,SI,69,5,95,3,11,114,7,82,7,19,115
2020,52012,Colle di Val d'Elsa,SI,70,6,105,2,4,117,2,92,7,15,116
2020,52012,Colle di Val d'Elsa,SI,71,6,101,3,3,113,5,97,5,26,133
2020,52012,Colle di Val d'Elsa,SI,72,6,110,2,15,133,9,114,11,32,166
2020,52012,Colle di Val d'Elsa,SI,73,5,103,2,7,117,5,96,3,31,135
2020,52012,Colle di Val d'Elsa,SI,74,9,95,3,3,110,7,73,4,37,121
2020,52012,Colle di Val d'Elsa,SI,75,8,69,1,5,83,3,69,6,31,109
2020,52012,Colle di Val d'Elsa,SI,76,5,61,3,9,78,0,48,4,35,87
2020,52012,Colle di Val d'Elsa,SI,77,5,66,1,8,80,1,68,9,36,114
2020,52012,Colle di Val d'Elsa,SI,78,3,71,2,8,84,2,44,0,23,69
2020,52012,Colle di Val d'Elsa,SI,79,5,74,1,6,86,4,50,3,33,90
2020,52012,Colle di Val d'Elsa,SI,80,4,49,2,8,63,0,59,0,43,102
2020,52012,Colle di Val d'Elsa,SI,81,7,66,1,9,83,3,47,0,58,108
2020,52012,Colle di Val d'Elsa,SI,82,5,64,1,12,82,0,35,3,66,104
2020,52012,Colle di Val d'Elsa,SI,83,2,44,1,9,56,1,27,2,64,94
2020,52012,Colle di Val d'Elsa,SI,84,6,35,0,8,49,2,16,1,48,67
2020,52012,Colle di Val d'Elsa,SI,85,2,42,0,7,51,3,21,1,56,81
2020,52012,Colle di Val d'Elsa,SI,86,3,36,0,12,51,3,6,0,49,58
2020,52012,Colle di Val d'Elsa,SI,87,2,23,1,6,32,1,14,1,46,62
2020,52012,Colle di Val d'Elsa,SI,88,6,21,0,11,38,0,10,0,36,46
2020,52012,Colle di Val d'Elsa,SI,89,0,22,0,9,31,5,4,1,43,53
2020,52012,Colle di Val d'Elsa,SI,90,0,15,0,9,24,0,8,1,50,59
2020,52012,Colle di Val d'Elsa,SI,91,2,11,1,6,20,0,3,0,29,32
2020,52012,Colle di Val d'Elsa,SI,92,2,5,0,5,12,1,3,0,23,27
2020,52012,Colle di Val d'Elsa,SI,93,0,4,0,6,10,0,2,0,27,29
2020,52012,Colle di Val d'Elsa,SI,94,0,5,0,1,6,0,1,0,23,24
2020,52012,Colle di Val d'Elsa,SI,95,0,2,0,1,3,0,1,0,19,20
2020,52012,Colle di Val d'Elsa,SI,96,0,1,0,1,2,0,0,0,13,13
2020,52012,Colle di Val d'Elsa,SI,97,0,3,0,2,5,0,1,0,8,9
2020,52012,Colle di Val d'Elsa,SI,98,0,2,0,1,3,0,0,0,17,17
2020,52012,Colle di Val d'Elsa,SI,99,0,0,0,0,0,0,0,0,8,8
2020,52012,Colle di Val d'Elsa,SI,100 e più,0,1,0,1,2,0,0,0,4,4
2020,52013,Gaiole in Chianti,SI,0,11,0,0,0,11,8,0,0,0,8
2020,52013,Gaiole in Chianti,SI,1,13,0,0,0,13,8,0,0,0,8
2020,52013,Gaiole in Chianti,SI,2,11,0,0,0,11,6,0,0,0,6
2020,52013,Gaiole in Chianti,SI,3,9,0,0,0,9,9,0,0,0,9
2020,52013,Gaiole in Chianti,SI,4,2,0,0,0,2,8,0,0,0,8
2020,52013,Gaiole in Chianti,SI,5,18,0,0,0,18,16,0,0,0,16
2020,52013,Gaiole in Chianti,SI,6,16,0,0,0,16,9,0,0,0,9
2020,52013,Gaiole in Chianti,SI,7,8,0,0,0,8,9,0,0,0,9
2020,52013,Gaiole in Chianti,SI,8,15,0,0,0,15,20,0,0,0,20
2020,52013,Gaiole in Chianti,SI,9,19,0,0,0,19,17,0,0,0,17
2020,52013,Gaiole in Chianti,SI,10,7,0,0,0,7,6,0,0,0,6
2020,52013,Gaiole in Chianti,SI,11,17,0,0,0,17,15,0,0,0,15
2020,52013,Gaiole in Chianti,SI,12,7,0,0,0,7,7,0,0,0,7
2020,52013,Gaiole in Chianti,SI,13,15,0,0,0,15,16,0,0,0,16
2020,52013,Gaiole in Chianti,SI,14,10,0,0,0,10,14,0,0,0,14
2020,52013,Gaiole in Chianti,SI,15,14,0,0,0,14,11,0,0,0,11
2020,52013,Gaiole in Chianti,SI,16,13,0,0,0,13,7,0,0,0,7
2020,52013,Gaiole in Chianti,SI,17,11,0,0,0,11,12,0,0,0,12
2020,52013,Gaiole in Chianti,SI,18,16,0,0,0,16,15,0,0,0,15
2020,52013,Gaiole in Chianti,SI,19,10,0,0,0,10,5,0,0,0,5
2020,52013,Gaiole in Chianti,SI,20,12,0,0,0,12,9,0,0,0,9
2020,52013,Gaiole in Chianti,SI,21,11,0,0,0,11,14,0,0,0,14
2020,52013,Gaiole in Chianti,SI,22,15,0,0,0,15,15,1,0,0,16
2020,52013,Gaiole in Chianti,SI,23,10,0,0,0,10,15,0,0,0,15
2020,52013,Gaiole in Chianti,SI,24,16,0,0,0,16,11,3,0,0,14
2020,52013,Gaiole in Chianti,SI,25,14,1,0,0,15,11,2,0,0,13
2020,52013,Gaiole in Chianti,SI,26,18,2,0,0,20,4,1,0,0,5
2020,52013,Gaiole in Chianti,SI,27,17,2,0,0,19,7,3,0,0,10
2020,52013,Gaiole in Chianti,SI,28,7,3,0,0,10,5,6,0,0,11
2020,52013,Gaiole in Chianti,SI,29,14,4,0,0,18,7,6,0,0,13
2020,52013,Gaiole in Chianti,SI,30,12,6,0,0,18,12,3,0,0,15
2020,52013,Gaiole in Chianti,SI,31,4,4,0,0,8,5,6,0,1,12
2020,52013,Gaiole in Chianti,SI,32,14,2,0,0,16,5,8,0,0,13
2020,52013,Gaiole in Chianti,SI,33,10,2,0,0,12,10,6,0,0,16
2020,52013,Gaiole in Chianti,SI,34,4,5,0,0,9,6,5,0,0,11
2020,52013,Gaiole in Chianti,SI,35,12,10,0,0,22,8,13,1,0,22
2020,52013,Gaiole in Chianti,SI,36,8,9,0,0,17,6,5,0,0,11
2020,52013,Gaiole in Chianti,SI,37,12,8,0,0,20,5,6,2,0,13
2020,52013,Gaiole in Chianti,SI,38,10,9,0,0,19,7,9,0,0,16
2020,52013,Gaiole in Chianti,SI,39,3,5,0,0,8,7,10,0,0,17
2020,52013,Gaiole in Chianti,SI,40,7,12,0,0,19,8,10,2,1,21
2020,52013,Gaiole in Chianti,SI,41,8,7,0,0,15,3,7,0,0,10
2020,52013,Gaiole in Chianti,SI,42,13,10,0,0,23,5,8,1,0,14
2020,52013,Gaiole in Chianti,SI,43,6,16,0,0,22,4,14,1,0,19
2020,52013,Gaiole in Chianti,SI,44,6,9,1,0,16,2,13,1,0,16
2020,52013,Gaiole in Chianti,SI,45,10,13,0,0,23,1,13,0,0,14
2020,52013,Gaiole in Chianti,SI,46,11,19,0,0,30,4,12,2,0,18
2020,52013,Gaiole in Chianti,SI,47,5,12,0,0,17,3,24,4,0,31
2020,52013,Gaiole in Chianti,SI,48,2,20,0,0,22,3,17,2,1,23
2020,52013,Gaiole in Chianti,SI,49,5,9,1,0,15,3,15,1,0,19
2020,52013,Gaiole in Chianti,SI,50,4,11,1,0,16,1,12,1,0,14
2020,52013,Gaiole in Chianti,SI,51,6,17,0,0,23,7,15,0,0,22
2020,52013,Gaiole in Chianti,SI,52,5,17,4,0,26,6,6,4,0,16
2020,52013,Gaiole in Chianti,SI,53,6,16,3,0,25,3,13,0,1,17
2020,52013,Gaiole in Chianti,SI,54,4,13,4,0,21,4,16,1,1,22
2020,52013,Gaiole in Chianti,SI,55,2,14,2,1,19,3,18,4,0,25
2020,52013,Gaiole in Chianti,SI,56,4,14,2,0,20,3,22,3,1,29
2020,52013,Gaiole in Chianti,SI,57,4,12,2,0,18,3,16,0,1,20
2020,52013,Gaiole in Chianti,SI,58,7,12,2,0,21,7,5,2,1,15
2020,52013,Gaiole in Chianti,SI,59,1,16,4,1,22,1,18,1,1,21
2020,52013,Gaiole in Chianti,SI,60,2,15,2,0,19,3,11,0,0,14
2020,52013,Gaiole in Chianti,SI,61,7,22,0,1,30,5,16,2,0,23
2020,52013,Gaiole in Chianti,SI,62,3,13,0,0,16,2,16,0,2,20
2020,52013,Gaiole in Chianti,SI,63,2,12,1,0,15,1,13,1,1,16
2020,52013,Gaiole in Chianti,SI,64,1,14,1,0,16,2,15,2,2,21
2020,52013,Gaiole in Chianti,SI,65,1,8,2,0,11,2,11,0,1,14
2020,52013,Gaiole in Chianti,SI,66,2,11,1,0,14,0,21,1,2,24
2020,52013,Gaiole in Chianti,SI,67,2,9,0,2,13,1,11,3,6,21
2020,52013,Gaiole in Chianti,SI,68,2,12,0,0,14,1,7,2,1,11
2020,52013,Gaiole in Chianti,SI,69,4,11,0,0,15,1,7,1,2,11
2020,52013,Gaiole in Chianti,SI,70,1,15,0,1,17,1,10,1,3,15
2020,52013,Gaiole in Chianti,SI,71,3,11,1,1,16,1,16,0,1,18
2020,52013,Gaiole in Chianti,SI,72,0,13,0,2,15,0,14,0,1,15
2020,52013,Gaiole in Chianti,SI,73,2,10,2,0,14,0,10,0,3,13
2020,52013,Gaiole in Chianti,SI,74,2,13,0,2,17,1,7,0,4,12
2020,52013,Gaiole in Chianti,SI,75,0,10,0,1,11,1,7,0,3,11
2020,52013,Gaiole in Chianti,SI,76,1,4,0,0,5,0,8,0,3,11
2020,52013,Gaiole in Chianti,SI,77,0,10,0,2,12,0,4,0,6,10
2020,52013,Gaiole in Chianti,SI,78,2,7,0,1,10,1,5,0,10,16
2020,52013,Gaiole in Chianti,SI,79,0,12,0,1,13,0,7,0,5,12
2020,52013,Gaiole in Chianti,SI,80,0,15,2,5,22,0,4,1,3,8
2020,52013,Gaiole in Chianti,SI,81,1,7,0,0,8,1,5,0,4,10
2020,52013,Gaiole in Chianti,SI,82,2,7,0,0,9,0,2,0,3,5
2020,52013,Gaiole in Chianti,SI,83,1,6,0,0,7,0,2,0,9,11
2020,52013,Gaiole in Chianti,SI,84,1,4,0,0,5,1,2,0,9,12
2020,52013,Gaiole in Chianti,SI,85,1,2,0,2,5,0,0,0,12,12
2020,52013,Gaiole in Chianti,SI,86,1,3,0,1,5,0,0,0,6,6
2020,52013,Gaiole in Chianti,SI,87,1,1,0,4,6,0,0,0,5,5
2020,52013,Gaiole in Chianti,SI,88,0,2,0,3,5,0,0,0,4,4
2020,52013,Gaiole in Chianti,SI,89,1,1,0,1,3,0,1,0,7,8
2020,52013,Gaiole in Chianti,SI,90,1,0,0,3,4,0,1,0,10,11
2020,52013,Gaiole in Chianti,SI,91,1,3,0,1,5,0,0,0,8,8
2020,52013,Gaiole in Chianti,SI,92,0,0,0,2,2,0,0,0,3,3
2020,52013,Gaiole in Chianti,SI,93,0,0,0,0,0,0,0,0,7,7
2020,52013,Gaiole in Chianti,SI,94,0,0,0,4,4,0,0,0,4,4
2020,52013,Gaiole in Chianti,SI,95,0,0,0,0,0,0,0,0,2,2
2020,52013,Gaiole in Chianti,SI,96,0,0,0,2,2,0,0,0,3,3
2020,52013,Gaiole in Chianti,SI,97,0,0,0,1,1,0,0,0,0,0
2020,52013,Gaiole in Chianti,SI,98,0,0,0,0,0,0,0,0,2,2
2020,52013,Gaiole in Chianti,SI,99,0,0,0,0,0,0,0,0,1,1
2020,52013,Gaiole in Chianti,SI,100 e più,0,0,0,0,0,0,0,0,2,2
2020,52015,Montepulciano,SI,0,38,0,0,0,38,25,0,0,0,25
2020,52015,Montepulciano,SI,1,34,0,0,0,34,30,0,0,0,30
2020,52015,Montepulciano,SI,2,41,0,0,0,41,41,0,0,0,41
2020,52015,Montepulciano,SI,3,42,0,0,0,42,47,0,0,0,47
2020,52015,Montepulciano,SI,4,43,0,0,0,43,43,0,0,0,43
2020,52015,Montepulciano,SI,5,44,0,0,0,44,42,0,0,0,42
2020,52015,Montepulciano,SI,6,60,0,0,0,60,40,0,0,0,40
2020,52015,Montepulciano,SI,7,63,0,0,0,63,49,0,0,0,49
2020,52015,Montepulciano,SI,8,57,0,0,0,57,59,0,0,0,59
2020,52015,Montepulciano,SI,9,54,0,0,0,54,40,0,0,0,40
2020,52015,Montepulciano,SI,10,66,0,0,0,66,60,0,0,0,60
2020,52015,Montepulciano,SI,11,57,0,0,0,57,72,0,0,0,72
2020,52015,Montepulciano,SI,12,72,0,0,0,72,67,0,0,0,67
2020,52015,Montepulciano,SI,13,56,0,0,0,56,52,0,0,0,52
2020,52015,Montepulciano,SI,14,75,0,0,0,75,61,0,0,0,61
2020,52015,Montepulciano,SI,15,54,0,0,0,54,56,0,0,0,56
2020,52015,Montepulciano,SI,16,48,0,0,0,48,62,0,0,0,62
2020,52015,Montepulciano,SI,17,61,0,0,0,61,53,0,0,0,53
2020,52015,Montepulciano,SI,18,50,0,0,0,50,40,0,0,0,40
2020,52015,Montepulciano,SI,19,53,0,0,0,53,59,0,0,0,59
2020,52015,Montepulciano,SI,20,53,0,0,0,53,64,0,0,0,64
2020,52015,Montepulciano,SI,21,52,0,0,0,52,45,3,0,0,48
2020,52015,Montepulciano,SI,22,56,0,0,0,56,50,1,0,0,51
2020,52015,Montepulciano,SI,23,67,0,0,0,67,58,2,0,0,60
2020,52015,Montepulciano,SI,24,52,0,0,0,52,61,1,0,0,62
2020,52015,Montepulciano,SI,25,56,1,0,0,57,47,6,0,0,53
2020,52015,Montepulciano,SI,26,66,2,0,0,68,61,6,0,0,67
2020,52015,Montepulciano,SI,27,57,2,0,0,59,51,12,0,0,63
2020,52015,Montepulciano,SI,28,61,5,1,0,67,45,12,0,0,57
2020,52015,Montepulciano,SI,29,59,8,0,0,67,47,11,0,0,58
2020,52015,Montepulciano,SI,30,57,6,0,0,63,41,22,0,0,63
2020,52015,Montepulciano,SI,31,49,11,0,0,60,35,17,0,0,52
2020,52015,Montepulciano,SI,32,45,10,0,0,55,44,19,0,0,63
2020,52015,Montepulciano,SI,33,63,21,2,0,86,43,15,1,0,59
2020,52015,Montepulciano,SI,34,49,15,0,0,64,29,27,1,1,58
2020,52015,Montepulciano,SI,35,49,18,0,0,67,34,20,1,0,55
2020,52015,Montepulciano,SI,36,50,30,1,0,81,44,38,0,0,82
2020,52015,Montepulciano,SI,37,43,35,0,0,78,39,28,1,0,68
2020,52015,Montepulciano,SI,38,34,26,0,0,60,39,32,3,0,74
2020,52015,Montepulciano,SI,39,47,30,2,0,79,40,46,2,0,88
2020,52015,Montepulciano,SI,40,29,36,2,0,67,28,47,4,1,80
2020,52015,Montepulciano,SI,41,42,36,4,0,82,23,52,7,0,82
2020,52015,Montepulciano,SI,42,42,46,3,0,91,23,58,2,1,84
2020,52015,Montepulciano,SI,43,44,41,1,0,86,23,52,5,0,80
2020,52015,Montepulciano,SI,44,42,47,1,0,90,30,69,5,0,104
2020,52015,Montepulciano,SI,45,28,49,4,0,81,33,68,6,1,108
2020,52015,Montepulciano,SI,46,43,50,3,0,96,22,94,10,1,127
2020,52015,Montepulciano,SI,47,23,65,2,1,91,29,76,8,0,113
2020,52015,Montepulciano,SI,48,31,58,7,0,96,26,81,3,1,111
2020,52015,Montepulciano,SI,49,33,75,1,1,110,18,69,4,2,93
2020,52015,Montepulciano,SI,50,32,54,6,0,92,16,63,4,3,86
2020,52015,Montepulciano,SI,51,31,75,12,0,118,21,81,6,4,112
2020,52015,Montepulciano,SI,52,31,61,1,0,93,20,79,9,2,110
2020,52015,Montepulciano,SI,53,22,65,11,0,98,22,106,8,3,139
2020,52015,Montepulciano,SI,54,25,75,2,2,104,17,89,13,3,122
2020,52015,Montepulciano,SI,55,15,84,9,0,108,11,82,3,8,104
2020,52015,Montepulciano,SI,56,22,86,3,2,113,17,85,11,3,116
2020,52015,Montepulciano,SI,57,16,88,7,0,111,13,61,9,5,88
2020,52015,Montepulciano,SI,58,19,66,7,0,92,16,90,2,7,115
2020,52015,Montepulciano,SI,59,11,83,5,1,100,5,81,7,3,96
2020,52015,Montepulciano,SI,60,20,69,5,1,95,5,92,7,8,112
2020,52015,Montepulciano,SI,61,8,75,6,1,90,7,79,10,9,105
2020,52015,Montepulciano,SI,62,7,70,5,1,83,7,87,4,7,105
2020,52015,Montepulciano,SI,63,12,68,4,3,87,5,77,8,8,98
2020,52015,Montepulciano,SI,64,6,72,3,3,84,8,79,4,16,107
2020,52015,Montepulciano,SI,65,9,74,7,4,94,6,63,2,13,84
2020,52015,Montepulciano,SI,66,12,89,3,5,109,4,78,4,17,103
2020,52015,Montepulciano,SI,67,9,60,2,3,74,8,75,4,9,96
2020,52015,Montepulciano,SI,68,4,59,7,1,71,0,72,5,6,83
2020,52015,Montepulciano,SI,69,10,78,1,4,93,3,63,4,21,91
2020,52015,Montepulciano,SI,70,7,75,3,0,85,5,61,4,18,88
2020,52015,Montepulciano,SI,71,8,71,1,3,83,5,75,5,26,111
2020,52015,Montepulciano,SI,72,9,62,3,5,79,2,67,3,29,101
2020,52015,Montepulciano,SI,73,10,69,3,6,88,0,68,4,28,100
2020,52015,Montepulciano,SI,74,7,70,4,6,87,3,55,0,24,82
2020,52015,Montepulciano,SI,75,1,51,0,1,53,5,62,0,25,92
2020,52015,Montepulciano,SI,76,11,64,3,4,82,7,39,1,18,65
2020,52015,Montepulciano,SI,77,1,51,3,6,61,4,47,4,37,92
2020,52015,Montepulciano,SI,78,4,48,2,8,62,1,29,2,36,68
2020,52015,Montepulciano,SI,79,6,47,2,3,58,3,30,1,31,65
2020,52015,Montepulciano,SI,80,6,51,2,4,63,3,45,2,45,95
2020,52015,Montepulciano,SI,81,9,49,0,9,67,0,31,1,44,76
2020,52015,Montepulciano,SI,82,4,42,1,12,59,3,37,1,46,87
2020,52015,Montepulciano,SI,83,2,32,2,9,45,1,17,0,40,58
2020,52015,Montepulciano,SI,84,1,30,0,7,38,3,13,0,49,65
2020,52015,Montepulciano,SI,85,5,40,2,6,53,5,19,1,44,69
2020,52015,Montepulciano,SI,86,3,33,0,5,41,0,9,2,47,58
2020,52015,Montepulciano,SI,87,2,22,1,11,36,4,8,0,42,54
2020,52015,Montepulciano,SI,88,1,16,0,4,21,1,7,0,47,55
2020,52015,Montepulciano,SI,89,1,14,1,8,24,2,7,0,44,53
2020,52015,Montepulciano,SI,90,2,17,0,8,27,0,2,0,36,38
2020,52015,Montepulciano,SI,91,0,11,1,9,21,0,2,0,42,44
2020,52015,Montepulciano,SI,92,1,9,0,5,15,0,2,0,27,29
2020,52015,Montepulciano,SI,93,0,6,0,6,12,2,0,1,25,28
2020,52015,Montepulciano,SI,94,0,3,0,7,10,3,0,0,16,19
2020,52015,Montepulciano,SI,95,1,2,0,1,4,1,0,0,14,15
2020,52015,Montepulciano,SI,96,0,1,0,1,2,0,0,0,17,17
2020,52015,Montepulciano,SI,97,0,1,0,3,4,1,0,1,9,11
2020,52015,Montepulciano,SI,98,0,0,0,2,2,0,0,0,1,1
2020,52015,Montepulciano,SI,99,0,1,0,1,2,0,0,0,3,3
2020,52015,Montepulciano,SI,100 e più,0,0,0,1,1,1,0,0,4,5
2020,52016,Monteriggioni,SI,0,39,0,0,0,39,30,0,0,0,30
2020,52016,Monteriggioni,SI,1,48,0,0,0,48,41,0,0,0,41
2020,52016,Monteriggioni,SI,2,32,0,0,0,32,53,0,0,0,53
2020,52016,Monteriggioni,SI,3,50,0,0,0,50,36,0,0,0,36
2020,52016,Monteriggioni,SI,4,44,0,0,0,44,43,0,0,0,43
2020,52016,Monteriggioni,SI,5,45,0,0,0,45,50,0,0,0,50
2020,52016,Monteriggioni,SI,6,49,0,0,0,49,53,0,0,0,53
2020,52016,Monteriggioni,SI,7,55,0,0,0,55,41,0,0,0,41
2020,52016,Monteriggioni,SI,8,46,0,0,0,46,56,0,0,0,56
2020,52016,Monteriggioni,SI,9,48,0,0,0,48,47,0,0,0,47
2020,52016,Monteriggioni,SI,10,65,0,0,0,65,49,0,0,0,49
2020,52016,Monteriggioni,SI,11,50,0,0,0,50,45,0,0,0,45
2020,52016,Monteriggioni,SI,12,64,0,0,0,64,53,0,0,0,53
2020,52016,Monteriggioni,SI,13,52,0,0,0,52,48,0,0,0,48
2020,52016,Monteriggioni,SI,14,41,0,0,0,41,41,0,0,0,41
2020,52016,Monteriggioni,SI,15,61,0,0,0,61,47,0,0,0,47
2020,52016,Monteriggioni,SI,16,46,0,0,0,46,46,0,0,0,46
2020,52016,Monteriggioni,SI,17,44,0,0,0,44,43,0,0,0,43
2020,52016,Monteriggioni,SI,18,41,0,0,0,41,25,0,0,0,25
2020,52016,Monteriggioni,SI,19,57,0,0,0,57,37,1,0,0,38
2020,52016,Monteriggioni,SI,20,42,0,0,0,42,47,0,0,0,47
2020,52016,Monteriggioni,SI,21,39,0,0,0,39,31,1,0,0,32
2020,52016,Monteriggioni,SI,22,41,1,0,0,42,34,4,0,0,38
2020,52016,Monteriggioni,SI,23,47,0,0,0,47,42,4,0,0,46
2020,52016,Monteriggioni,SI,24,42,1,0,0,43,39,2,0,0,41
2020,52016,Monteriggioni,SI,25,47,3,0,0,50,41,10,0,0,51
2020,52016,Monteriggioni,SI,26,53,3,0,0,56,40,4,0,0,44
2020,52016,Monteriggioni,SI,27,47,1,0,0,48,40,8,0,0,48
2020,52016,Monteriggioni,SI,28,64,8,0,0,72,34,14,0,0,48
2020,52016,Monteriggioni,SI,29,48,7,0,0,55,30,13,0,0,43
2020,52016,Monteriggioni,SI,30,45,13,0,0,58,28,9,0,0,37
2020,52016,Monteriggioni,SI,31,55,12,0,0,67,31,14,1,0,46
2020,52016,Monteriggioni,SI,32,48,18,0,0,66,33,27,0,0,60
2020,52016,Monteriggioni,SI,33,52,9,0,0,61,43,20,0,0,63
2020,52016,Monteriggioni,SI,34,47,14,0,0,61,33,29,1,0,63
2020,52016,Monteriggioni,SI,35,34,22,0,0,56,29,25,0,0,54
2020,52016,Monteriggioni,SI,36,39,25,0,0,64,22,33,3,0,58
2020,52016,Monteriggioni,SI,37,40,26,0,0,66,35,42,0,0,77
2020,52016,Monteriggioni,SI,38,33,35,0,0,68,13,33,4,0,50
2020,52016,Monteriggioni,SI,39,22,45,0,0,67,27,33,2,1,63
2020,52016,Monteriggioni,SI,40,44,39,2,0,85,30,33,3,0,66
2020,52016,Monteriggioni,SI,41,27,37,2,0,66,21,44,2,0,67
2020,52016,Monteriggioni,SI,42,22,36,2,0,60,27,49,3,0,79
2020,52016,Monteriggioni,SI,43,33,54,2,0,89,38,57,5,0,100
2020,52016,Monteriggioni,SI,44,42,51,2,0,95,20,46,5,0,71
2020,52016,Monteriggioni,SI,45,37,57,4,1,99,24,61,2,1,88
2020,52016,Monteriggioni,SI,46,23,48,3,0,74,34,57,3,0,94
2020,52016,Monteriggioni,SI,47,35,47,3,0,85,27,64,2,1,94
2020,52016,Monteriggioni,SI,48,27,54,2,1,84,20,52,4,1,77
2020,52016,Monteriggioni,SI,49,23,54,3,0,80,24,52,6,1,83
2020,52016,Monteriggioni,SI,50,20,49,5,0,74,18,64,2,1,85
2020,52016,Monteriggioni,SI,51,18,48,1,2,69,15,67,8,2,92
2020,52016,Monteriggioni,SI,52,17,57,8,1,83,19,58,15,2,94
2020,52016,Monteriggioni,SI,53,18,68,6,0,92,21,64,10,0,95
2020,52016,Monteriggioni,SI,54,18,52,1,1,72,19,48,8,2,77
2020,52016,Monteriggioni,SI,55,20,55,7,3,85,14,53,5,0,72
2020,52016,Monteriggioni,SI,56,16,63,6,2,87,10,52,11,4,77
2020,52016,Monteriggioni,SI,57,9,47,6,1,63,5,50,9,3,67
2020,52016,Monteriggioni,SI,58,8,53,3,1,65,11,44,7,6,68
2020,52016,Monteriggioni,SI,59,13,57,4,1,75,10,53,8,4,75
2020,52016,Monteriggioni,SI,60,6,42,6,0,54,7,45,5,1,58
2020,52016,Monteriggioni,SI,61,2,55,7,0,64,7,53,4,6,70
2020,52016,Monteriggioni,SI,62,5,45,4,0,54,7,42,2,4,55
2020,52016,Monteriggioni,SI,63,10,45,1,1,57,6,52,0,5,63
2020,52016,Monteriggioni,SI,64,5,46,3,3,57,4,41,4,3,52
2020,52016,Monteriggioni,SI,65,3,50,4,4,61,3,55,2,6,66
2020,52016,Monteriggioni,SI,66,6,47,5,1,59,2,30,4,12,48
2020,52016,Monteriggioni,SI,67,3,43,4,1,51,1,40,2,6,49
2020,52016,Monteriggioni,SI,68,2,35,1,2,40,3,48,2,5,58
2020,52016,Monteriggioni,SI,69,1,46,2,3,52,1,52,2,6,61
2020,52016,Monteriggioni,SI,70,2,38,2,3,45,1,34,4,8,47
2020,52016,Monteriggioni,SI,71,2,41,2,1,46,1,50,2,14,67
2020,52016,Monteriggioni,SI,72,4,43,1,4,52,0,43,3,13,59
2020,52016,Monteriggioni,SI,73,1,35,1,2,39,0,53,1,11,65
2020,52016,Monteriggioni,SI,74,2,45,0,5,52,1,42,1,10,54
2020,52016,Monteriggioni,SI,75,2,35,1,5,43,1,20,1,15,37
2020,52016,Monteriggioni,SI,76,1,37,1,2,41,2,31,1,21,55
2020,52016,Monteriggioni,SI,77,2,30,0,4,36,0,27,2,19,48
2020,52016,Monteriggioni,SI,78,3,28,0,6,37,0,23,0,19,42
2020,52016,Monteriggioni,SI,79,4,25,0,1,30,0,18,2,21,41
2020,52016,Monteriggioni,SI,80,3,29,2,9,43,0,21,0,20,41
2020,52016,Monteriggioni,SI,81,2,28,0,4,34,1,25,2,18,46
2020,52016,Monteriggioni,SI,82,3,29,0,7,39,2,20,0,17,39
2020,52016,Monteriggioni,SI,83,1,20,1,4,26,0,13,2,27,42
2020,52016,Monteriggioni,SI,84,1,21,0,7,29,1,10,1,22,34
2020,52016,Monteriggioni,SI,85,0,20,0,9,29,0,14,0,30,44
2020,52016,Monteriggioni,SI,86,0,15,0,5,20,0,8,0,20,28
2020,52016,Monteriggioni,SI,87,2,12,0,7,21,0,10,0,20,30
2020,52016,Monteriggioni,SI,88,0,13,0,3,16,2,3,0,10,15
2020,52016,Monteriggioni,SI,89,0,8,0,3,11,0,5,0,16,21
2020,52016,Monteriggioni,SI,90,2,12,0,7,21,0,3,0,18,21
2020,52016,Monteriggioni,SI,91,1,5,0,3,9,0,0,0,8,8
2020,52016,Monteriggioni,SI,92,0,5,0,3,8,0,1,0,7,8
2020,52016,Monteriggioni,SI,93,0,2,0,2,4,1,0,0,11,12
2020,52016,Monteriggioni,SI,94,1,7,0,1,9,0,0,0,8,8
2020,52016,Monteriggioni,SI,95,0,0,0,1,1,1,1,0,4,6
2020,52016,Monteriggioni,SI,96,0,0,0,0,0,0,1,0,4,5
2020,52016,Monteriggioni,SI,97,0,0,0,2,2,1,0,0,7,8
2020,52016,Monteriggioni,SI,98,0,1,0,2,3,0,0,0,1,1
2020,52016,Monteriggioni,SI,99,0,0,0,0,0,0,0,0,1,1
2020,52016,Monteriggioni,SI,100 e più,0,0,0,0,0,0,0,0,1,1
2020,52017,Monteroni d'Arbia,SI,0,30,0,0,0,30,32,0,0,0,32
2020,52017,Monteroni d'Arbia,SI,1,36,0,0,0,36,39,0,0,0,39
2020,52017,Monteroni d'Arbia,SI,2,40,0,0,0,40,36,0,0,0,36
2020,52017,Monteroni d'Arbia,SI,3,37,0,0,0,37,42,0,0,0,42
2020,52017,Monteroni d'Arbia,SI,4,51,0,0,0,51,44,0,0,0,44
2020,52017,Monteroni d'Arbia,SI,5,54,0,0,0,54,49,0,0,0,49
2020,52017,Monteroni d'Arbia,SI,6,54,0,0,0,54,46,0,0,0,46
2020,52017,Monteroni d'Arbia,SI,7,68,0,0,0,68,50,0,0,0,50
2020,52017,Monteroni d'Arbia,SI,8,45,0,0,0,45,56,0,0,0,56
2020,52017,Monteroni d'Arbia,SI,9,55,0,0,0,55,49,0,0,0,49
2020,52017,Monteroni d'Arbia,SI,10,57,0,0,0,57,50,0,0,0,50
2020,52017,Monteroni d'Arbia,SI,11,53,0,0,0,53,59,0,0,0,59
2020,52017,Monteroni d'Arbia,SI,12,43,0,0,0,43,45,0,0,0,45
2020,52017,Monteroni d'Arbia,SI,13,37,0,0,0,37,60,0,0,0,60
2020,52017,Monteroni d'Arbia,SI,14,36,0,0,0,36,46,0,0,0,46
2020,52017,Monteroni d'Arbia,SI,15,50,0,0,0,50,38,0,0,0,38
2020,52017,Monteroni d'Arbia,SI,16,52,0,0,0,52,41,0,0,0,41
2020,52017,Monteroni d'Arbia,SI,17,49,0,0,0,49,44,0,0,0,44
2020,52017,Monteroni d'Arbia,SI,18,42,0,0,0,42,40,0,0,0,40
2020,52017,Monteroni d'Arbia,SI,19,40,0,0,0,40,45,1,0,0,46
2020,52017,Monteroni d'Arbia,SI,20,42,1,0,0,43,33,6,0,0,39
2020,52017,Monteroni d'Arbia,SI,21,50,0,0,0,50,34,0,0,0,34
2020,52017,Monteroni d'Arbia,SI,22,38,1,0,0,39,31,4,0,0,35
2020,52017,Monteroni d'Arbia,SI,23,37,3,0,0,40,37,2,0,0,39
2020,52017,Monteroni d'Arbia,SI,24,45,5,0,0,50,23,6,0,0,29
2020,52017,Monteroni d'Arbia,SI,25,51,5,0,0,56,38,5,1,0,44
2020,52017,Monteroni d'Arbia,SI,26,28,6,0,0,34,32,6,0,0,38
2020,52017,Monteroni d'Arbia,SI,27,40,3,0,0,43,39,8,0,0,47
2020,52017,Monteroni d'Arbia,SI,28,33,4,0,0,37,29,8,0,0,37
2020,52017,Monteroni d'Arbia,SI,29,43,3,0,0,46,26,13,0,0,39
2020,52017,Monteroni d'Arbia,SI,30,39,9,0,0,48,25,16,0,0,41
2020,52017,Monteroni d'Arbia,SI,31,41,11,0,0,52,28,16,1,0,45
2020,52017,Monteroni d'Arbia,SI,32,32,18,0,0,50,26,23,0,0,49
2020,52017,Monteroni d'Arbia,SI,33,36,15,0,0,51,21,33,0,0,54
2020,52017,Monteroni d'Arbia,SI,34,25,24,0,0,49,30,27,0,0,57
2020,52017,Monteroni d'Arbia,SI,35,26,23,0,0,49,29,36,0,0,65
2020,52017,Monteroni d'Arbia,SI,36,34,15,0,0,49,30,33,2,0,65
2020,52017,Monteroni d'Arbia,SI,37,32,31,0,0,63,30,28,0,0,58
2020,52017,Monteroni d'Arbia,SI,38,27,29,1,0,57,21,37,1,0,59
2020,52017,Monteroni d'Arbia,SI,39,27,35,2,0,64,26,36,0,0,62
2020,52017,Monteroni d'Arbia,SI,40,41,22,0,0,63,24,37,4,0,65
2020,52017,Monteroni d'Arbia,SI,41,32,29,2,0,63,20,41,0,0,61
2020,52017,Monteroni d'Arbia,SI,42,23,41,1,0,65,22,44,2,0,68
2020,52017,Monteroni d'Arbia,SI,43,31,42,2,0,75,17,72,1,1,91
2020,52017,Monteroni d'Arbia,SI,44,23,48,1,0,72,17,40,1,3,61
2020,52017,Monteroni d'Arbia,SI,45,23,49,2,0,74,23,40,6,0,69
2020,52017,Monteroni d'Arbia,SI,46,20,51,2,0,73,21,66,5,0,92
2020,52017,Monteroni d'Arbia,SI,47,14,52,0,0,66,17,46,4,1,68
2020,52017,Monteroni d'Arbia,SI,48,31,54,2,1,88,15,45,9,0,69
2020,52017,Monteroni d'Arbia,SI,49,14,56,5,0,75,11,56,6,1,74
2020,52017,Monteroni d'Arbia,SI,50,14,38,3,0,55,10,51,4,0,65
2020,52017,Monteroni d'Arbia,SI,51,15,52,4,1,72,12,42,6,0,60
2020,52017,Monteroni d'Arbia,SI,52,17,51,7,3,78,13,44,6,1,64
2020,52017,Monteroni d'Arbia,SI,53,18,45,3,0,66,9,55,4,1,69
2020,52017,Monteroni d'Arbia,SI,54,13,52,3,0,68,13,64,5,2,84
2020,52017,Monteroni d'Arbia,SI,55,8,34,11,1,54,6,42,7,1,56
2020,52017,Monteroni d'Arbia,SI,56,8,51,4,0,63,6,54,7,1,68
2020,52017,Monteroni d'Arbia,SI,57,7,53,5,1,66,2,51,5,2,60
2020,52017,Monteroni d'Arbia,SI,58,7,44,5,0,56,6,48,2,6,62
2020,52017,Monteroni d'Arbia,SI,59,7,46,7,2,62,6,52,5,4,67
2020,52017,Monteroni d'Arbia,SI,60,9,40,3,1,53,2,55,3,5,65
2020,52017,Monteroni d'Arbia,SI,61,7,41,1,1,50,7,55,2,6,70
2020,52017,Monteroni d'Arbia,SI,62,9,44,1,0,54,5,34,3,6,48
2020,52017,Monteroni d'Arbia,SI,63,3,31,1,0,35,4,52,5,2,63
2020,52017,Monteroni d'Arbia,SI,64,3,43,2,1,49,0,51,3,7,61
2020,52017,Monteroni d'Arbia,SI,65,8,44,1,1,54,7,48,7,4,66
2020,52017,Monteroni d'Arbia,SI,66,1,47,6,0,54,6,40,3,7,56
2020,52017,Monteroni d'Arbia,SI,67,3,36,3,2,44,1,35,3,9,48
2020,52017,Monteroni d'Arbia,SI,68,2,42,1,0,45,2,33,6,8,49
2020,52017,Monteroni d'Arbia,SI,69,4,34,2,3,43,1,40,2,8,51
2020,52017,Monteroni d'Arbia,SI,70,3,44,3,2,52,2,40,4,3,49
2020,52017,Monteroni d'Arbia,SI,71,4,54,2,1,61,3,44,1,11,59
2020,52017,Monteroni d'Arbia,SI,72,4,59,4,3,70,2,41,2,15,60
2020,52017,Monteroni d'Arbia,SI,73,1,36,3,0,40,2,35,3,12,52
2020,52017,Monteroni d'Arbia,SI,74,3,21,0,2,26,2,26,1,9,38
2020,52017,Monteroni d'Arbia,SI,75,3,30,0,1,34,2,23,1,12,38
2020,52017,Monteroni d'Arbia,SI,76,2,29,3,4,38,1,18,0,13,32
2020,52017,Monteroni d'Arbia,SI,77,1,32,1,2,36,1,24,2,14,41
2020,52017,Monteroni d'Arbia,SI,78,1,20,2,2,25,0,16,0,13,29
2020,52017,Monteroni d'Arbia,SI,79,2,18,0,7,27,0,22,1,21,44
2020,52017,Monteroni d'Arbia,SI,80,2,26,0,6,34,0,20,0,18,38
2020,52017,Monteroni d'Arbia,SI,81,2,20,0,3,25,1,11,0,18,30
2020,52017,Monteroni d'Arbia,SI,82,2,22,1,1,26,0,13,1,14,28
2020,52017,Monteroni d'Arbia,SI,83,3,23,0,4,30,0,15,0,17,32
2020,52017,Monteroni d'Arbia,SI,84,0,19,0,5,24,0,14,0,22,36
2020,52017,Monteroni d'Arbia,SI,85,2,13,0,2,17,1,7,0,15,23
2020,52017,Monteroni d'Arbia,SI,86,5,13,0,6,24,2,6,0,21,29
2020,52017,Monteroni d'Arbia,SI,87,2,15,0,4,21,2,8,0,22,32
2020,52017,Monteroni d'Arbia,SI,88,1,12,0,3,16,0,1,0,12,13
2020,52017,Monteroni d'Arbia,SI,89,0,5,0,4,9,1,2,0,24,27
2020,52017,Monteroni d'Arbia,SI,90,1,7,0,1,9,0,3,1,15,19
2020,52017,Monteroni d'Arbia,SI,91,1,1,0,4,6,2,2,1,16,21
2020,52017,Monteroni d'Arbia,SI,92,0,4,0,1,5,1,0,0,20,21
2020,52017,Monteroni d'Arbia,SI,93,0,0,0,0,0,0,0,1,9,10
2020,52017,Monteroni d'Arbia,SI,94,0,1,0,2,3,0,0,0,7,7
2020,52017,Monteroni d'Arbia,SI,95,2,1,0,0,3,0,0,0,8,8
2020,52017,Monteroni d'Arbia,SI,96,0,0,0,2,2,0,0,0,5,5
2020,52017,Monteroni d'Arbia,SI,97,1,2,0,1,4,0,0,0,5,5
2020,52017,Monteroni d'Arbia,SI,98,0,1,0,0,1,1,0,0,3,4
2020,52017,Monteroni d'Arbia,SI,99,0,0,0,1,1,0,0,0,1,1
2020,52017,Monteroni d'Arbia,SI,100 e più,0,1,0,2,3,0,0,0,5,5
2020,52018,Monticiano,SI,0,3,0,0,0,3,4,0,0,0,4
2020,52018,Monticiano,SI,1,0,0,0,0,0,7,0,0,0,7
2020,52018,Monticiano,SI,2,3,0,0,0,3,6,0,0,0,6
2020,52018,Monticiano,SI,3,6,0,0,0,6,7,0,0,0,7
2020,52018,Monticiano,SI,4,2,0,0,0,2,6,0,0,0,6
2020,52018,Monticiano,SI,5,4,0,0,0,4,5,0,0,0,5
2020,52018,Monticiano,SI,6,8,0,0,0,8,7,0,0,0,7
2020,52018,Monticiano,SI,7,6,0,0,0,6,6,0,0,0,6
2020,52018,Monticiano,SI,8,7,0,0,0,7,5,0,0,0,5
2020,52018,Monticiano,SI,9,2,0,0,0,2,8,0,0,0,8
2020,52018,Monticiano,SI,10,6,0,0,0,6,8,0,0,0,8
2020,52018,Monticiano,SI,11,6,0,0,0,6,13,0,0,0,13
2020,52018,Monticiano,SI,12,8,0,0,0,8,8,0,0,0,8
2020,52018,Monticiano,SI,13,5,0,0,0,5,7,0,0,0,7
2020,52018,Monticiano,SI,14,9,0,0,0,9,9,0,0,0,9
2020,52018,Monticiano,SI,15,9,0,0,0,9,6,0,0,0,6
2020,52018,Monticiano,SI,16,8,0,0,0,8,6,0,0,0,6
2020,52018,Monticiano,SI,17,10,0,0,0,10,8,0,0,0,8
2020,52018,Monticiano,SI,18,6,0,0,0,6,9,0,0,0,9
2020,52018,Monticiano,SI,19,9,0,0,0,9,7,1,0,0,8
2020,52018,Monticiano,SI,20,11,0,0,0,11,6,0,0,0,6
2020,52018,Monticiano,SI,21,7,0,1,0,8,4,2,0,0,6
2020,52018,Monticiano,SI,22,10,1,0,0,11,3,0,0,0,3
2020,52018,Monticiano,SI,23,3,0,0,0,3,4,2,0,0,6
2020,52018,Monticiano,SI,24,7,0,1,0,8,5,2,0,0,7
2020,52018,Monticiano,SI,25,7,1,1,0,9,3,0,0,0,3
2020,52018,Monticiano,SI,26,6,0,0,0,6,2,1,0,0,3
2020,52018,Monticiano,SI,27,9,3,0,0,12,3,3,0,0,6
2020,52018,Monticiano,SI,28,7,2,0,0,9,5,4,0,0,9
2020,52018,Monticiano,SI,29,6,2,0,0,8,4,1,0,0,5
2020,52018,Monticiano,SI,30,8,0,0,0,8,3,4,0,0,7
2020,52018,Monticiano,SI,31,1,2,0,0,3,1,4,0,0,5
2020,52018,Monticiano,SI,32,5,3,0,0,8,2,3,0,0,5
2020,52018,Monticiano,SI,33,3,5,0,0,8,2,0,1,0,3
2020,52018,Monticiano,SI,34,6,3,0,0,9,9,5,0,0,14
2020,52018,Monticiano,SI,35,1,3,0,0,4,2,3,0,0,5
2020,52018,Monticiano,SI,36,3,6,0,0,9,1,2,0,0,3
2020,52018,Monticiano,SI,37,3,6,0,0,9,4,2,0,0,6
2020,52018,Monticiano,SI,38,5,1,0,0,6,2,4,0,0,6
2020,52018,Monticiano,SI,39,5,8,0,0,13,5,3,0,0,8
2020,52018,Monticiano,SI,40,5,3,0,0,8,3,3,0,0,6
2020,52018,Monticiano,SI,41,0,7,0,0,7,4,12,0,0,16
2020,52018,Monticiano,SI,42,7,4,1,0,12,1,9,0,0,10
2020,52018,Monticiano,SI,43,3,6,0,0,9,3,7,0,0,10
2020,52018,Monticiano,SI,44,7,9,0,0,16,5,10,0,0,15
2020,52018,Monticiano,SI,45,3,4,1,0,8,4,10,2,0,16
2020,52018,Monticiano,SI,46,9,11,0,0,20,0,7,0,0,7
2020,52018,Monticiano,SI,47,6,9,2,0,17,2,11,0,0,13
2020,52018,Monticiano,SI,48,10,10,0,0,20,4,7,2,0,13
2020,52018,Monticiano,SI,49,7,14,1,0,22,0,7,1,0,8
2020,52018,Monticiano,SI,50,6,7,0,0,13,2,5,0,0,7
2020,52018,Monticiano,SI,51,6,12,1,0,19,1,8,3,0,12
2020,52018,Monticiano,SI,52,2,7,0,0,9,1,11,1,0,13
2020,52018,Monticiano,SI,53,3,6,0,0,9,1,8,2,0,11
2020,52018,Monticiano,SI,54,4,8,1,0,13,2,7,2,1,12
2020,52018,Monticiano,SI,55,5,8,1,0,14,3,7,1,0,11
2020,52018,Monticiano,SI,56,1,6,4,0,11,1,9,1,1,12
2020,52018,Monticiano,SI,57,3,10,1,0,14,0,7,0,0,7
2020,52018,Monticiano,SI,58,1,12,1,0,14,4,10,1,0,15
2020,52018,Monticiano,SI,59,2,5,1,0,8,1,4,0,0,5
2020,52018,Monticiano,SI,60,4,9,1,0,14,0,9,2,0,11
2020,52018,Monticiano,SI,61,0,7,0,0,7,2,5,1,1,9
2020,52018,Monticiano,SI,62,1,5,1,1,8,1,7,0,0,8
2020,52018,Monticiano,SI,63,1,11,0,0,12,1,7,0,1,9
2020,52018,Monticiano,SI,64,2,5,1,1,9,1,9,1,1,12
2020,52018,Monticiano,SI,65,1,5,1,0,7,1,7,1,1,10
2020,52018,Monticiano,SI,66,2,5,1,0,8,1,4,1,0,6
2020,52018,Monticiano,SI,67,1,10,0,1,12,0,7,0,0,7
2020,52018,Monticiano,SI,68,1,8,1,0,10,0,9,0,1,10
2020,52018,Monticiano,SI,69,3,6,1,2,12,1,3,1,1,6
2020,52018,Monticiano,SI,70,0,7,1,0,8,0,4,1,5,10
2020,52018,Monticiano,SI,71,0,1,0,0,1,0,8,0,5,13
2020,52018,Monticiano,SI,72,0,6,1,0,7,0,8,0,4,12
2020,52018,Monticiano,SI,73,2,9,0,0,11,0,5,0,1,6
2020,52018,Monticiano,SI,74,1,5,1,0,7,0,7,1,2,10
2020,52018,Monticiano,SI,75,0,8,2,1,11,1,4,0,1,6
2020,52018,Monticiano,SI,76,0,6,0,1,7,0,3,0,2,5
2020,52018,Monticiano,SI,77,0,8,0,0,8,1,7,0,4,12
2020,52018,Monticiano,SI,78,1,6,0,0,7,1,2,0,4,7
2020,52018,Monticiano,SI,79,0,8,0,1,9,0,3,0,4,7
2020,52018,Monticiano,SI,80,1,5,0,0,6,0,4,1,4,9
2020,52018,Monticiano,SI,81,1,5,0,1,7,0,4,0,5,9
2020,52018,Monticiano,SI,82,2,3,0,0,5,1,6,0,5,12
2020,52018,Monticiano,SI,83,0,5,0,2,7,0,1,0,4,5
2020,52018,Monticiano,SI,84,0,1,0,0,1,0,1,0,5,6
2020,52018,Monticiano,SI,85,0,5,0,0,5,0,1,0,4,5
2020,52018,Monticiano,SI,86,0,6,0,1,7,0,0,0,5,5
2020,52018,Monticiano,SI,87,0,1,0,1,2,1,1,0,8,10
2020,52018,Monticiano,SI,88,2,3,0,2,7,1,2,0,4,7
2020,52018,Monticiano,SI,89,0,2,0,1,3,0,0,0,6,6
2020,52018,Monticiano,SI,90,0,1,0,1,2,0,0,0,4,4
2020,52018,Monticiano,SI,91,0,0,0,0,0,0,0,0,5,5
2020,52018,Monticiano,SI,92,0,1,0,1,2,0,0,0,6,6
2020,52018,Monticiano,SI,93,0,1,0,1,2,0,0,0,1,1
2020,52018,Monticiano,SI,94,0,0,0,0,0,0,1,0,2,3
2020,52018,Monticiano,SI,95,0,0,0,1,1,0,0,0,5,5
2020,52018,Monticiano,SI,96,0,0,0,0,0,0,0,0,2,2
2020,52018,Monticiano,SI,97,0,0,0,0,0,0,0,0,2,2
2020,52018,Monticiano,SI,98,0,0,0,0,0,0,0,0,2,2
2020,52018,Monticiano,SI,99,0,0,0,0,0,0,0,0,0,0
2020,52018,Monticiano,SI,100 e più,0,0,0,1,1,0,0,0,2,2
2020,52019,Murlo,SI,0,13,0,0,0,13,9,0,0,0,9
2020,52019,Murlo,SI,1,12,0,0,0,12,6,0,0,0,6
2020,52019,Murlo,SI,2,7,0,0,0,7,6,0,0,0,6
2020,52019,Murlo,SI,3,12,0,0,0,12,9,0,0,0,9
2020,52019,Murlo,SI,4,7,0,0,0,7,9,0,0,0,9
2020,52019,Murlo,SI,5,16,0,0,0,16,7,0,0,0,7
2020,52019,Murlo,SI,6,15,0,0,0,15,16,0,0,0,16
2020,52019,Murlo,SI,7,11,0,0,0,11,21,0,0,0,21
2020,52019,Murlo,SI,8,10,0,0,0,10,11,0,0,0,11
2020,52019,Murlo,SI,9,7,0,0,0,7,8,0,0,0,8
2020,52019,Murlo,SI,10,13,0,0,0,13,11,0,0,0,11
2020,52019,Murlo,SI,11,12,0,0,0,12,10,0,0,0,10
2020,52019,Murlo,SI,12,17,0,0,0,17,16,0,0,0,16
2020,52019,Murlo,SI,13,16,0,0,0,16,6,0,0,0,6
2020,52019,Murlo,SI,14,12,0,0,0,12,8,0,0,0,8
2020,52019,Murlo,SI,15,8,0,0,0,8,14,0,0,0,14
2020,52019,Murlo,SI,16,10,0,0,0,10,16,0,0,0,16
2020,52019,Murlo,SI,17,13,0,0,0,13,11,0,0,0,11
2020,52019,Murlo,SI,18,17,0,0,0,17,10,0,0,0,10
2020,52019,Murlo,SI,19,20,0,0,0,20,10,0,0,0,10
2020,52019,Murlo,SI,20,8,0,0,0,8,15,0,0,0,15
2020,52019,Murlo,SI,21,11,0,0,0,11,9,0,0,0,9
2020,52019,Murlo,SI,22,13,0,0,0,13,13,0,0,0,13
2020,52019,Murlo,SI,23,7,0,0,0,7,8,2,0,0,10
2020,52019,Murlo,SI,24,14,0,0,0,14,4,0,0,0,4
2020,52019,Murlo,SI,25,10,1,0,0,11,4,2,0,0,6
2020,52019,Murlo,SI,26,9,1,0,0,10,7,3,0,0,10
2020,52019,Murlo,SI,27,14,1,0,0,15,6,5,0,0,11
2020,52019,Murlo,SI,28,13,0,0,0,13,10,3,1,0,14
2020,52019,Murlo,SI,29,9,5,0,0,14,4,7,0,0,11
2020,52019,Murlo,SI,30,13,4,0,0,17,4,6,0,0,10
2020,52019,Murlo,SI,31,8,4,0,0,12,5,5,0,0,10
2020,52019,Murlo,SI,32,10,4,0,0,14,10,3,0,1,14
2020,52019,Murlo,SI,33,5,3,0,0,8,12,6,0,0,18
2020,52019,Murlo,SI,34,3,4,0,0,7,6,5,0,0,11
2020,52019,Murlo,SI,35,6,2,0,0,8,3,10,0,0,13
2020,52019,Murlo,SI,36,10,7,0,0,17,12,8,0,0,20
2020,52019,Murlo,SI,37,11,6,0,0,17,4,6,1,0,11
2020,52019,Murlo,SI,38,7,6,0,0,13,8,7,0,0,15
2020,52019,Murlo,SI,39,11,3,0,0,14,4,6,1,1,12
2020,52019,Murlo,SI,40,5,10,0,0,15,6,11,0,0,17
2020,52019,Murlo,SI,41,11,6,0,0,17,7,9,0,0,16
2020,52019,Murlo,SI,42,6,10,0,0,16,6,9,0,0,15
2020,52019,Murlo,SI,43,13,11,0,0,24,5,11,4,1,21
2020,52019,Murlo,SI,44,6,11,1,0,18,4,16,2,0,22
2020,52019,Murlo,SI,45,12,14,1,0,27,6,17,1,0,24
2020,52019,Murlo,SI,46,12,13,1,0,26,2,14,1,0,17
2020,52019,Murlo,SI,47,12,9,1,0,22,8,19,0,0,27
2020,52019,Murlo,SI,48,6,11,2,0,19,2,14,2,0,18
2020,52019,Murlo,SI,49,7,17,3,0,27,6,10,1,0,17
2020,52019,Murlo,SI,50,8,13,0,0,21,7,17,1,0,25
2020,52019,Murlo,SI,51,4,14,0,0,18,6,10,2,0,18
2020,52019,Murlo,SI,52,3,19,3,0,25,4,14,1,1,20
2020,52019,Murlo,SI,53,3,13,2,0,18,5,14,4,2,25
2020,52019,Murlo,SI,54,4,22,2,0,28,5,11,0,1,17
2020,52019,Murlo,SI,55,4,13,1,0,18,4,9,1,1,15
2020,52019,Murlo,SI,56,7,17,1,0,25,3,11,3,1,18
2020,52019,Murlo,SI,57,6,9,4,0,19,5,10,1,0,16
2020,52019,Murlo,SI,58,3,15,4,0,22,2,10,2,1,15
2020,52019,Murlo,SI,59,4,9,0,1,14,1,13,2,4,20
2020,52019,Murlo,SI,60,3,5,1,0,9,0,6,2,0,8
2020,52019,Murlo,SI,61,1,15,2,0,18,1,10,1,1,13
2020,52019,Murlo,SI,62,2,7,3,0,12,1,11,4,3,19
2020,52019,Murlo,SI,63,6,6,0,2,14,2,14,3,2,21
2020,52019,Murlo,SI,64,0,11,1,0,12,1,3,2,2,8
2020,52019,Murlo,SI,65,2,9,1,0,12,2,11,0,1,14
2020,52019,Murlo,SI,66,3,9,0,0,12,0,11,0,4,15
2020,52019,Murlo,SI,67,1,9,1,0,11,1,11,2,3,17
2020,52019,Murlo,SI,68,0,9,1,0,10,0,9,0,4,13
2020,52019,Murlo,SI,69,3,10,0,1,14,1,9,0,2,12
2020,52019,Murlo,SI,70,1,8,0,1,10,0,8,0,1,9
2020,52019,Murlo,SI,71,0,9,1,1,11,1,7,0,2,10
2020,52019,Murlo,SI,72,0,12,1,0,13,2,12,2,3,19
2020,52019,Murlo,SI,73,1,15,0,1,17,1,7,0,4,12
2020,52019,Murlo,SI,74,2,10,0,1,13,0,12,1,6,19
2020,52019,Murlo,SI,75,1,3,0,0,4,0,13,0,2,15
2020,52019,Murlo,SI,76,0,9,0,0,9,1,6,0,1,8
2020,52019,Murlo,SI,77,1,9,0,1,11,0,5,0,4,9
2020,52019,Murlo,SI,78,1,9,0,1,11,0,9,1,4,14
2020,52019,Murlo,SI,79,2,3,0,1,6,0,7,0,7,14
2020,52019,Murlo,SI,80,0,12,0,2,14,1,6,0,14,21
2020,52019,Murlo,SI,81,3,6,0,0,9,1,3,0,5,9
2020,52019,Murlo,SI,82,1,8,1,1,11,0,3,0,5,8
2020,52019,Murlo,SI,83,0,7,0,0,7,1,1,0,9,11
2020,52019,Murlo,SI,84,0,4,1,0,5,1,1,0,3,5
2020,52019,Murlo,SI,85,1,2,0,0,3,0,1,0,6,7
2020,52019,Murlo,SI,86,0,6,0,3,9,0,1,0,5,6
2020,52019,Murlo,SI,87,2,5,0,2,9,0,0,0,6,6
2020,52019,Murlo,SI,88,0,0,0,1,1,0,0,0,2,2
2020,52019,Murlo,SI,89,1,3,0,0,4,0,0,1,3,4
2020,52019,Murlo,SI,90,0,1,0,0,1,0,1,1,3,5
2020,52019,Murlo,SI,91,0,1,0,1,2,0,0,0,1,1
2020,52019,Murlo,SI,92,1,0,0,1,2,0,0,0,2,2
2020,52019,Murlo,SI,93,1,0,0,0,1,1,0,1,2,4
2020,52019,Murlo,SI,94,0,0,0,0,0,0,0,0,1,1
2020,52019,Murlo,SI,95,0,0,0,0,0,0,0,0,1,1
2020,52019,Murlo,SI,96,0,1,0,0,1,0,0,0,0,0
2020,52019,Murlo,SI,97,0,0,0,1,1,0,0,0,0,0
2020,52019,Murlo,SI,98,0,0,0,0,0,0,0,0,1,1
2020,52019,Murlo,SI,99,0,0,0,0,0,0,0,0,1,1
2020,52019,Murlo,SI,100 e più,0,0,0,0,0,0,0,0,0,0
2020,52020,Piancastagnaio,SI,0,17,0,0,0,17,14,0,0,0,14
2020,52020,Piancastagnaio,SI,1,11,0,0,0,11,13,0,0,0,13
2020,52020,Piancastagnaio,SI,2,8,0,0,0,8,13,0,0,0,13
2020,52020,Piancastagnaio,SI,3,15,0,0,0,15,9,0,0,0,9
2020,52020,Piancastagnaio,SI,4,15,0,0,0,15,17,0,0,0,17
2020,52020,Piancastagnaio,SI,5,15,0,0,0,15,15,0,0,0,15
2020,52020,Piancastagnaio,SI,6,5,0,0,0,5,15,0,0,0,15
2020,52020,Piancastagnaio,SI,7,17,0,0,0,17,17,0,0,0,17
2020,52020,Piancastagnaio,SI,8,12,0,0,0,12,28,0,0,0,28
2020,52020,Piancastagnaio,SI,9,12,0,0,0,12,18,0,0,0,18
2020,52020,Piancastagnaio,SI,10,22,0,0,0,22,12,0,0,0,12
2020,52020,Piancastagnaio,SI,11,23,0,0,0,23,19,0,0,0,19
2020,52020,Piancastagnaio,SI,12,12,0,0,0,12,14,0,0,0,14
2020,52020,Piancastagnaio,SI,13,14,0,0,0,14,14,0,0,0,14
2020,52020,Piancastagnaio,SI,14,20,0,0,0,20,15,0,0,0,15
2020,52020,Piancastagnaio,SI,15,18,0,0,0,18,20,0,0,0,20
2020,52020,Piancastagnaio,SI,16,13,0,0,0,13,13,0,0,0,13
2020,52020,Piancastagnaio,SI,17,12,0,0,0,12,3,0,0,0,3
2020,52020,Piancastagnaio,SI,18,20,0,0,0,20,12,0,0,0,12
2020,52020,Piancastagnaio,SI,19,15,0,0,0,15,14,0,0,0,14
2020,52020,Piancastagnaio,SI,20,10,0,0,0,10,10,0,0,0,10
2020,52020,Piancastagnaio,SI,21,32,0,0,0,32,27,1,0,0,28
2020,52020,Piancastagnaio,SI,22,9,0,0,0,9,15,3,0,0,18
2020,52020,Piancastagnaio,SI,23,19,0,0,0,19,9,2,0,0,11
2020,52020,Piancastagnaio,SI,24,28,1,0,0,29,18,3,0,0,21
2020,52020,Piancastagnaio,SI,25,20,0,0,0,20,19,2,0,0,21
2020,52020,Piancastagnaio,SI,26,28,1,0,0,29,20,1,0,0,21
2020,52020,Piancastagnaio,SI,27,25,0,0,0,25,12,5,0,0,17
2020,52020,Piancastagnaio,SI,28,18,2,0,0,20,15,0,0,0,15
2020,52020,Piancastagnaio,SI,29,18,3,0,0,21,15,7,0,0,22
2020,52020,Piancastagnaio,SI,30,13,5,0,0,18,12,8,1,0,21
2020,52020,Piancastagnaio,SI,31,18,6,0,0,24,9,5,0,0,14
2020,52020,Piancastagnaio,SI,32,20,4,1,0,25,13,14,0,0,27
2020,52020,Piancastagnaio,SI,33,19,5,0,0,24,12,7,0,0,19
2020,52020,Piancastagnaio,SI,34,11,4,0,0,15,10,10,0,0,20
2020,52020,Piancastagnaio,SI,35,16,4,0,0,20,6,5,0,0,11
2020,52020,Piancastagnaio,SI,36,11,9,0,0,20,12,4,1,0,17
2020,52020,Piancastagnaio,SI,37,12,6,0,0,18,17,6,0,1,24
2020,52020,Piancastagnaio,SI,38,16,12,0,0,28,5,12,0,0,17
2020,52020,Piancastagnaio,SI,39,15,8,1,0,24,22,10,4,0,36
2020,52020,Piancastagnaio,SI,40,10,10,0,0,20,9,18,3,0,30
2020,52020,Piancastagnaio,SI,41,17,9,1,0,27,9,9,2,0,20
2020,52020,Piancastagnaio,SI,42,18,17,0,0,35,14,15,0,0,29
2020,52020,Piancastagnaio,SI,43,15,16,2,0,33,13,19,5,0,37
2020,52020,Piancastagnaio,SI,44,22,16,1,0,39,6,19,2,0,27
2020,52020,Piancastagnaio,SI,45,17,11,1,0,29,10,14,1,0,25
2020,52020,Piancastagnaio,SI,46,11,14,1,0,26,6,20,2,0,28
2020,52020,Piancastagnaio,SI,47,19,13,1,0,33,6,12,2,0,20
2020,52020,Piancastagnaio,SI,48,8,16,3,0,27,3,17,3,0,23
2020,52020,Piancastagnaio,SI,49,8,11,2,0,21,7,20,1,0,28
2020,52020,Piancastagnaio,SI,50,9,17,3,0,29,7,23,3,0,33
2020,52020,Piancastagnaio,SI,51,8,20,0,0,28,10,24,3,0,37
2020,52020,Piancastagnaio,SI,52,11,17,1,1,30,4,26,2,1,33
2020,52020,Piancastagnaio,SI,53,5,20,2,1,28,2,17,3,1,23
2020,52020,Piancastagnaio,SI,54,6,22,0,0,28,5,25,5,1,36
2020,52020,Piancastagnaio,SI,55,5,15,3,0,23,6,30,3,5,44
2020,52020,Piancastagnaio,SI,56,3,27,4,0,34,3,28,3,2,36
2020,52020,Piancastagnaio,SI,57,4,25,2,1,32,3,24,1,3,31
2020,52020,Piancastagnaio,SI,58,3,18,3,0,24,2,25,2,0,29
2020,52020,Piancastagnaio,SI,59,2,26,4,0,32,5,27,4,1,37
2020,52020,Piancastagnaio,SI,60,7,31,2,0,40,5,30,0,6,41
2020,52020,Piancastagnaio,SI,61,1,31,3,1,36,2,23,3,4,32
2020,52020,Piancastagnaio,SI,62,7,33,1,0,41,0,27,2,2,31
2020,52020,Piancastagnaio,SI,63,0,26,1,1,28,2,19,0,5,26
2020,52020,Piancastagnaio,SI,64,6,19,2,0,27,5,28,0,5,38
2020,52020,Piancastagnaio,SI,65,3,20,4,1,28,8,23,0,5,36
2020,52020,Piancastagnaio,SI,66,5,22,0,0,27,2,35,0,10,47
2020,52020,Piancastagnaio,SI,67,3,33,1,0,37,2,17,2,5,26
2020,52020,Piancastagnaio,SI,68,1,19,0,3,23,2,18,2,4,26
2020,52020,Piancastagnaio,SI,69,2,22,1,2,27,1,7,1,8,17
2020,52020,Piancastagnaio,SI,70,1,20,1,2,24,1,13,0,4,18
2020,52020,Piancastagnaio,SI,71,3,24,2,0,29,0,16,0,3,19
2020,52020,Piancastagnaio,SI,72,2,19,1,3,25,2,20,0,9,31
2020,52020,Piancastagnaio,SI,73,2,19,1,1,23,0,10,2,6,18
2020,52020,Piancastagnaio,SI,74,1,15,1,3,20,0,10,1,6,17
2020,52020,Piancastagnaio,SI,75,1,10,1,0,12,0,10,1,12,23
2020,52020,Piancastagnaio,SI,76,1,14,0,2,17,0,13,0,6,19
2020,52020,Piancastagnaio,SI,77,1,16,0,3,20,0,9,0,3,12
2020,52020,Piancastagnaio,SI,78,2,10,0,1,13,0,13,1,8,22
2020,52020,Piancastagnaio,SI,79,4,11,0,0,15,0,6,1,7,14
2020,52020,Piancastagnaio,SI,80,2,11,0,3,16,0,11,0,8,19
2020,52020,Piancastagnaio,SI,81,1,3,0,3,7,0,8,0,9,17
2020,52020,Piancastagnaio,SI,82,1,16,0,7,24,0,8,0,18,26
2020,52020,Piancastagnaio,SI,83,0,14,0,1,15,1,4,0,12,17
2020,52020,Piancastagnaio,SI,84,0,8,0,3,11,1,3,0,15,19
2020,52020,Piancastagnaio,SI,85,1,8,0,4,13,0,9,0,12,21
2020,52020,Piancastagnaio,SI,86,0,4,0,1,5,0,3,0,12,15
2020,52020,Piancastagnaio,SI,87,1,4,0,1,6,1,5,0,11,17
2020,52020,Piancastagnaio,SI,88,0,5,0,1,6,0,8,0,11,19
2020,52020,Piancastagnaio,SI,89,1,4,0,1,6,0,1,1,17,19
2020,52020,Piancastagnaio,SI,90,0,2,0,3,5,0,1,0,10,11
2020,52020,Piancastagnaio,SI,91,1,5,0,3,9,0,1,0,7,8
2020,52020,Piancastagnaio,SI,92,1,2,0,0,3,0,1,0,11,12
2020,52020,Piancastagnaio,SI,93,0,2,0,4,6,0,0,0,10,10
2020,52020,Piancastagnaio,SI,94,0,0,0,1,1,0,0,0,8,8
2020,52020,Piancastagnaio,SI,95,0,1,0,0,1,0,1,0,3,4
2020,52020,Piancastagnaio,SI,96,0,2,0,1,3,0,2,0,6,8
2020,52020,Piancastagnaio,SI,97,0,0,0,1,1,0,0,0,3,3
2020,52020,Piancastagnaio,SI,98,0,0,0,2,2,0,0,0,1,1
2020,52020,Piancastagnaio,SI,99,0,0,0,0,0,0,0,0,0,0
2020,52020,Piancastagnaio,SI,100 e più,0,0,0,0,0,0,0,0,2,2
2020,52021,Pienza,SI,0,4,0,0,0,4,6,0,0,0,6
2020,52021,Pienza,SI,1,6,0,0,0,6,5,0,0,0,5
2020,52021,Pienza,SI,2,6,0,0,0,6,0,0,0,0,0
2020,52021,Pienza,SI,3,5,0,0,0,5,5,0,0,0,5
2020,52021,Pienza,SI,4,4,0,0,0,4,9,0,0,0,9
2020,52021,Pienza,SI,5,7,0,0,0,7,7,0,0,0,7
2020,52021,Pienza,SI,6,7,0,0,0,7,6,0,0,0,6
2020,52021,Pienza,SI,7,4,0,0,0,4,9,0,0,0,9
2020,52021,Pienza,SI,8,8,0,0,0,8,9,0,0,0,9
2020,52021,Pienza,SI,9,8,0,0,0,8,7,0,0,0,7
2020,52021,Pienza,SI,10,8,0,0,0,8,16,0,0,0,16
2020,52021,Pienza,SI,11,7,0,0,0,7,9,0,0,0,9
2020,52021,Pienza,SI,12,6,0,0,0,6,5,0,0,0,5
2020,52021,Pienza,SI,13,11,0,0,0,11,6,0,0,0,6
2020,52021,Pienza,SI,14,6,0,0,0,6,4,0,0,0,4
2020,52021,Pienza,SI,15,8,0,0,0,8,7,0,0,0,7
2020,52021,Pienza,SI,16,4,0,0,0,4,10,0,0,0,10
2020,52021,Pienza,SI,17,10,0,0,0,10,8,0,0,0,8
2020,52021,Pienza,SI,18,8,0,0,0,8,10,0,0,0,10
2020,52021,Pienza,SI,19,11,0,0,0,11,9,0,0,0,9
2020,52021,Pienza,SI,20,12,0,0,0,12,9,0,0,0,9
2020,52021,Pienza,SI,21,8,0,0,0,8,11,0,0,0,11
2020,52021,Pienza,SI,22,13,0,0,0,13,5,0,0,0,5
2020,52021,Pienza,SI,23,9,0,0,0,9,7,0,0,0,7
2020,52021,Pienza,SI,24,11,0,0,0,11,7,0,0,0,7
2020,52021,Pienza,SI,25,7,0,0,0,7,3,0,0,0,3
2020,52021,Pienza,SI,26,10,0,0,0,10,7,0,0,0,7
2020,52021,Pienza,SI,27,11,0,0,0,11,8,1,0,0,9
2020,52021,Pienza,SI,28,9,0,0,0,9,9,1,0,0,10
2020,52021,Pienza,SI,29,4,2,0,0,6,8,0,0,0,8
2020,52021,Pienza,SI,30,10,0,0,0,10,6,2,1,0,9
2020,52021,Pienza,SI,31,8,1,0,0,9,5,1,1,0,7
2020,52021,Pienza,SI,32,5,2,0,0,7,3,4,0,0,7
2020,52021,Pienza,SI,33,5,6,0,0,11,11,3,0,0,14
2020,52021,Pienza,SI,34,4,2,1,0,7,6,5,0,0,11
2020,52021,Pienza,SI,35,4,1,0,0,5,1,0,0,0,1
2020,52021,Pienza,SI,36,7,5,0,0,12,6,3,0,0,9
2020,52021,Pienza,SI,37,5,1,0,0,6,3,5,0,0,8
2020,52021,Pienza,SI,38,7,1,0,0,8,8,8,0,0,16
2020,52021,Pienza,SI,39,8,5,0,0,13,1,5,0,0,6
2020,52021,Pienza,SI,40,13,7,0,0,20,3,11,0,0,14
2020,52021,Pienza,SI,41,5,7,0,0,12,7,3,2,0,12
2020,52021,Pienza,SI,42,5,6,0,0,11,3,7,2,0,12
2020,52021,Pienza,SI,43,3,7,0,0,10,5,8,0,0,13
2020,52021,Pienza,SI,44,5,4,0,0,9,4,8,0,0,12
2020,52021,Pienza,SI,45,7,8,0,0,15,4,11,1,0,16
2020,52021,Pienza,SI,46,5,3,0,0,8,3,11,2,0,16
2020,52021,Pienza,SI,47,5,9,0,0,14,3,14,0,0,17
2020,52021,Pienza,SI,48,4,12,0,0,16,1,12,0,1,14
2020,52021,Pienza,SI,49,5,13,1,0,19,4,18,0,1,23
2020,52021,Pienza,SI,50,3,11,1,0,15,8,7,1,0,16
2020,52021,Pienza,SI,51,3,13,1,1,18,3,12,0,0,15
2020,52021,Pienza,SI,52,7,13,2,0,22,6,9,1,0,16
2020,52021,Pienza,SI,53,0,14,1,0,15,5,16,2,0,23
2020,52021,Pienza,SI,54,3,10,0,0,13,0,19,0,0,19
2020,52021,Pienza,SI,55,8,12,0,0,20,2,14,1,0,17
2020,52021,Pienza,SI,56,4,10,0,0,14,2,8,0,0,10
2020,52021,Pienza,SI,57,3,9,0,0,12,2,19,1,0,22
2020,52021,Pienza,SI,58,3,13,0,0,16,3,11,1,0,15
2020,52021,Pienza,SI,59,5,11,0,0,16,3,11,2,1,17
2020,52021,Pienza,SI,60,2,12,1,1,16,2,13,1,3,19
2020,52021,Pienza,SI,61,4,12,2,0,18,0,8,1,1,10
2020,52021,Pienza,SI,62,2,11,1,0,14,0,15,1,2,18
2020,52021,Pienza,SI,63,3,10,0,0,13,1,7,0,2,10
2020,52021,Pienza,SI,64,1,15,0,1,17,0,10,1,2,13
2020,52021,Pienza,SI,65,2,8,0,1,11,0,18,2,2,22
2020,52021,Pienza,SI,66,0,12,0,0,12,0,14,1,1,16
2020,52021,Pienza,SI,67,1,13,3,0,17,0,8,1,2,11
2020,52021,Pienza,SI,68,0,11,1,1,13,0,7,0,1,8
2020,52021,Pienza,SI,69,0,12,1,0,13,1,9,0,3,13
2020,52021,Pienza,SI,70,0,15,2,0,17,0,16,2,4,22
2020,52021,Pienza,SI,71,1,8,1,1,11,0,11,0,2,13
2020,52021,Pienza,SI,72,1,8,1,1,11,0,12,0,0,12
2020,52021,Pienza,SI,73,3,21,1,2,27,2,8,2,6,18
2020,52021,Pienza,SI,74,0,11,1,0,12,3,7,0,6,16
2020,52021,Pienza,SI,75,1,15,0,0,16,0,5,0,3,8
2020,52021,Pienza,SI,76,2,6,1,1,10,0,10,0,9,19
2020,52021,Pienza,SI,77,0,2,0,2,4,1,4,1,8,14
2020,52021,Pienza,SI,78,1,3,0,0,4,0,5,0,3,8
2020,52021,Pienza,SI,79,1,6,1,1,9,0,4,1,3,8
2020,52021,Pienza,SI,80,0,10,0,2,12,1,14,0,6,21
2020,52021,Pienza,SI,81,0,8,0,1,9,0,5,0,10,15
2020,52021,Pienza,SI,82,0,4,0,2,6,0,6,1,10,17
2020,52021,Pienza,SI,83,2,5,0,0,7,0,0,0,4,4
2020,52021,Pienza,SI,84,0,3,0,1,4,0,4,0,7,11
2020,52021,Pienza,SI,85,0,6,0,2,8,2,3,0,10,15
2020,52021,Pienza,SI,86,2,5,0,0,7,0,3,0,7,10
2020,52021,Pienza,SI,87,0,5,0,1,6,0,1,0,6,7
2020,52021,Pienza,SI,88,0,4,0,2,6,1,0,0,5,6
2020,52021,Pienza,SI,89,0,5,0,0,5,0,2,0,5,7
2020,52021,Pienza,SI,90,0,4,0,0,4,0,2,0,9,11
2020,52021,Pienza,SI,91,0,1,0,1,2,0,1,0,3,4
2020,52021,Pienza,SI,92,1,1,0,0,2,0,0,0,1,1
2020,52021,Pienza,SI,93,0,0,0,2,2,0,0,0,9,9
2020,52021,Pienza,SI,94,0,0,0,1,1,1,0,0,1,2
2020,52021,Pienza,SI,95,0,0,0,0,0,0,0,0,2,2
2020,52021,Pienza,SI,96,0,1,0,0,1,0,0,0,3,3
2020,52021,Pienza,SI,97,0,0,0,0,0,0,0,0,1,1
2020,52021,Pienza,SI,98,0,0,0,0,0,0,0,0,0,0
2020,52021,Pienza,SI,99,0,0,0,0,0,0,0,0,0,0
2020,52021,Pienza,SI,100 e più,0,0,0,1,1,0,0,0,3,3
2020,52022,Poggibonsi,SI,0,88,0,0,0,88,91,0,0,0,91
2020,52022,Poggibonsi,SI,1,106,0,0,0,106,113,0,0,0,113
2020,52022,Poggibonsi,SI,2,90,0,0,0,90,110,0,0,0,110
2020,52022,Poggibonsi,SI,3,116,0,0,0,116,106,0,0,0,106
2020,52022,Poggibonsi,SI,4,112,0,0,0,112,106,0,0,0,106
2020,52022,Poggibonsi,SI,5,130,0,0,0,130,134,0,0,0,134
2020,52022,Poggibonsi,SI,6,127,0,0,0,127,113,0,0,0,113
2020,52022,Poggibonsi,SI,7,112,0,0,0,112,113,0,0,0,113
2020,52022,Poggibonsi,SI,8,143,0,0,0,143,107,0,0,0,107
2020,52022,Poggibonsi,SI,9,122,0,0,0,122,113,0,0,0,113
2020,52022,Poggibonsi,SI,10,123,0,0,0,123,145,0,0,0,145
2020,52022,Poggibonsi,SI,11,136,0,0,0,136,127,0,0,0,127
2020,52022,Poggibonsi,SI,12,128,0,0,0,128,115,0,0,0,115
2020,52022,Poggibonsi,SI,13,127,0,0,0,127,146,0,0,0,146
2020,52022,Poggibonsi,SI,14,129,0,0,0,129,155,0,0,0,155
2020,52022,Poggibonsi,SI,15,145,0,0,0,145,116,0,0,0,116
2020,52022,Poggibonsi,SI,16,170,0,0,0,170,131,0,0,0,131
2020,52022,Poggibonsi,SI,17,141,0,0,0,141,135,0,0,0,135
2020,52022,Poggibonsi,SI,18,144,0,0,0,144,120,0,0,0,120
2020,52022,Poggibonsi,SI,19,140,0,0,0,140,134,0,0,0,134
2020,52022,Poggibonsi,SI,20,140,0,0,0,140,129,4,0,0,133
2020,52022,Poggibonsi,SI,21,150,0,0,0,150,115,2,0,0,117
2020,52022,Poggibonsi,SI,22,162,0,0,0,162,135,4,0,0,139
2020,52022,Poggibonsi,SI,23,151,0,0,0,151,130,6,0,0,136
2020,52022,Poggibonsi,SI,24,175,3,0,0,178,127,5,0,0,132
2020,52022,Poggibonsi,SI,25,126,4,0,0,130,110,11,1,0,122
2020,52022,Poggibonsi,SI,26,142,3,0,0,145,127,15,0,0,142
2020,52022,Poggibonsi,SI,27,141,10,0,0,151,119,20,0,0,139
2020,52022,Poggibonsi,SI,28,130,10,0,0,140,109,34,0,0,143
2020,52022,Poggibonsi,SI,29,123,20,1,0,144,98,40,0,0,138
2020,52022,Poggibonsi,SI,30,130,24,0,0,154,96,50,0,0,146
2020,52022,Poggibonsi,SI,31,102,41,0,0,143,84,48,4,0,136
2020,52022,Poggibonsi,SI,32,101,49,2,0,152,82,58,2,0,142
2020,52022,Poggibonsi,SI,33,93,41,3,0,137,68,43,0,1,113
2020,52022,Poggibonsi,SI,34,114,50,3,0,168,64,74,4,0,142
2020,52022,Poggibonsi,SI,35,95,50,1,0,146,66,80,1,0,148
2020,52022,Poggibonsi,SI,36,76,58,2,0,136,54,96,7,1,158
2020,52022,Poggibonsi,SI,37,88,81,1,0,170,70,99,2,0,171
2020,52022,Poggibonsi,SI,38,100,74,1,0,175,63,94,8,1,166
2020,52022,Poggibonsi,SI,39,91,78,2,1,172,81,101,8,0,190
2020,52022,Poggibonsi,SI,40,73,93,5,0,171,49,91,2,0,142
2020,52022,Poggibonsi,SI,41,53,81,5,0,139,43,108,9,0,160
2020,52022,Poggibonsi,SI,42,80,94,3,0,178,64,116,8,0,189
2020,52022,Poggibonsi,SI,43,85,119,7,1,212,56,129,9,2,196
2020,52022,Poggibonsi,SI,44,74,106,10,0,190,42,163,12,3,220
2020,52022,Poggibonsi,SI,45,79,105,7,0,191,46,151,15,4,217
2020,52022,Poggibonsi,SI,46,70,139,8,0,217,54,141,14,4,213
2020,52022,Poggibonsi,SI,47,65,122,10,0,197,37,153,15,4,209
2020,52022,Poggibonsi,SI,48,67,145,8,0,220,49,159,23,2,233
2020,52022,Poggibonsi,SI,49,63,155,10,3,231,39,155,16,3,213
2020,52022,Poggibonsi,SI,50,71,159,13,2,245,35,179,24,6,244
2020,52022,Poggibonsi,SI,51,59,161,14,0,234,36,196,19,2,253
2020,52022,Poggibonsi,SI,52,46,190,15,2,253,37,179,17,7,240
2020,52022,Poggibonsi,SI,53,60,178,16,1,255,43,195,24,5,267
2020,52022,Poggibonsi,SI,54,51,209,9,1,270,29,184,20,8,241
2020,52022,Poggibonsi,SI,55,41,182,12,0,235,22,209,18,8,257
2020,52022,Poggibonsi,SI,56,37,199,19,1,256,26,198,25,14,263
2020,52022,Poggibonsi,SI,57,31,188,18,3,240,19,161,21,7,208
2020,52022,Poggibonsi,SI,58,24,167,14,1,206,16,176,17,12,221
2020,52022,Poggibonsi,SI,59,25,165,23,2,215,15,180,12,14,221
2020,52022,Poggibonsi,SI,60,27,158,16,2,203,15,163,21,8,207
2020,52022,Poggibonsi,SI,61,12,170,19,6,207,7,161,15,10,193
2020,52022,Poggibonsi,SI,62,22,154,14,0,190,14,155,19,12,200
2020,52022,Poggibonsi,SI,63,15,123,10,2,150,11,121,11,16,159
2020,52022,Poggibonsi,SI,64,11,143,6,5,165,13,123,5,27,168
2020,52022,Poggibonsi,SI,65,11,126,13,2,153,5,156,10,17,188
2020,52022,Poggibonsi,SI,66,15,132,10,2,159,7,132,10,20,169
2020,52022,Poggibonsi,SI,67,5,122,6,8,141,7,140,12,28,187
2020,52022,Poggibonsi,SI,68,5,109,6,3,123,4,113,9,24,150
2020,52022,Poggibonsi,SI,69,9,125,3,0,137,4,143,6,23,176
2020,52022,Poggibonsi,SI,70,10,129,12,6,157,5,119,8,36,168
2020,52022,Poggibonsi,SI,71,6,143,6,8,163,10,141,8,46,205
2020,52022,Poggibonsi,SI,72,4,118,6,7,135,8,125,3,51,187
2020,52022,Poggibonsi,SI,73,13,160,6,11,190,7,140,8,45,200
2020,52022,Poggibonsi,SI,74,5,134,3,8,150,5,136,4,40,185
2020,52022,Poggibonsi,SI,75,3,93,3,6,105,1,102,2,35,140
2020,52022,Poggibonsi,SI,76,4,94,3,10,111,2,79,3,46,130
2020,52022,Poggibonsi,SI,77,6,112,1,9,128,5,82,4,51,142
2020,52022,Poggibonsi,SI,78,8,89,1,16,115,4,75,3,46,128
2020,52022,Poggibonsi,SI,79,4,95,2,13,114,2,84,2,80,168
2020,52022,Poggibonsi,SI,80,11,111,2,21,145,3,83,7,89,182
2020,52022,Poggibonsi,SI,81,4,103,0,13,120,5,68,0,102,175
2020,52022,Poggibonsi,SI,82,11,85,3,18,117,3,69,3,88,163
2020,52022,Poggibonsi,SI,83,7,89,2,11,109,3,52,0,88,143
2020,52022,Poggibonsi,SI,84,6,71,1,19,97,2,31,1,78,112
2020,52022,Poggibonsi,SI,85,5,60,0,10,75,2,34,1,94,131
2020,52022,Poggibonsi,SI,86,7,50,0,20,77,2,30,1,75,108
2020,52022,Poggibonsi,SI,87,3,44,2,12,61,3,18,1,82,104
2020,52022,Poggibonsi,SI,88,4,31,0,21,56,3,16,1,74,94
2020,52022,Poggibonsi,SI,89,0,34,0,17,51,2,7,0,80,89
2020,52022,Poggibonsi,SI,90,2,22,1,12,37,3,8,0,77,88
2020,52022,Poggibonsi,SI,91,1,21,0,9,31,2,3,0,47,52
2020,52022,Poggibonsi,SI,92,2,12,0,12,26,2,2,0,44,48
2020,52022,Poggibonsi,SI,93,0,10,0,11,21,0,1,0,36,37
2020,52022,Poggibonsi,SI,94,1,9,0,7,17,0,1,0,40,41
2020,52022,Poggibonsi,SI,95,0,3,0,8,11,1,1,0,23,25
2020,52022,Poggibonsi,SI,96,1,2,0,7,10,1,0,0,14,15
2020,52022,Poggibonsi,SI,97,1,0,0,4,5,0,0,0,9,9
2020,52022,Poggibonsi,SI,98,0,0,0,2,2,0,1,0,13,14
2020,52022,Poggibonsi,SI,99,0,1,0,2,3,0,0,0,7,7
2020,52022,Poggibonsi,SI,100 e più,0,0,0,3,3,0,0,0,6,6
2020,52023,Radda in Chianti,SI,0,3,0,0,0,3,3,0,0,0,3
2020,52023,Radda in Chianti,SI,1,4,0,0,0,4,6,0,0,0,6
2020,52023,Radda in Chianti,SI,2,5,0,0,0,5,1,0,0,0,1
2020,52023,Radda in Chianti,SI,3,3,0,0,0,3,8,0,0,0,8
2020,52023,Radda in Chianti,SI,4,7,0,0,0,7,2,0,0,0,2
2020,52023,Radda in Chianti,SI,5,5,0,0,0,5,3,0,0,0,3
2020,52023,Radda in Chianti,SI,6,6,0,0,0,6,9,0,0,0,9
2020,52023,Radda in Chianti,SI,7,4,0,0,0,4,2,0,0,0,2
2020,52023,Radda in Chianti,SI,8,5,0,0,0,5,7,0,0,0,7
2020,52023,Radda in Chianti,SI,9,4,0,0,0,4,10,0,0,0,10
2020,52023,Radda in Chianti,SI,10,7,0,0,0,7,4,0,0,0,4
2020,52023,Radda in Chianti,SI,11,5,0,0,0,5,4,0,0,0,4
2020,52023,Radda in Chianti,SI,12,6,0,0,0,6,2,0,0,0,2
2020,52023,Radda in Chianti,SI,13,6,0,0,0,6,9,0,0,0,9
2020,52023,Radda in Chianti,SI,14,7,0,0,0,7,3,0,0,0,3
2020,52023,Radda in Chianti,SI,15,5,0,0,0,5,12,0,0,0,12
2020,52023,Radda in Chianti,SI,16,8,0,0,0,8,9,0,0,0,9
2020,52023,Radda in Chianti,SI,17,10,0,0,0,10,7,0,0,0,7
2020,52023,Radda in Chianti,SI,18,4,0,0,0,4,5,0,0,0,5
2020,52023,Radda in Chianti,SI,19,9,0,0,0,9,5,0,0,0,5
2020,52023,Radda in Chianti,SI,20,7,0,0,0,7,10,0,0,0,10
2020,52023,Radda in Chianti,SI,21,12,0,0,0,12,11,0,0,0,11
2020,52023,Radda in Chianti,SI,22,5,0,0,0,5,7,0,0,0,7
2020,52023,Radda in Chianti,SI,23,9,0,0,0,9,6,0,0,0,6
2020,52023,Radda in Chianti,SI,24,11,0,0,0,11,7,2,0,0,9
2020,52023,Radda in Chianti,SI,25,6,1,0,0,7,6,3,0,0,9
2020,52023,Radda in Chianti,SI,26,8,1,0,0,9,8,0,0,0,8
2020,52023,Radda in Chianti,SI,27,6,0,0,0,6,6,2,0,0,8
2020,52023,Radda in Chianti,SI,28,4,1,0,0,5,4,1,0,0,5
2020,52023,Radda in Chianti,SI,29,12,4,0,0,16,3,3,0,0,6
2020,52023,Radda in Chianti,SI,30,9,2,0,0,11,3,2,0,0,5
2020,52023,Radda in Chianti,SI,31,11,2,0,0,13,6,2,0,0,8
2020,52023,Radda in Chianti,SI,32,3,1,0,0,4,4,2,0,0,6
2020,52023,Radda in Chianti,SI,33,3,5,0,0,8,4,4,0,0,8
2020,52023,Radda in Chianti,SI,34,7,1,0,0,8,1,3,1,0,5
2020,52023,Radda in Chianti,SI,35,2,2,1,0,5,1,3,0,0,4
2020,52023,Radda in Chianti,SI,36,2,3,0,0,5,6,2,0,0,8
2020,52023,Radda in Chianti,SI,37,4,3,0,0,7,3,7,0,0,10
2020,52023,Radda in Chianti,SI,38,7,1,0,0,8,4,4,0,0,8
2020,52023,Radda in Chianti,SI,39,5,2,0,0,7,0,3,1,0,4
2020,52023,Radda in Chianti,SI,40,1,3,0,0,4,0,1,1,0,2
2020,52023,Radda in Chianti,SI,41,5,6,1,0,12,5,6,1,1,13
2020,52023,Radda in Chianti,SI,42,1,4,0,0,5,2,10,0,0,12
2020,52023,Radda in Chianti,SI,43,2,5,0,0,7,1,2,0,0,3
2020,52023,Radda in Chianti,SI,44,2,9,0,0,11,3,10,0,1,14
2020,52023,Radda in Chianti,SI,45,5,3,0,0,8,2,6,2,0,10
2020,52023,Radda in Chianti,SI,46,5,11,0,0,16,3,5,0,0,8
2020,52023,Radda in Chianti,SI,47,7,6,0,0,13,2,8,0,0,10
2020,52023,Radda in Chianti,SI,48,6,7,0,0,13,2,15,1,0,18
2020,52023,Radda in Chianti,SI,49,4,10,2,0,16,1,9,1,0,11
2020,52023,Radda in Chianti,SI,50,5,8,0,0,13,3,5,0,0,8
2020,52023,Radda in Chianti,SI,51,3,4,0,0,7,1,8,0,0,9
2020,52023,Radda in Chianti,SI,52,5,11,0,0,16,0,7,1,0,8
2020,52023,Radda in Chianti,SI,53,3,5,2,0,10,1,14,1,0,16
2020,52023,Radda in Chianti,SI,54,0,4,0,1,5,3,14,1,0,18
2020,52023,Radda in Chianti,SI,55,7,11,1,0,19,2,6,0,0,8
2020,52023,Radda in Chianti,SI,56,1,18,1,0,20,1,13,1,2,17
2020,52023,Radda in Chianti,SI,57,3,7,1,0,11,5,11,0,1,17
2020,52023,Radda in Chianti,SI,58,2,10,0,0,12,3,8,1,0,12
2020,52023,Radda in Chianti,SI,59,3,4,5,0,12,2,7,0,0,9
2020,52023,Radda in Chianti,SI,60,0,8,0,0,8,1,11,2,1,15
2020,52023,Radda in Chianti,SI,61,1,16,0,0,17,3,9,2,3,17
2020,52023,Radda in Chianti,SI,62,4,6,0,0,10,3,13,0,0,16
2020,52023,Radda in Chianti,SI,63,0,14,0,0,14,0,10,0,2,12
2020,52023,Radda in Chianti,SI,64,3,4,0,0,7,1,13,0,1,15
2020,52023,Radda in Chianti,SI,65,1,10,2,0,13,0,7,1,2,10
2020,52023,Radda in Chianti,SI,66,0,10,0,0,10,2,5,0,2,9
2020,52023,Radda in Chianti,SI,67,2,5,0,0,7,0,6,0,0,6
2020,52023,Radda in Chianti,SI,68,1,9,0,1,11,1,4,1,5,11
2020,52023,Radda in Chianti,SI,69,0,6,0,0,6,2,5,1,0,8
2020,52023,Radda in Chianti,SI,70,0,12,1,0,13,0,8,0,1,9
2020,52023,Radda in Chianti,SI,71,1,6,1,1,9,1,5,0,3,9
2020,52023,Radda in Chianti,SI,72,1,3,1,0,5,1,7,0,2,10
2020,52023,Radda in Chianti,SI,73,1,6,0,0,7,0,10,1,3,14
2020,52023,Radda in Chianti,SI,74,1,8,0,2,11,1,5,2,3,11
2020,52023,Radda in Chianti,SI,75,0,7,0,1,8,0,1,0,3,4
2020,52023,Radda in Chianti,SI,76,1,7,1,2,11,2,1,1,2,6
2020,52023,Radda in Chianti,SI,77,1,4,0,1,6,0,2,0,3,5
2020,52023,Radda in Chianti,SI,78,2,3,0,1,6,0,4,0,2,6
2020,52023,Radda in Chianti,SI,79,1,7,0,1,9,0,4,0,5,9
2020,52023,Radda in Chianti,SI,80,0,6,0,1,7,0,3,0,2,5
2020,52023,Radda in Chianti,SI,81,2,4,1,2,9,0,4,0,3,7
2020,52023,Radda in Chianti,SI,82,0,0,1,1,2,0,0,0,7,7
2020,52023,Radda in Chianti,SI,83,1,7,0,0,8,0,5,0,4,9
2020,52023,Radda in Chianti,SI,84,0,2,0,1,3,1,0,0,6,7
2020,52023,Radda in Chianti,SI,85,0,2,0,1,3,0,0,0,3,3
2020,52023,Radda in Chianti,SI,86,1,4,0,1,6,1,1,0,6,8
2020,52023,Radda in Chianti,SI,87,0,2,0,0,2,0,2,0,7,9
2020,52023,Radda in Chianti,SI,88,0,2,0,1,3,1,0,0,1,2
2020,52023,Radda in Chianti,SI,89,0,1,0,2,3,0,0,0,2,2
2020,52023,Radda in Chianti,SI,90,0,0,0,0,0,0,0,1,4,5
2020,52023,Radda in Chianti,SI,91,0,1,0,1,2,1,0,0,6,7
2020,52023,Radda in Chianti,SI,92,0,0,0,1,1,0,0,0,4,4
2020,52023,Radda in Chianti,SI,93,0,0,0,0,0,0,0,0,0,0
2020,52023,Radda in Chianti,SI,94,0,0,0,0,0,0,0,0,1,1
2020,52023,Radda in Chianti,SI,95,0,0,0,1,1,0,0,0,1,1
2020,52023,Radda in Chianti,SI,96,0,0,0,1,1,0,0,0,0,0
2020,52023,Radda in Chianti,SI,97,0,0,0,0,0,0,0,0,0,0
2020,52023,Radda in Chianti,SI,98,0,0,0,0,0,0,0,0,0,0
2020,52023,Radda in Chianti,SI,99,0,0,0,0,0,0,0,0,1,1
2020,52023,Radda in Chianti,SI,100 e più,0,0,0,0,0,0,0,0,1,1
2020,52024,Radicofani,SI,0,6,0,0,0,6,0,0,0,0,0
2020,52024,Radicofani,SI,1,1,0,0,0,1,2,0,0,0,2
2020,52024,Radicofani,SI,2,2,0,0,0,2,3,0,0,0,3
2020,52024,Radicofani,SI,3,5,0,0,0,5,5,0,0,0,5
2020,52024,Radicofani,SI,4,3,0,0,0,3,5,0,0,0,5
2020,52024,Radicofani,SI,5,5,0,0,0,5,2,0,0,0,2
2020,52024,Radicofani,SI,6,3,0,0,0,3,1,0,0,0,1
2020,52024,Radicofani,SI,7,2,0,0,0,2,8,0,0,0,8
2020,52024,Radicofani,SI,8,7,0,0,0,7,5,0,0,0,5
2020,52024,Radicofani,SI,9,3,0,0,0,3,8,0,0,0,8
2020,52024,Radicofani,SI,10,3,0,0,0,3,4,0,0,0,4
2020,52024,Radicofani,SI,11,4,0,0,0,4,3,0,0,0,3
2020,52024,Radicofani,SI,12,4,0,0,0,4,5,0,0,0,5
2020,52024,Radicofani,SI,13,3,0,0,0,3,4,0,0,0,4
2020,52024,Radicofani,SI,14,3,0,0,0,3,0,0,0,0,0
2020,52024,Radicofani,SI,15,3,0,0,0,3,1,0,0,0,1
2020,52024,Radicofani,SI,16,2,0,0,0,2,3,0,0,0,3
2020,52024,Radicofani,SI,17,2,0,0,0,2,3,0,0,0,3
2020,52024,Radicofani,SI,18,3,0,0,0,3,2,0,0,0,2
2020,52024,Radicofani,SI,19,2,0,0,0,2,5,0,0,0,5
2020,52024,Radicofani,SI,20,4,0,0,0,4,5,0,0,0,5
2020,52024,Radicofani,SI,21,7,0,0,0,7,3,0,0,0,3
2020,52024,Radicofani,SI,22,4,0,0,0,4,5,0,0,0,5
2020,52024,Radicofani,SI,23,6,0,0,0,6,4,0,0,0,4
2020,52024,Radicofani,SI,24,7,0,0,0,7,1,0,0,0,1
2020,52024,Radicofani,SI,25,5,0,0,0,5,0,0,0,0,0
2020,52024,Radicofani,SI,26,5,0,0,0,5,2,1,0,0,3
2020,52024,Radicofani,SI,27,8,0,0,0,8,6,0,0,0,6
2020,52024,Radicofani,SI,28,3,1,0,0,4,3,2,0,0,5
2020,52024,Radicofani,SI,29,1,0,0,0,1,4,1,0,0,5
2020,52024,Radicofani,SI,30,7,0,0,0,7,5,0,0,0,5
2020,52024,Radicofani,SI,31,5,1,0,0,6,7,2,0,0,9
2020,52024,Radicofani,SI,32,4,3,0,0,7,6,1,0,0,7
2020,52024,Radicofani,SI,33,8,0,0,0,8,1,3,0,0,4
2020,52024,Radicofani,SI,34,6,2,0,0,8,3,6,0,0,9
2020,52024,Radicofani,SI,35,6,0,0,0,6,6,2,0,0,8
2020,52024,Radicofani,SI,36,5,1,0,0,6,2,2,0,0,4
2020,52024,Radicofani,SI,37,5,1,0,0,6,3,1,0,0,4
2020,52024,Radicofani,SI,38,3,0,1,0,4,3,2,0,0,5
2020,52024,Radicofani,SI,39,2,1,0,0,3,3,0,0,0,3
2020,52024,Radicofani,SI,40,0,2,0,0,2,2,5,0,0,7
2020,52024,Radicofani,SI,41,3,3,0,0,6,5,4,1,0,10
2020,52024,Radicofani,SI,42,4,3,0,0,7,4,1,0,0,5
2020,52024,Radicofani,SI,43,3,3,0,0,6,2,2,0,0,4
2020,52024,Radicofani,SI,44,3,1,0,0,4,2,3,1,0,6
2020,52024,Radicofani,SI,45,6,4,0,0,10,0,5,0,0,5
2020,52024,Radicofani,SI,46,2,7,0,0,9,9,4,1,0,14
2020,52024,Radicofani,SI,47,6,3,0,0,9,1,3,0,0,4
2020,52024,Radicofani,SI,48,3,2,1,0,6,6,3,0,0,9
2020,52024,Radicofani,SI,49,4,4,1,0,9,4,1,0,0,5
2020,52024,Radicofani,SI,50,2,6,0,0,8,2,5,3,0,10
2020,52024,Radicofani,SI,51,1,3,1,0,5,1,9,3,0,13
2020,52024,Radicofani,SI,52,3,4,0,1,8,1,6,0,0,7
2020,52024,Radicofani,SI,53,3,5,1,0,9,2,9,0,0,11
2020,52024,Radicofani,SI,54,2,12,0,0,14,1,7,0,0,8
2020,52024,Radicofani,SI,55,1,9,0,0,10,2,6,0,0,8
2020,52024,Radicofani,SI,56,0,11,0,0,11,1,13,0,0,14
2020,52024,Radicofani,SI,57,4,6,0,0,10,0,5,0,0,5
2020,52024,Radicofani,SI,58,4,4,0,0,8,2,5,0,0,7
2020,52024,Radicofani,SI,59,2,7,0,0,9,1,8,1,0,10
2020,52024,Radicofani,SI,60,7,10,0,0,17,0,4,0,1,5
2020,52024,Radicofani,SI,61,1,6,0,0,7,0,7,0,0,7
2020,52024,Radicofani,SI,62,0,11,0,0,11,1,9,0,2,12
2020,52024,Radicofani,SI,63,0,6,1,0,7,0,7,0,0,7
2020,52024,Radicofani,SI,64,0,8,0,0,8,1,3,0,2,6
2020,52024,Radicofani,SI,65,1,9,0,0,10,1,10,0,1,12
2020,52024,Radicofani,SI,66,0,9,2,0,11,0,9,0,2,11
2020,52024,Radicofani,SI,67,1,9,0,0,10,0,4,0,1,5
2020,52024,Radicofani,SI,68,1,3,0,0,4,0,4,0,2,6
2020,52024,Radicofani,SI,69,2,10,0,0,12,1,4,0,0,5
2020,52024,Radicofani,SI,70,3,9,1,0,13,0,7,0,0,7
2020,52024,Radicofani,SI,71,1,7,0,0,8,0,4,0,3,7
2020,52024,Radicofani,SI,72,0,6,0,0,6,0,5,1,0,6
2020,52024,Radicofani,SI,73,0,2,0,0,2,0,5,0,4,9
2020,52024,Radicofani,SI,74,0,7,0,1,8,0,2,0,4,6
2020,52024,Radicofani,SI,75,1,5,0,0,6,0,3,0,3,6
2020,52024,Radicofani,SI,76,2,4,0,0,6,0,4,0,3,7
2020,52024,Radicofani,SI,77,1,1,0,2,4,0,1,0,3,4
2020,52024,Radicofani,SI,78,0,2,0,1,3,0,3,0,5,8
2020,52024,Radicofani,SI,79,0,4,0,2,6,0,1,0,1,2
2020,52024,Radicofani,SI,80,0,6,0,1,7,0,1,0,7,8
2020,52024,Radicofani,SI,81,0,2,0,0,2,0,3,0,6,9
2020,52024,Radicofani,SI,82,0,2,0,0,2,0,2,0,7,9
2020,52024,Radicofani,SI,83,0,2,0,1,3,0,2,0,4,6
2020,52024,Radicofani,SI,84,0,2,0,1,3,0,3,2,4,9
2020,52024,Radicofani,SI,85,0,2,0,0,2,0,0,0,4,4
2020,52024,Radicofani,SI,86,0,5,0,1,6,0,0,0,3,3
2020,52024,Radicofani,SI,87,1,0,0,1,2,0,0,0,6,6
2020,52024,Radicofani,SI,88,0,0,0,2,2,0,0,0,5,5
2020,52024,Radicofani,SI,89,0,1,0,0,1,0,0,0,7,7
2020,52024,Radicofani,SI,90,0,0,0,0,0,0,1,0,2,3
2020,52024,Radicofani,SI,91,0,1,0,0,1,0,0,0,3,3
2020,52024,Radicofani,SI,92,0,0,0,0,0,0,0,0,1,1
2020,52024,Radicofani,SI,93,0,0,0,0,0,0,0,0,2,2
2020,52024,Radicofani,SI,94,0,0,0,0,0,0,0,0,1,1
2020,52024,Radicofani,SI,95,0,0,0,0,0,1,0,0,0,1
2020,52024,Radicofani,SI,96,0,0,0,0,0,0,0,0,0,0
2020,52024,Radicofani,SI,97,0,1,0,0,1,0,0,0,0,0
2020,52024,Radicofani,SI,98,0,0,0,0,0,0,0,0,0,0
2020,52024,Radicofani,SI,99,0,0,0,0,0,0,0,0,1,1
2020,52024,Radicofani,SI,100 e più,0,0,0,0,0,0,0,0,0,0
2020,52025,Radicondoli,SI,0,2,0,0,0,2,0,0,0,0,0
2020,52025,Radicondoli,SI,1,2,0,0,0,2,3,0,0,0,3
2020,52025,Radicondoli,SI,2,4,0,0,0,4,2,0,0,0,2
2020,52025,Radicondoli,SI,3,1,0,0,0,1,3,0,0,0,3
2020,52025,Radicondoli,SI,4,2,0,0,0,2,5,0,0,0,5
2020,52025,Radicondoli,SI,5,4,0,0,0,4,2,0,0,0,2
2020,52025,Radicondoli,SI,6,5,0,0,0,5,2,0,0,0,2
2020,52025,Radicondoli,SI,7,1,0,0,0,1,4,0,0,0,4
2020,52025,Radicondoli,SI,8,2,0,0,0,2,5,0,0,0,5
2020,52025,Radicondoli,SI,9,5,0,0,0,5,1,0,0,0,1
2020,52025,Radicondoli,SI,10,3,0,0,0,3,5,0,0,0,5
2020,52025,Radicondoli,SI,11,2,0,0,0,2,1,0,0,0,1
2020,52025,Radicondoli,SI,12,5,0,0,0,5,1,0,0,0,1
2020,52025,Radicondoli,SI,13,3,0,0,0,3,4,0,0,0,4
2020,52025,Radicondoli,SI,14,3,0,0,0,3,3,0,0,0,3
2020,52025,Radicondoli,SI,15,4,0,0,0,4,1,0,0,0,1
2020,52025,Radicondoli,SI,16,4,0,0,0,4,2,0,0,0,2
2020,52025,Radicondoli,SI,17,2,0,0,0,2,7,0,0,0,7
2020,52025,Radicondoli,SI,18,2,0,0,0,2,2,0,0,0,2
2020,52025,Radicondoli,SI,19,5,0,0,0,5,2,0,0,0,2
2020,52025,Radicondoli,SI,20,6,0,0,0,6,2,0,0,0,2
2020,52025,Radicondoli,SI,21,4,0,0,0,4,4,0,0,0,4
2020,52025,Radicondoli,SI,22,7,0,0,0,7,3,0,0,0,3
2020,52025,Radicondoli,SI,23,6,1,0,0,7,4,0,0,0,4
2020,52025,Radicondoli,SI,24,13,0,0,0,13,3,0,0,0,3
2020,52025,Radicondoli,SI,25,9,0,0,0,9,4,1,0,0,5
2020,52025,Radicondoli,SI,26,8,0,0,0,8,3,1,0,0,4
2020,52025,Radicondoli,SI,27,5,1,0,0,6,4,0,0,0,4
2020,52025,Radicondoli,SI,28,5,0,0,0,5,1,0,0,0,1
2020,52025,Radicondoli,SI,29,10,0,0,0,10,3,0,0,0,3
2020,52025,Radicondoli,SI,30,6,0,0,0,6,3,1,0,0,4
2020,52025,Radicondoli,SI,31,5,1,0,0,6,3,1,0,0,4
2020,52025,Radicondoli,SI,32,3,0,0,0,3,2,1,0,0,3
2020,52025,Radicondoli,SI,33,2,0,0,0,2,2,0,0,0,2
2020,52025,Radicondoli,SI,34,5,2,0,0,7,3,1,0,0,4
2020,52025,Radicondoli,SI,35,4,0,0,0,4,2,0,1,0,3
2020,52025,Radicondoli,SI,36,1,0,0,0,1,3,0,0,0,3
2020,52025,Radicondoli,SI,37,4,0,1,0,5,3,3,0,0,6
2020,52025,Radicondoli,SI,38,2,4,0,0,6,2,3,0,0,5
2020,52025,Radicondoli,SI,39,3,1,0,0,4,2,1,0,0,3
2020,52025,Radicondoli,SI,40,3,0,0,0,3,2,0,0,0,2
2020,52025,Radicondoli,SI,41,3,3,1,0,7,1,5,0,0,6
2020,52025,Radicondoli,SI,42,3,1,0,0,4,2,3,0,0,5
2020,52025,Radicondoli,SI,43,4,2,0,0,6,4,6,0,0,10
2020,52025,Radicondoli,SI,44,0,5,0,0,5,3,3,0,0,6
2020,52025,Radicondoli,SI,45,4,5,1,0,10,2,6,0,0,8
2020,52025,Radicondoli,SI,46,4,5,0,0,9,4,6,0,0,10
2020,52025,Radicondoli,SI,47,1,0,0,0,1,2,4,0,0,6
2020,52025,Radicondoli,SI,48,1,2,0,0,3,3,7,1,0,11
2020,52025,Radicondoli,SI,49,5,1,0,0,6,0,3,1,0,4
2020,52025,Radicondoli,SI,50,2,4,1,0,7,1,5,0,0,6
2020,52025,Radicondoli,SI,51,2,5,1,0,8,2,5,2,1,10
2020,52025,Radicondoli,SI,52,2,5,0,0,7,1,4,2,1,8
2020,52025,Radicondoli,SI,53,0,10,0,0,10,0,6,0,0,6
2020,52025,Radicondoli,SI,54,1,5,2,0,8,0,9,0,0,9
2020,52025,Radicondoli,SI,55,0,8,1,0,9,1,2,0,0,3
2020,52025,Radicondoli,SI,56,3,8,0,0,11,3,2,1,0,6
2020,52025,Radicondoli,SI,57,3,6,1,0,10,2,9,1,0,12
2020,52025,Radicondoli,SI,58,4,7,1,0,12,0,8,1,0,9
2020,52025,Radicondoli,SI,59,1,3,0,0,4,0,6,1,0,7
2020,52025,Radicondoli,SI,60,1,4,1,0,6,0,4,1,0,5
2020,52025,Radicondoli,SI,61,0,7,0,0,7,1,9,0,2,12
2020,52025,Radicondoli,SI,62,2,3,0,0,5,0,2,1,0,3
2020,52025,Radicondoli,SI,63,1,7,0,0,8,1,10,0,0,11
2020,52025,Radicondoli,SI,64,0,8,0,0,8,1,8,2,1,12
2020,52025,Radicondoli,SI,65,0,4,0,1,5,2,1,2,1,6
2020,52025,Radicondoli,SI,66,1,4,0,0,5,1,1,0,0,2
2020,52025,Radicondoli,SI,67,2,5,2,0,9,0,6,0,2,8
2020,52025,Radicondoli,SI,68,0,5,0,0,5,1,3,0,2,6
2020,52025,Radicondoli,SI,69,0,7,1,1,9,0,1,1,1,3
2020,52025,Radicondoli,SI,70,1,5,1,0,7,0,8,1,0,9
2020,52025,Radicondoli,SI,71,1,6,0,0,7,0,4,0,0,4
2020,52025,Radicondoli,SI,72,2,1,0,0,3,0,3,0,0,3
2020,52025,Radicondoli,SI,73,0,4,0,0,4,0,2,0,1,3
2020,52025,Radicondoli,SI,74,1,7,0,1,9,2,4,0,2,8
2020,52025,Radicondoli,SI,75,1,2,0,0,3,0,6,0,1,7
2020,52025,Radicondoli,SI,76,1,4,1,0,6,0,4,0,1,5
2020,52025,Radicondoli,SI,77,0,0,0,0,0,0,4,0,1,5
2020,52025,Radicondoli,SI,78,1,4,0,0,5,0,2,0,0,2
2020,52025,Radicondoli,SI,79,0,3,0,0,3,0,7,0,2,9
2020,52025,Radicondoli,SI,80,0,3,0,0,3,2,1,0,1,4
2020,52025,Radicondoli,SI,81,0,5,0,0,5,0,4,0,2,6
2020,52025,Radicondoli,SI,82,0,4,0,0,4,0,2,2,0,4
2020,52025,Radicondoli,SI,83,0,8,0,1,9,0,1,0,1,2
2020,52025,Radicondoli,SI,84,0,2,0,1,3,0,0,0,5,5
2020,52025,Radicondoli,SI,85,2,3,0,0,5,0,0,0,5,5
2020,52025,Radicondoli,SI,86,0,1,0,1,2,0,2,0,1,3
2020,52025,Radicondoli,SI,87,2,1,0,1,4,0,0,0,3,3
2020,52025,Radicondoli,SI,88,0,0,0,0,0,0,0,0,3,3
2020,52025,Radicondoli,SI,89,0,3,0,0,3,1,0,0,4,5
2020,52025,Radicondoli,SI,90,0,1,0,0,1,0,0,0,2,2
2020,52025,Radicondoli,SI,91,0,0,0,0,0,0,0,0,1,1
2020,52025,Radicondoli,SI,92,0,0,0,1,1,0,1,0,1,2
2020,52025,Radicondoli,SI,93,0,0,0,0,0,0,0,0,0,0
2020,52025,Radicondoli,SI,94,0,0,0,1,1,1,0,0,2,3
2020,52025,Radicondoli,SI,95,0,0,0,1,1,0,0,0,0,0
2020,52025,Radicondoli,SI,96,0,0,0,0,0,0,0,0,0,0
2020,52025,Radicondoli,SI,97,0,0,0,0,0,0,0,0,1,1
2020,52025,Radicondoli,SI,98,0,0,0,0,0,0,0,0,0,0
2020,52025,Radicondoli,SI,99,0,0,0,0,0,0,0,0,1,1
2020,52025,Radicondoli,SI,100 e più,0,0,0,0,0,0,0,0,1,1
2020,52026,Rapolano Terme,SI,0,15,0,0,0,15,11,0,0,0,11
2020,52026,Rapolano Terme,SI,1,20,0,0,0,20,16,0,0,0,16
2020,52026,Rapolano Terme,SI,2,16,0,0,0,16,25,0,0,0,25
2020,52026,Rapolano Terme,SI,3,18,0,0,0,18,19,0,0,0,19
2020,52026,Rapolano Terme,SI,4,25,0,0,0,25,22,0,0,0,22
2020,52026,Rapolano Terme,SI,5,17,0,0,0,17,16,0,0,0,16
2020,52026,Rapolano Terme,SI,6,30,0,0,0,30,22,0,0,0,22
2020,52026,Rapolano Terme,SI,7,27,0,0,0,27,26,0,0,0,26
2020,52026,Rapolano Terme,SI,8,25,0,0,0,25,17,0,0,0,17
2020,52026,Rapolano Terme,SI,9,27,0,0,0,27,25,0,0,0,25
2020,52026,Rapolano Terme,SI,10,20,0,0,0,20,31,0,0,0,31
2020,52026,Rapolano Terme,SI,11,27,0,0,0,27,19,0,0,0,19
2020,52026,Rapolano Terme,SI,12,22,0,0,0,22,20,0,0,0,20
2020,52026,Rapolano Terme,SI,13,19,0,0,0,19,23,0,0,0,23
2020,52026,Rapolano Terme,SI,14,29,0,0,0,29,18,0,0,0,18
2020,52026,Rapolano Terme,SI,15,22,0,0,0,22,20,0,0,0,20
2020,52026,Rapolano Terme,SI,16,24,0,0,0,24,19,0,0,0,19
2020,52026,Rapolano Terme,SI,17,18,0,0,0,18,14,0,0,0,14
2020,52026,Rapolano Terme,SI,18,23,0,0,0,23,15,0,0,0,15
2020,52026,Rapolano Terme,SI,19,16,0,0,0,16,21,1,0,0,22
2020,52026,Rapolano Terme,SI,20,25,0,0,0,25,18,1,0,0,19
2020,52026,Rapolano Terme,SI,21,21,1,0,0,22,23,1,0,0,24
2020,52026,Rapolano Terme,SI,22,32,0,0,0,32,19,2,0,0,21
2020,52026,Rapolano Terme,SI,23,23,0,0,0,23,18,1,0,0,19
2020,52026,Rapolano Terme,SI,24,26,1,0,0,27,23,2,0,0,25
2020,52026,Rapolano Terme,SI,25,21,0,0,0,21,18,5,0,0,23
2020,52026,Rapolano Terme,SI,26,30,2,0,0,32,17,2,0,0,19
2020,52026,Rapolano Terme,SI,27,20,1,0,0,21,22,5,0,0,27
2020,52026,Rapolano Terme,SI,28,21,1,0,0,22,18,6,0,0,24
2020,52026,Rapolano Terme,SI,29,17,4,0,0,21,8,9,0,0,17
2020,52026,Rapolano Terme,SI,30,31,4,0,0,35,11,8,0,0,19
2020,52026,Rapolano Terme,SI,31,12,7,0,0,19,12,13,0,0,25
2020,52026,Rapolano Terme,SI,32,24,7,0,0,31,17,16,1,0,34
2020,52026,Rapolano Terme,SI,33,19,6,0,0,25,5,7,0,0,12
2020,52026,Rapolano Terme,SI,34,6,11,0,0,17,14,16,0,0,30
2020,52026,Rapolano Terme,SI,35,21,10,2,0,33,13,12,1,0,26
2020,52026,Rapolano Terme,SI,36,16,19,0,0,35,10,24,1,0,35
2020,52026,Rapolano Terme,SI,37,11,16,0,0,27,18,22,0,0,40
2020,52026,Rapolano Terme,SI,38,20,17,0,0,37,11,23,1,1,36
2020,52026,Rapolano Terme,SI,39,9,18,1,0,28,12,25,1,0,38
2020,52026,Rapolano Terme,SI,40,17,21,0,0,38,7,19,1,0,27
2020,52026,Rapolano Terme,SI,41,12,17,0,0,29,10,19,2,0,31
2020,52026,Rapolano Terme,SI,42,14,18,0,0,32,12,23,3,0,38
2020,52026,Rapolano Terme,SI,43,8,22,1,0,31,7,18,2,0,27
2020,52026,Rapolano Terme,SI,44,11,28,0,0,39,13,21,2,0,36
2020,52026,Rapolano Terme,SI,45,7,22,0,0,29,9,19,2,1,31
2020,52026,Rapolano Terme,SI,46,18,16,1,0,35,10,29,7,0,46
2020,52026,Rapolano Terme,SI,47,16,20,3,0,39,8,31,1,1,41
2020,52026,Rapolano Terme,SI,48,12,16,2,0,30,7,43,2,1,53
2020,52026,Rapolano Terme,SI,49,7,33,1,0,41,5,35,1,0,41
2020,52026,Rapolano Terme,SI,50,10,32,4,0,46,8,31,2,1,42
2020,52026,Rapolano Terme,SI,51,11,25,2,0,38,3,25,6,1,35
2020,52026,Rapolano Terme,SI,52,15,32,4,1,52,7,33,0,0,40
2020,52026,Rapolano Terme,SI,53,6,35,2,0,43,5,28,3,0,36
2020,52026,Rapolano Terme,SI,54,7,35,1,0,43,5,27,2,1,35
2020,52026,Rapolano Terme,SI,55,10,20,4,0,34,7,41,4,2,54
2020,52026,Rapolano Terme,SI,56,14,24,3,1,42,6,44,5,1,56
2020,52026,Rapolano Terme,SI,57,3,35,3,1,42,2,40,5,4,51
2020,52026,Rapolano Terme,SI,58,2,40,2,0,44,3,31,1,2,37
2020,52026,Rapolano Terme,SI,59,5,31,4,0,40,2,33,1,4,40
2020,52026,Rapolano Terme,SI,60,4,33,0,1,38,3,19,3,3,28
2020,52026,Rapolano Terme,SI,61,5,40,1,1,47,1,33,3,5,42
2020,52026,Rapolano Terme,SI,62,4,26,0,0,30,0,29,4,3,36
2020,52026,Rapolano Terme,SI,63,1,22,1,2,26,2,25,1,2,30
2020,52026,Rapolano Terme,SI,64,3,31,1,0,35,1,25,1,3,30
2020,52026,Rapolano Terme,SI,65,4,24,1,0,29,2,40,1,1,44
2020,52026,Rapolano Terme,SI,66,2,22,3,2,29,2,26,2,4,34
2020,52026,Rapolano Terme,SI,67,0,22,0,0,22,2,24,1,5,32
2020,52026,Rapolano Terme,SI,68,1,27,1,1,30,1,13,0,6,20
2020,52026,Rapolano Terme,SI,69,5,33,1,1,40,0,30,3,4,37
2020,52026,Rapolano Terme,SI,70,2,28,0,2,32,0,18,1,5,24
2020,52026,Rapolano Terme,SI,71,4,22,1,2,29,1,25,0,7,33
2020,52026,Rapolano Terme,SI,72,2,20,0,3,25,1,36,0,12,49
2020,52026,Rapolano Terme,SI,73,2,33,0,3,38,1,25,0,8,34
2020,52026,Rapolano Terme,SI,74,2,26,0,0,28,2,17,1,9,29
2020,52026,Rapolano Terme,SI,75,2,10,0,1,13,1,14,0,6,21
2020,52026,Rapolano Terme,SI,76,1,27,0,2,30,0,20,0,6,26
2020,52026,Rapolano Terme,SI,77,0,21,1,1,23,2,11,0,13,26
2020,52026,Rapolano Terme,SI,78,0,18,1,2,21,1,10,0,14,25
2020,52026,Rapolano Terme,SI,79,1,11,0,1,13,1,11,0,15,27
2020,52026,Rapolano Terme,SI,80,0,25,1,1,27,1,16,0,20,37
2020,52026,Rapolano Terme,SI,81,3,9,1,3,16,0,18,0,19,37
2020,52026,Rapolano Terme,SI,82,2,25,0,3,30,0,8,0,22,30
2020,52026,Rapolano Terme,SI,83,3,12,0,1,16,1,12,0,11,24
2020,52026,Rapolano Terme,SI,84,0,7,0,6,13,1,2,0,17,20
2020,52026,Rapolano Terme,SI,85,1,12,0,3,16,0,4,0,17,21
2020,52026,Rapolano Terme,SI,86,2,12,0,2,16,0,5,1,23,29
2020,52026,Rapolano Terme,SI,87,1,10,0,6,17,2,2,0,27,31
2020,52026,Rapolano Terme,SI,88,3,2,0,2,7,0,2,0,6,8
2020,52026,Rapolano Terme,SI,89,1,5,0,3,9,0,4,0,12,16
2020,52026,Rapolano Terme,SI,90,1,5,0,3,9,1,2,0,6,9
2020,52026,Rapolano Terme,SI,91,0,0,0,3,3,0,2,0,7,9
2020,52026,Rapolano Terme,SI,92,0,4,0,3,7,0,1,0,13,14
2020,52026,Rapolano Terme,SI,93,0,1,0,1,2,0,0,0,7,7
2020,52026,Rapolano Terme,SI,94,0,3,0,1,4,0,0,0,8,8
2020,52026,Rapolano Terme,SI,95,0,1,0,1,2,0,0,0,7,7
2020,52026,Rapolano Terme,SI,96,0,1,0,1,2,0,0,0,5,5
2020,52026,Rapolano Terme,SI,97,0,0,0,1,1,0,0,0,5,5
2020,52026,Rapolano Terme,SI,98,0,0,0,1,1,0,0,0,1,1
2020,52026,Rapolano Terme,SI,99,0,0,0,0,0,0,0,0,1,1
2020,52026,Rapolano Terme,SI,100 e più,0,0,0,0,0,0,0,0,2,2
2020,52027,San Casciano dei Bagni,SI,0,5,0,0,0,5,3,0,0,0,3
2020,52027,San Casciano dei Bagni,SI,1,4,0,0,0,4,5,0,0,0,5
2020,52027,San Casciano dei Bagni,SI,2,3,0,0,0,3,4,0,0,0,4
2020,52027,San Casciano dei Bagni,SI,3,4,0,0,0,4,2,0,0,0,2
2020,52027,San Casciano dei Bagni,SI,4,6,0,0,0,6,4,0,0,0,4
2020,52027,San Casciano dei Bagni,SI,5,9,0,0,0,9,6,0,0,0,6
2020,52027,San Casciano dei Bagni,SI,6,5,0,0,0,5,3,0,0,0,3
2020,52027,San Casciano dei Bagni,SI,7,4,0,0,0,4,2,0,0,0,2
2020,52027,San Casciano dei Bagni,SI,8,3,0,0,0,3,2,0,0,0,2
2020,52027,San Casciano dei Bagni,SI,9,5,0,0,0,5,5,0,0,0,5
2020,52027,San Casciano dei Bagni,SI,10,7,0,0,0,7,6,0,0,0,6
2020,52027,San Casciano dei Bagni,SI,11,7,0,0,0,7,8,0,0,0,8
2020,52027,San Casciano dei Bagni,SI,12,4,0,0,0,4,4,0,0,0,4
2020,52027,San Casciano dei Bagni,SI,13,5,0,0,0,5,3,0,0,0,3
2020,52027,San Casciano dei Bagni,SI,14,9,0,0,0,9,3,0,0,0,3
2020,52027,San Casciano dei Bagni,SI,15,5,0,0,0,5,2,0,0,0,2
2020,52027,San Casciano dei Bagni,SI,16,13,0,0,0,13,2,0,0,0,2
2020,52027,San Casciano dei Bagni,SI,17,3,0,0,0,3,4,0,0,0,4
2020,52027,San Casciano dei Bagni,SI,18,1,0,0,0,1,3,0,0,0,3
2020,52027,San Casciano dei Bagni,SI,19,9,0,0,0,9,7,0,0,0,7
2020,52027,San Casciano dei Bagni,SI,20,5,0,0,0,5,6,0,0,0,6
2020,52027,San Casciano dei Bagni,SI,21,4,0,0,0,4,1,0,0,0,1
2020,52027,San Casciano dei Bagni,SI,22,6,0,0,0,6,9,0,0,0,9
2020,52027,San Casciano dei Bagni,SI,23,4,0,0,0,4,5,0,0,0,5
2020,52027,San Casciano dei Bagni,SI,24,1,0,0,0,1,7,0,0,0,7
2020,52027,San Casciano dei Bagni,SI,25,5,0,0,0,5,5,2,0,0,7
2020,52027,San Casciano dei Bagni,SI,26,7,1,0,0,8,3,0,0,0,3
2020,52027,San Casciano dei Bagni,SI,27,8,0,0,0,8,6,1,0,0,7
2020,52027,San Casciano dei Bagni,SI,28,5,0,0,0,5,2,2,0,0,4
2020,52027,San Casciano dei Bagni,SI,29,5,0,0,0,5,10,1,0,0,11
2020,52027,San Casciano dei Bagni,SI,30,5,1,0,0,6,10,1,0,0,11
2020,52027,San Casciano dei Bagni,SI,31,9,2,0,0,11,9,2,0,0,11
2020,52027,San Casciano dei Bagni,SI,32,8,1,0,0,9,4,1,0,0,5
2020,52027,San Casciano dei Bagni,SI,33,3,0,0,0,3,11,1,0,0,12
2020,52027,San Casciano dei Bagni,SI,34,7,1,0,0,8,5,1,0,0,6
2020,52027,San Casciano dei Bagni,SI,35,5,0,0,0,5,4,1,0,1,6
2020,52027,San Casciano dei Bagni,SI,36,5,2,0,0,7,2,1,0,0,3
2020,52027,San Casciano dei Bagni,SI,37,7,2,0,0,9,4,2,0,0,6
2020,52027,San Casciano dei Bagni,SI,38,7,2,0,0,9,2,3,0,0,5
2020,52027,San Casciano dei Bagni,SI,39,6,3,0,0,9,5,6,1,0,12
2020,52027,San Casciano dei Bagni,SI,40,4,1,0,0,5,2,7,0,0,9
2020,52027,San Casciano dei Bagni,SI,41,3,5,0,0,8,4,4,2,0,10
2020,52027,San Casciano dei Bagni,SI,42,2,3,1,0,6,5,6,0,0,11
2020,52027,San Casciano dei Bagni,SI,43,3,1,0,0,4,4,8,1,0,13
2020,52027,San Casciano dei Bagni,SI,44,3,4,1,0,8,4,6,0,0,10
2020,52027,San Casciano dei Bagni,SI,45,4,2,0,0,6,3,3,0,0,6
2020,52027,San Casciano dei Bagni,SI,46,7,7,0,0,14,2,7,1,0,10
2020,52027,San Casciano dei Bagni,SI,47,3,3,0,0,6,0,4,1,0,5
2020,52027,San Casciano dei Bagni,SI,48,4,9,1,0,14,6,7,1,1,15
2020,52027,San Casciano dei Bagni,SI,49,8,6,0,0,14,3,10,2,0,15
2020,52027,San Casciano dei Bagni,SI,50,5,1,0,0,6,1,7,0,0,8
2020,52027,San Casciano dei Bagni,SI,51,4,7,2,0,13,2,12,0,0,14
2020,52027,San Casciano dei Bagni,SI,52,1,8,0,0,9,1,4,1,0,6
2020,52027,San Casciano dei Bagni,SI,53,1,9,1,0,11,3,10,3,1,17
2020,52027,San Casciano dei Bagni,SI,54,3,6,1,1,11,1,8,2,0,11
2020,52027,San Casciano dei Bagni,SI,55,4,10,1,0,15,3,7,0,0,10
2020,52027,San Casciano dei Bagni,SI,56,1,12,0,0,13,5,7,0,1,13
2020,52027,San Casciano dei Bagni,SI,57,5,15,1,0,21,2,6,0,1,9
2020,52027,San Casciano dei Bagni,SI,58,4,5,0,0,9,1,12,0,1,14
2020,52027,San Casciano dei Bagni,SI,59,2,7,1,0,10,3,5,0,0,8
2020,52027,San Casciano dei Bagni,SI,60,1,11,1,0,13,3,10,0,0,13
2020,52027,San Casciano dei Bagni,SI,61,2,13,1,0,16,1,14,0,1,16
2020,52027,San Casciano dei Bagni,SI,62,4,11,0,1,16,1,10,0,2,13
2020,52027,San Casciano dei Bagni,SI,63,1,12,0,1,14,2,11,2,0,15
2020,52027,San Casciano dei Bagni,SI,64,1,11,0,1,13,1,10,0,2,13
2020,52027,San Casciano dei Bagni,SI,65,1,8,2,0,11,2,16,1,2,21
2020,52027,San Casciano dei Bagni,SI,66,1,14,0,0,15,1,10,1,2,14
2020,52027,San Casciano dei Bagni,SI,67,1,6,0,0,7,0,10,2,0,12
2020,52027,San Casciano dei Bagni,SI,68,1,10,0,0,11,1,4,0,1,6
2020,52027,San Casciano dei Bagni,SI,69,3,11,0,0,14,1,7,0,1,9
2020,52027,San Casciano dei Bagni,SI,70,1,16,0,1,18,3,3,0,2,8
2020,52027,San Casciano dei Bagni,SI,71,2,9,0,1,12,1,5,0,0,6
2020,52027,San Casciano dei Bagni,SI,72,1,13,0,0,14,1,10,0,1,12
2020,52027,San Casciano dei Bagni,SI,73,4,10,1,1,16,0,12,0,4,16
2020,52027,San Casciano dei Bagni,SI,74,3,9,0,1,13,0,5,1,2,8
2020,52027,San Casciano dei Bagni,SI,75,0,10,0,0,10,0,11,1,6,18
2020,52027,San Casciano dei Bagni,SI,76,3,5,1,0,9,3,7,0,4,14
2020,52027,San Casciano dei Bagni,SI,77,0,10,0,3,13,0,9,0,5,14
2020,52027,San Casciano dei Bagni,SI,78,1,2,0,1,4,0,3,0,2,5
2020,52027,San Casciano dei Bagni,SI,79,2,9,0,0,11,0,9,0,2,11
2020,52027,San Casciano dei Bagni,SI,80,0,7,0,2,9,1,4,0,4,9
2020,52027,San Casciano dei Bagni,SI,81,0,7,0,0,7,0,3,0,3,6
2020,52027,San Casciano dei Bagni,SI,82,1,6,0,0,7,2,5,0,5,12
2020,52027,San Casciano dei Bagni,SI,83,1,6,0,0,7,0,1,0,3,4
2020,52027,San Casciano dei Bagni,SI,84,0,3,0,3,6,0,2,0,5,7
2020,52027,San Casciano dei Bagni,SI,85,0,0,0,1,1,0,0,0,9,9
2020,52027,San Casciano dei Bagni,SI,86,1,5,0,0,6,0,4,0,7,11
2020,52027,San Casciano dei Bagni,SI,87,2,6,0,4,12,0,1,0,4,5
2020,52027,San Casciano dei Bagni,SI,88,0,2,0,2,4,0,1,0,8,9
2020,52027,San Casciano dei Bagni,SI,89,0,0,0,1,1,1,0,0,7,8
2020,52027,San Casciano dei Bagni,SI,90,0,2,0,0,2,0,0,0,5,5
2020,52027,San Casciano dei Bagni,SI,91,0,2,0,1,3,0,0,0,6,6
2020,52027,San Casciano dei Bagni,SI,92,0,0,0,0,0,0,0,1,5,6
2020,52027,San Casciano dei Bagni,SI,93,0,1,0,1,2,0,0,0,3,3
2020,52027,San Casciano dei Bagni,SI,94,0,0,0,0,0,0,2,0,5,7
2020,52027,San Casciano dei Bagni,SI,95,0,0,0,0,0,0,0,0,3,3
2020,52027,San Casciano dei Bagni,SI,96,0,0,0,1,1,0,0,0,0,0
2020,52027,San Casciano dei Bagni,SI,97,0,2,0,0,2,0,0,0,1,1
2020,52027,San Casciano dei Bagni,SI,98,0,0,0,0,0,0,0,0,1,1
2020,52027,San Casciano dei Bagni,SI,99,0,0,0,0,0,0,0,0,0,0
2020,52027,San Casciano dei Bagni,SI,100 e più,0,0,0,0,0,0,0,0,0,0
2020,52028,San Gimignano,SI,0,21,0,0,0,21,24,0,0,0,24
2020,52028,San Gimignano,SI,1,22,0,0,0,22,20,0,0,0,20
2020,52028,San Gimignano,SI,2,26,0,0,0,26,20,0,0,0,20
2020,52028,San Gimignano,SI,3,31,0,0,0,31,30,0,0,0,30
2020,52028,San Gimignano,SI,4,30,0,0,0,30,27,0,0,0,27
2020,52028,San Gimignano,SI,5,24,0,0,0,24,29,0,0,0,29
2020,52028,San Gimignano,SI,6,30,0,0,0,30,19,0,0,0,19
2020,52028,San Gimignano,SI,7,32,0,0,0,32,26,0,0,0,26
2020,52028,San Gimignano,SI,8,35,0,0,0,35,39,0,0,0,39
2020,52028,San Gimignano,SI,9,37,0,0,0,37,36,0,0,0,36
2020,52028,San Gimignano,SI,10,28,0,0,0,28,32,0,0,0,32
2020,52028,San Gimignano,SI,11,33,0,0,0,33,32,0,0,0,32
2020,52028,San Gimignano,SI,12,32,0,0,0,32,39,0,0,0,39
2020,52028,San Gimignano,SI,13,30,0,0,0,30,29,0,0,0,29
2020,52028,San Gimignano,SI,14,41,0,0,0,41,21,0,0,0,21
2020,52028,San Gimignano,SI,15,34,0,0,0,34,18,0,0,0,18
2020,52028,San Gimignano,SI,16,50,0,0,0,50,32,0,0,0,32
2020,52028,San Gimignano,SI,17,22,0,0,0,22,35,0,0,0,35
2020,52028,San Gimignano,SI,18,31,0,0,0,31,30,0,0,0,30
2020,52028,San Gimignano,SI,19,35,0,0,0,35,27,0,0,0,27
2020,52028,San Gimignano,SI,20,36,0,0,0,36,27,0,0,0,27
2020,52028,San Gimignano,SI,21,38,0,0,0,38,29,0,0,0,29
2020,52028,San Gimignano,SI,22,32,0,0,0,32,34,0,0,0,34
2020,52028,San Gimignano,SI,23,38,0,0,0,38,37,4,0,0,41
2020,52028,San Gimignano,SI,24,34,2,0,0,36,25,1,0,0,26
2020,52028,San Gimignano,SI,25,48,2,0,0,50,35,1,0,0,36
2020,52028,San Gimignano,SI,26,44,2,0,0,46,35,1,0,0,36
2020,52028,San Gimignano,SI,27,36,3,0,0,39,29,0,0,0,29
2020,52028,San Gimignano,SI,28,43,2,0,0,45,36,7,0,0,43
2020,52028,San Gimignano,SI,29,31,2,0,0,33,24,5,0,0,29
2020,52028,San Gimignano,SI,30,35,7,0,0,42,24,8,0,0,32
2020,52028,San Gimignano,SI,31,27,6,1,0,34,26,8,0,0,34
2020,52028,San Gimignano,SI,32,34,9,0,0,43,18,17,0,0,35
2020,52028,San Gimignano,SI,33,33,10,0,0,43,22,12,1,0,35
2020,52028,San Gimignano,SI,34,33,12,1,0,46,24,6,2,0,32
2020,52028,San Gimignano,SI,35,24,7,0,0,31,24,15,1,0,40
2020,52028,San Gimignano,SI,36,31,17,1,0,49,21,23,1,1,46
2020,52028,San Gimignano,SI,37,19,15,0,0,34,24,23,2,0,49
2020,52028,San Gimignano,SI,38,36,19,0,0,55,11,16,2,0,29
2020,52028,San Gimignano,SI,39,13,17,0,0,30,17,28,1,0,46
2020,52028,San Gimignano,SI,40,31,20,0,0,51,23,34,1,0,58
2020,52028,San Gimignano,SI,41,23,27,0,0,50,19,24,5,0,48
2020,52028,San Gimignano,SI,42,21,24,2,0,47,17,40,1,0,58
2020,52028,San Gimignano,SI,43,32,36,5,0,73,19,37,4,0,60
2020,52028,San Gimignano,SI,44,13,34,1,1,49,15,26,0,1,42
2020,52028,San Gimignano,SI,45,26,40,2,0,68,13,41,5,0,59
2020,52028,San Gimignano,SI,46,24,43,5,0,72,22,46,2,1,71
2020,52028,San Gimignano,SI,47,20,46,0,0,66,16,44,2,1,63
2020,52028,San Gimignano,SI,48,22,36,3,0,61,14,37,7,0,58
2020,52028,San Gimignano,SI,49,23,31,6,0,60,8,41,4,1,54
2020,52028,San Gimignano,SI,50,19,38,1,0,58,12,45,3,1,61
2020,52028,San Gimignano,SI,51,24,46,3,0,73,11,37,7,1,56
2020,52028,San Gimignano,SI,52,13,49,6,0,68,10,50,4,3,67
2020,52028,San Gimignano,SI,53,12,51,4,0,67,13,42,6,1,62
2020,52028,San Gimignano,SI,54,13,46,3,0,62,7,50,4,2,63
2020,52028,San Gimignano,SI,55,12,58,8,0,78,9,44,5,0,58
2020,52028,San Gimignano,SI,56,9,39,8,1,57,10,51,10,7,78
2020,52028,San Gimignano,SI,57,6,47,2,0,55,6,46,2,0,54
2020,52028,San Gimignano,SI,58,11,46,6,1,64,9,41,3,1,54
2020,52028,San Gimignano,SI,59,8,40,6,2,56,6,48,2,4,60
2020,52028,San Gimignano,SI,60,8,42,1,2,53,8,39,4,3,54
2020,52028,San Gimignano,SI,61,13,46,1,1,61,4,46,4,3,57
2020,52028,San Gimignano,SI,62,3,48,2,2,55,4,39,0,8,51
2020,52028,San Gimignano,SI,63,5,45,3,0,53,6,63,4,2,75
2020,52028,San Gimignano,SI,64,5,40,4,3,52,5,30,3,6,44
2020,52028,San Gimignano,SI,65,5,35,1,0,41,5,43,2,6,56
2020,52028,San Gimignano,SI,66,6,46,2,2,56,0,34,2,7,43
2020,52028,San Gimignano,SI,67,4,49,3,3,59,3,33,6,4,46
2020,52028,San Gimignano,SI,68,3,27,4,3,37,5,35,2,4,46
2020,52028,San Gimignano,SI,69,2,31,0,1,34,1,28,1,8,38
2020,52028,San Gimignano,SI,70,6,25,2,0,33,1,37,0,8,46
2020,52028,San Gimignano,SI,71,2,31,0,1,34,3,38,1,11,53
2020,52028,San Gimignano,SI,72,3,40,3,5,51,1,35,0,8,44
2020,52028,San Gimignano,SI,73,8,40,3,0,51,3,41,2,12,58
2020,52028,San Gimignano,SI,74,6,40,2,3,51,1,29,0,7,37
2020,52028,San Gimignano,SI,75,1,28,0,1,30,0,23,1,10,34
2020,52028,San Gimignano,SI,76,2,30,2,4,38,0,26,1,9,36
2020,52028,San Gimignano,SI,77,4,23,2,3,32,2,22,1,9,34
2020,52028,San Gimignano,SI,78,1,29,1,2,33,0,15,0,7,22
2020,52028,San Gimignano,SI,79,3,19,1,4,27,0,21,0,19,40
2020,52028,San Gimignano,SI,80,4,29,0,2,35,0,19,1,17,37
2020,52028,San Gimignano,SI,81,0,22,0,5,27,1,27,1,18,47
2020,52028,San Gimignano,SI,82,0,19,1,2,22,1,19,1,14,35
2020,52028,San Gimignano,SI,83,1,21,0,9,31,1,11,2,15,29
2020,52028,San Gimignano,SI,84,3,16,0,5,24,1,4,0,17,22
2020,52028,San Gimignano,SI,85,1,17,0,3,21,1,7,1,23,32
2020,52028,San Gimignano,SI,86,2,14,0,5,21,0,5,0,19,24
2020,52028,San Gimignano,SI,87,2,15,0,5,22,3,5,0,14,22
2020,52028,San Gimignano,SI,88,0,14,0,7,21,1,8,0,21,30
2020,52028,San Gimignano,SI,89,1,11,0,1,13,2,2,0,19,23
2020,52028,San Gimignano,SI,90,0,6,0,1,7,0,1,0,12,13
2020,52028,San Gimignano,SI,91,0,6,0,2,8,0,3,0,12,15
2020,52028,San Gimignano,SI,92,0,8,0,4,12,1,3,0,13,17
2020,52028,San Gimignano,SI,93,1,4,0,1,6,0,0,0,7,7
2020,52028,San Gimignano,SI,94,0,2,0,4,6,0,0,0,9,9
2020,52028,San Gimignano,SI,95,0,2,0,1,3,0,0,0,1,1
2020,52028,San Gimignano,SI,96,0,0,0,2,2,0,0,0,5,5
2020,52028,San Gimignano,SI,97,0,0,0,0,0,0,0,0,1,1
2020,52028,San Gimignano,SI,98,0,0,0,0,0,0,0,0,4,4
2020,52028,San Gimignano,SI,99,0,0,0,1,1,0,0,0,2,2
2020,52028,San Gimignano,SI,100 e più,0,0,0,1,1,0,0,0,5,5
2020,52030,San Quirico d'Orcia,SI,0,7,0,0,0,7,6,0,0,0,6
2020,52030,San Quirico d'Orcia,SI,1,11,0,0,0,11,11,0,0,0,11
2020,52030,San Quirico d'Orcia,SI,2,7,0,0,0,7,13,0,0,0,13
2020,52030,San Quirico d'Orcia,SI,3,15,0,0,0,15,10,0,0,0,10
2020,52030,San Quirico d'Orcia,SI,4,10,0,0,0,10,12,0,0,0,12
2020,52030,San Quirico d'Orcia,SI,5,8,0,0,0,8,13,0,0,0,13
2020,52030,San Quirico d'Orcia,SI,6,13,0,0,0,13,6,0,0,0,6
2020,52030,San Quirico d'Orcia,SI,7,7,0,0,0,7,7,0,0,0,7
2020,52030,San Quirico d'Orcia,SI,8,7,0,0,0,7,7,0,0,0,7
2020,52030,San Quirico d'Orcia,SI,9,15,0,0,0,15,9,0,0,0,9
2020,52030,San Quirico d'Orcia,SI,10,15,0,0,0,15,9,0,0,0,9
2020,52030,San Quirico d'Orcia,SI,11,11,0,0,0,11,14,0,0,0,14
2020,52030,San Quirico d'Orcia,SI,12,10,0,0,0,10,15,0,0,0,15
2020,52030,San Quirico d'Orcia,SI,13,13,0,0,0,13,15,0,0,0,15
2020,52030,San Quirico d'Orcia,SI,14,11,0,0,0,11,8,0,0,0,8
2020,52030,San Quirico d'Orcia,SI,15,16,0,0,0,16,5,0,0,0,5
2020,52030,San Quirico d'Orcia,SI,16,6,0,0,0,6,14,0,0,0,14
2020,52030,San Quirico d'Orcia,SI,17,14,0,0,0,14,11,0,0,0,11
2020,52030,San Quirico d'Orcia,SI,18,11,0,0,0,11,11,0,0,0,11
2020,52030,San Quirico d'Orcia,SI,19,12,0,0,0,12,8,0,0,0,8
2020,52030,San Quirico d'Orcia,SI,20,7,0,0,0,7,14,0,0,0,14
2020,52030,San Quirico d'Orcia,SI,21,19,0,0,0,19,8,1,0,0,9
2020,52030,San Quirico d'Orcia,SI,22,11,0,0,0,11,11,1,0,0,12
2020,52030,San Quirico d'Orcia,SI,23,9,0,0,0,9,9,0,0,0,9
2020,52030,San Quirico d'Orcia,SI,24,16,1,0,0,17,14,0,0,0,14
2020,52030,San Quirico d'Orcia,SI,25,11,1,0,0,12,10,2,0,0,12
2020,52030,San Quirico d'Orcia,SI,26,8,0,0,0,8,10,2,0,0,12
2020,52030,San Quirico d'Orcia,SI,27,15,2,0,0,17,12,2,0,0,14
2020,52030,San Quirico d'Orcia,SI,28,17,1,0,0,18,12,5,0,0,17
2020,52030,San Quirico d'Orcia,SI,29,8,0,0,0,8,9,9,0,0,18
2020,52030,San Quirico d'Orcia,SI,30,12,4,0,0,16,6,4,0,0,10
2020,52030,San Quirico d'Orcia,SI,31,14,4,0,0,18,8,5,0,0,13
2020,52030,San Quirico d'Orcia,SI,32,17,3,0,0,20,13,6,0,0,19
2020,52030,San Quirico d'Orcia,SI,33,13,8,0,0,21,6,4,0,0,10
2020,52030,San Quirico d'Orcia,SI,34,8,5,0,0,13,6,7,0,0,13
2020,52030,San Quirico d'Orcia,SI,35,12,6,0,0,18,9,8,1,0,18
2020,52030,San Quirico d'Orcia,SI,36,7,9,0,0,16,7,5,0,0,12
2020,52030,San Quirico d'Orcia,SI,37,6,7,0,0,13,7,8,2,0,17
2020,52030,San Quirico d'Orcia,SI,38,8,6,0,0,14,6,12,0,0,18
2020,52030,San Quirico d'Orcia,SI,39,9,7,0,0,16,5,9,0,0,14
2020,52030,San Quirico d'Orcia,SI,40,11,4,0,0,15,5,6,1,0,12
2020,52030,San Quirico d'Orcia,SI,41,11,9,0,0,20,11,10,1,0,22
2020,52030,San Quirico d'Orcia,SI,42,7,11,1,0,19,6,15,0,0,21
2020,52030,San Quirico d'Orcia,SI,43,5,16,0,0,21,1,6,4,0,11
2020,52030,San Quirico d'Orcia,SI,44,19,11,0,0,30,4,17,0,0,21
2020,52030,San Quirico d'Orcia,SI,45,6,10,2,0,18,5,14,1,1,21
2020,52030,San Quirico d'Orcia,SI,46,8,5,1,0,14,6,11,2,0,19
2020,52030,San Quirico d'Orcia,SI,47,3,16,1,0,20,6,17,2,0,25
2020,52030,San Quirico d'Orcia,SI,48,6,9,0,0,15,6,13,1,0,20
2020,52030,San Quirico d'Orcia,SI,49,8,15,1,0,24,10,12,0,0,22
2020,52030,San Quirico d'Orcia,SI,50,5,11,2,0,18,4,17,1,0,22
2020,52030,San Quirico d'Orcia,SI,51,7,12,1,0,20,7,13,3,1,24
2020,52030,San Quirico d'Orcia,SI,52,8,12,0,0,20,4,12,4,0,20
2020,52030,San Quirico d'Orcia,SI,53,5,14,1,0,20,7,18,1,1,27
2020,52030,San Quirico d'Orcia,SI,54,4,11,0,0,15,1,14,2,2,19
2020,52030,San Quirico d'Orcia,SI,55,2,16,4,0,22,3,18,2,1,24
2020,52030,San Quirico d'Orcia,SI,56,0,13,2,0,15,1,24,1,0,26
2020,52030,San Quirico d'Orcia,SI,57,3,15,1,0,19,2,17,2,0,21
2020,52030,San Quirico d'Orcia,SI,58,2,14,1,0,17,1,14,1,2,18
2020,52030,San Quirico d'Orcia,SI,59,1,11,2,0,14,3,19,1,0,23
2020,52030,San Quirico d'Orcia,SI,60,2,10,2,0,14,1,14,2,0,17
2020,52030,San Quirico d'Orcia,SI,61,4,15,1,2,22,0,10,1,3,14
2020,52030,San Quirico d'Orcia,SI,62,2,16,1,1,20,0,17,0,2,19
2020,52030,San Quirico d'Orcia,SI,63,0,11,3,0,14,2,15,0,2,19
2020,52030,San Quirico d'Orcia,SI,64,1,12,1,1,15,1,15,2,1,19
2020,52030,San Quirico d'Orcia,SI,65,0,16,0,0,16,2,12,3,5,22
2020,52030,San Quirico d'Orcia,SI,66,1,14,1,0,16,0,9,0,4,13
2020,52030,San Quirico d'Orcia,SI,67,3,15,0,0,18,0,12,0,1,13
2020,52030,San Quirico d'Orcia,SI,68,1,13,0,0,14,0,13,0,1,14
2020,52030,San Quirico d'Orcia,SI,69,1,8,0,1,10,0,15,0,3,18
2020,52030,San Quirico d'Orcia,SI,70,0,13,0,1,14,0,12,0,1,13
2020,52030,San Quirico d'Orcia,SI,71,1,16,1,1,19,0,5,1,4,10
2020,52030,San Quirico d'Orcia,SI,72,0,10,0,0,10,4,13,1,5,23
2020,52030,San Quirico d'Orcia,SI,73,3,15,1,1,20,0,16,0,2,18
2020,52030,San Quirico d'Orcia,SI,74,1,18,0,0,19,0,9,2,4,15
2020,52030,San Quirico d'Orcia,SI,75,1,9,0,1,11,2,8,1,13,24
2020,52030,San Quirico d'Orcia,SI,76,1,10,0,2,13,0,7,1,3,11
2020,52030,San Quirico d'Orcia,SI,77,0,6,0,0,6,0,8,0,6,14
2020,52030,San Quirico d'Orcia,SI,78,0,7,0,0,7,1,8,0,3,12
2020,52030,San Quirico d'Orcia,SI,79,1,7,1,0,9,1,9,0,4,14
2020,52030,San Quirico d'Orcia,SI,80,0,13,0,2,15,0,11,0,4,15
2020,52030,San Quirico d'Orcia,SI,81,1,7,0,1,9,1,3,1,5,10
2020,52030,San Quirico d'Orcia,SI,82,2,9,0,2,13,0,9,0,7,16
2020,52030,San Quirico d'Orcia,SI,83,0,8,0,2,10,1,4,0,7,12
2020,52030,San Quirico d'Orcia,SI,84,0,15,1,0,16,1,2,0,10,13
2020,52030,San Quirico d'Orcia,SI,85,0,8,1,0,9,1,4,0,4,9
2020,52030,San Quirico d'Orcia,SI,86,0,4,0,1,5,0,3,0,5,8
2020,52030,San Quirico d'Orcia,SI,87,0,2,0,1,3,0,2,0,8,10
2020,52030,San Quirico d'Orcia,SI,88,0,3,0,1,4,0,0,0,5,5
2020,52030,San Quirico d'Orcia,SI,89,1,4,0,0,5,0,2,0,9,11
2020,52030,San Quirico d'Orcia,SI,90,2,0,0,0,2,0,0,0,9,9
2020,52030,San Quirico d'Orcia,SI,91,0,4,0,0,4,0,1,0,5,6
2020,52030,San Quirico d'Orcia,SI,92,0,1,0,0,1,1,1,0,7,9
2020,52030,San Quirico d'Orcia,SI,93,0,1,0,0,1,0,1,0,1,2
2020,52030,San Quirico d'Orcia,SI,94,0,0,0,0,0,0,0,0,1,1
2020,52030,San Quirico d'Orcia,SI,95,0,0,0,0,0,0,0,0,2,2
2020,52030,San Quirico d'Orcia,SI,96,0,2,0,1,3,0,0,0,2,2
2020,52030,San Quirico d'Orcia,SI,97,0,1,0,0,1,0,0,0,2,2
2020,52030,San Quirico d'Orcia,SI,98,0,0,0,0,0,0,0,0,0,0
2020,52030,San Quirico d'Orcia,SI,99,0,0,0,0,0,0,0,0,0,0
2020,52030,San Quirico d'Orcia,SI,100 e più,0,0,0,0,0,0,0,0,1,1
2020,52031,Sarteano,SI,0,15,0,0,0,15,15,0,0,0,15
2020,52031,Sarteano,SI,1,11,0,0,0,11,16,0,0,0,16
2020,52031,Sarteano,SI,2,13,0,0,0,13,16,0,0,0,16
2020,52031,Sarteano,SI,3,17,0,0,0,17,14,0,0,0,14
2020,52031,Sarteano,SI,4,20,0,0,0,20,19,0,0,0,19
2020,52031,Sarteano,SI,5,18,0,0,0,18,12,0,0,0,12
2020,52031,Sarteano,SI,6,19,0,0,0,19,16,0,0,0,16
2020,52031,Sarteano,SI,7,19,0,0,0,19,20,0,0,0,20
2020,52031,Sarteano,SI,8,20,0,0,0,20,22,0,0,0,22
2020,52031,Sarteano,SI,9,14,0,0,0,14,16,0,0,0,16
2020,52031,Sarteano,SI,10,25,0,0,0,25,19,0,0,0,19
2020,52031,Sarteano,SI,11,18,0,0,0,18,33,0,0,0,33
2020,52031,Sarteano,SI,12,19,0,0,0,19,19,0,0,0,19
2020,52031,Sarteano,SI,13,19,0,0,0,19,22,0,0,0,22
2020,52031,Sarteano,SI,14,16,0,0,0,16,32,0,0,0,32
2020,52031,Sarteano,SI,15,29,0,0,0,29,22,0,0,0,22
2020,52031,Sarteano,SI,16,17,0,0,0,17,15,0,0,0,15
2020,52031,Sarteano,SI,17,18,0,0,0,18,23,0,0,0,23
2020,52031,Sarteano,SI,18,16,0,0,0,16,21,0,0,0,21
2020,52031,Sarteano,SI,19,20,0,0,0,20,18,0,0,0,18
2020,52031,Sarteano,SI,20,23,0,0,0,23,13,2,0,0,15
2020,52031,Sarteano,SI,21,18,1,0,0,19,17,0,0,0,17
2020,52031,Sarteano,SI,22,21,0,0,0,21,14,0,0,0,14
2020,52031,Sarteano,SI,23,17,0,0,0,17,23,0,0,0,23
2020,52031,Sarteano,SI,24,18,0,0,0,18,14,2,0,0,16
2020,52031,Sarteano,SI,25,18,0,0,0,18,11,1,0,0,12
2020,52031,Sarteano,SI,26,18,2,0,0,20,10,3,0,0,13
2020,52031,Sarteano,SI,27,10,0,0,0,10,11,2,0,0,13
2020,52031,Sarteano,SI,28,19,1,0,0,20,28,0,1,0,29
2020,52031,Sarteano,SI,29,15,5,0,0,20,15,6,0,0,21
2020,52031,Sarteano,SI,30,15,2,0,0,17,23,6,0,0,29
2020,52031,Sarteano,SI,31,16,1,0,0,17,19,2,1,0,22
2020,52031,Sarteano,SI,32,9,3,0,0,12,12,6,1,0,19
2020,52031,Sarteano,SI,33,16,7,0,0,23,12,10,0,0,22
2020,52031,Sarteano,SI,34,17,5,0,0,22,13,7,1,0,21
2020,52031,Sarteano,SI,35,13,9,0,0,22,18,11,1,0,30
2020,52031,Sarteano,SI,36,15,12,0,0,27,12,10,1,0,23
2020,52031,Sarteano,SI,37,9,6,0,0,15,16,15,0,0,31
2020,52031,Sarteano,SI,38,9,10,0,0,19,11,14,1,0,26
2020,52031,Sarteano,SI,39,19,8,0,0,27,9,12,1,0,22
2020,52031,Sarteano,SI,40,15,11,2,0,28,12,19,1,0,32
2020,52031,Sarteano,SI,41,12,16,1,0,29,6,16,2,0,24
2020,52031,Sarteano,SI,42,22,17,1,0,40,15,18,1,0,34
2020,52031,Sarteano,SI,43,14,13,0,0,27,5,21,2,0,28
2020,52031,Sarteano,SI,44,6,21,0,0,27,12,16,2,0,30
2020,52031,Sarteano,SI,45,16,19,1,1,37,9,25,1,1,36
2020,52031,Sarteano,SI,46,13,21,2,0,36,9,23,3,0,35
2020,52031,Sarteano,SI,47,11,25,2,0,38,8,18,2,0,28
2020,52031,Sarteano,SI,48,16,21,1,0,38,11,22,3,1,37
2020,52031,Sarteano,SI,49,10,21,0,0,31,14,24,2,0,40
2020,52031,Sarteano,SI,50,10,19,1,2,32,10,24,2,1,37
2020,52031,Sarteano,SI,51,9,21,1,0,31,6,27,1,0,34
2020,52031,Sarteano,SI,52,9,27,1,1,38,4,20,5,2,31
2020,52031,Sarteano,SI,53,8,19,2,0,29,3,25,2,1,31
2020,52031,Sarteano,SI,54,8,20,4,3,35,8,30,2,0,40
2020,52031,Sarteano,SI,55,9,30,1,0,40,9,27,4,4,44
2020,52031,Sarteano,SI,56,4,26,1,0,31,2,31,2,2,37
2020,52031,Sarteano,SI,57,6,20,1,0,27,1,26,4,2,33
2020,52031,Sarteano,SI,58,5,22,3,1,31,8,26,7,3,44
2020,52031,Sarteano,SI,59,0,28,2,0,30,4,23,4,0,31
2020,52031,Sarteano,SI,60,2,26,2,0,30,2,21,4,6,33
2020,52031,Sarteano,SI,61,1,29,2,1,33,2,30,2,3,37
2020,52031,Sarteano,SI,62,7,25,1,3,36,3,23,5,2,33
2020,52031,Sarteano,SI,63,2,23,2,2,29,0,22,3,0,25
2020,52031,Sarteano,SI,64,4,20,1,0,25,3,16,2,2,23
2020,52031,Sarteano,SI,65,3,15,4,0,22,2,23,2,5,32
2020,52031,Sarteano,SI,66,4,22,3,3,32,2,22,1,3,28
2020,52031,Sarteano,SI,67,2,30,1,1,34,0,18,1,5,24
2020,52031,Sarteano,SI,68,2,13,2,1,18,1,18,1,5,25
2020,52031,Sarteano,SI,69,4,20,1,0,25,3,24,2,4,33
2020,52031,Sarteano,SI,70,2,28,0,2,32,1,24,2,7,34
2020,52031,Sarteano,SI,71,2,19,1,2,24,4,29,3,6,42
2020,52031,Sarteano,SI,72,5,36,0,4,45,2,25,1,2,30
2020,52031,Sarteano,SI,73,1,28,0,0,29,3,22,0,16,41
2020,52031,Sarteano,SI,74,3,29,0,1,33,0,17,0,8,25
2020,52031,Sarteano,SI,75,4,20,0,2,26,0,13,1,6,20
2020,52031,Sarteano,SI,76,0,14,0,0,14,2,15,1,13,31
2020,52031,Sarteano,SI,77,0,16,0,3,19,3,16,2,8,29
2020,52031,Sarteano,SI,78,1,17,0,4,22,0,14,0,15,29
2020,52031,Sarteano,SI,79,3,18,0,2,23,0,12,1,13,26
2020,52031,Sarteano,SI,80,2,21,0,0,23,3,6,2,14,25
2020,52031,Sarteano,SI,81,0,12,0,3,15,1,13,1,19,34
2020,52031,Sarteano,SI,82,2,17,1,5,25,0,9,0,15,24
2020,52031,Sarteano,SI,83,2,9,0,5,16,4,9,0,10,23
2020,52031,Sarteano,SI,84,1,11,0,3,15,1,4,0,16,21
2020,52031,Sarteano,SI,85,3,12,0,2,17,2,11,0,17,30
2020,52031,Sarteano,SI,86,1,9,1,2,13,1,8,0,11,20
2020,52031,Sarteano,SI,87,0,7,0,2,9,0,3,1,17,21
2020,52031,Sarteano,SI,88,0,8,0,2,10,0,2,0,10,12
2020,52031,Sarteano,SI,89,0,7,0,0,7,0,1,0,21,22
2020,52031,Sarteano,SI,90,0,6,0,1,7,1,1,0,12,14
2020,52031,Sarteano,SI,91,1,2,0,2,5,2,2,0,11,15
2020,52031,Sarteano,SI,92,0,1,0,3,4,0,0,0,7,7
2020,52031,Sarteano,SI,93,0,2,0,1,3,0,0,0,11,11
2020,52031,Sarteano,SI,94,1,1,0,0,2,0,2,0,3,5
2020,52031,Sarteano,SI,95,0,1,0,0,1,0,0,0,9,9
2020,52031,Sarteano,SI,96,1,0,0,2,3,1,0,0,4,5
2020,52031,Sarteano,SI,97,0,0,0,0,0,0,0,0,1,1
2020,52031,Sarteano,SI,98,0,0,0,0,0,0,0,0,2,2
2020,52031,Sarteano,SI,99,0,0,0,0,0,0,0,0,1,1
2020,52031,Sarteano,SI,100 e più,0,0,0,0,0,0,0,0,1,1
2020,52032,Siena,SI,0,155,0,0,0,155,151,0,0,0,151
2020,52032,Siena,SI,1,158,0,0,0,158,172,0,0,0,172
2020,52032,Siena,SI,2,176,0,0,0,176,179,0,0,0,179
2020,52032,Siena,SI,3,163,0,0,0,163,193,0,0,0,193
2020,52032,Siena,SI,4,156,0,0,0,156,185,0,0,0,185
2020,52032,Siena,SI,5,191,0,0,0,191,195,0,0,0,195
2020,52032,Siena,SI,6,196,0,0,0,196,168,0,0,0,168
2020,52032,Siena,SI,7,206,0,0,0,206,218,0,0,0,218
2020,52032,Siena,SI,8,199,0,0,0,199,222,0,0,0,222
2020,52032,Siena,SI,9,233,0,0,0,233,178,0,0,0,178
2020,52032,Siena,SI,10,240,0,0,0,240,218,0,0,0,218
2020,52032,Siena,SI,11,226,0,0,0,226,229,0,0,0,229
2020,52032,Siena,SI,12,218,0,0,0,218,229,0,0,0,229
2020,52032,Siena,SI,13,254,0,0,0,254,254,0,0,0,254
2020,52032,Siena,SI,14,235,0,0,0,235,205,0,0,0,205
2020,52032,Siena,SI,15,237,0,0,0,237,207,0,0,0,207
2020,52032,Siena,SI,16,241,0,0,0,241,209,0,0,0,209
2020,52032,Siena,SI,17,233,0,0,0,233,217,0,0,0,217
2020,52032,Siena,SI,18,233,0,0,0,233,215,0,0,0,215
2020,52032,Siena,SI,19,244,0,0,0,244,224,0,0,0,224
2020,52032,Siena,SI,20,287,1,0,0,288,249,0,0,0,249
2020,52032,Siena,SI,21,279,1,0,0,280,300,8,1,0,309
2020,52032,Siena,SI,22,285,2,0,0,287,261,7,0,0,268
2020,52032,Siena,SI,23,273,2,0,0,275,246,13,0,0,259
2020,52032,Siena,SI,24,327,1,0,0,328,268,15,0,0,283
2020,52032,Siena,SI,25,298,9,0,0,307,226,32,0,0,258
2020,52032,Siena,SI,26,275,7,0,0,282,241,10,0,0,251
2020,52032,Siena,SI,27,287,8,0,0,295,257,24,0,0,281
2020,52032,Siena,SI,28,298,17,0,0,315,289,32,2,0,323
2020,52032,Siena,SI,29,268,31,0,0,299,225,38,1,0,264
2020,52032,Siena,SI,30,310,40,2,0,352,259,54,1,0,314
2020,52032,Siena,SI,31,296,38,1,0,336,220,79,5,0,304
2020,52032,Siena,SI,32,239,31,1,0,271,227,88,1,0,316
2020,52032,Siena,SI,33,203,57,2,0,262,183,99,1,0,283
2020,52032,Siena,SI,34,194,82,5,0,282,147,114,3,0,264
2020,52032,Siena,SI,35,190,95,2,0,287,172,126,5,0,303
2020,52032,Siena,SI,36,193,99,4,0,296,162,151,4,0,317
2020,52032,Siena,SI,37,165,106,2,1,274,157,162,6,1,329
2020,52032,Siena,SI,38,175,117,3,0,296,142,168,7,2,320
2020,52032,Siena,SI,39,160,136,8,0,304,139,149,8,0,296
2020,52032,Siena,SI,40,155,142,4,1,302,117,160,9,0,286
2020,52032,Siena,SI,41,147,138,6,0,291,134,183,15,4,336
2020,52032,Siena,SI,42,149,169,9,0,328,147,204,15,0,366
2020,52032,Siena,SI,43,151,188,12,0,351,116,236,20,3,375
2020,52032,Siena,SI,44,133,195,10,0,338,158,207,20,2,387
2020,52032,Siena,SI,45,149,172,10,1,333,139,226,17,3,385
2020,52032,Siena,SI,46,154,200,16,2,373,133,264,23,3,423
2020,52032,Siena,SI,47,148,229,12,2,391,121,265,21,3,411
2020,52032,Siena,SI,48,156,200,15,1,373,138,272,36,4,450
2020,52032,Siena,SI,49,111,242,20,2,375,142,255,29,6,432
2020,52032,Siena,SI,50,119,219,19,1,358,119,269,53,3,444
2020,52032,Siena,SI,51,116,266,23,4,409,90,328,46,6,471
2020,52032,Siena,SI,52,88,257,25,2,373,111,306,42,2,461
2020,52032,Siena,SI,53,95,276,28,3,402,99,303,32,9,444
2020,52032,Siena,SI,54,87,291,25,3,406,92,326,48,7,474
2020,52032,Siena,SI,55,89,298,26,5,419,84,305,42,9,440
2020,52032,Siena,SI,56,63,260,27,3,355,90,314,56,18,479
2020,52032,Siena,SI,57,63,284,28,3,379,64,306,44,9,424
2020,52032,Siena,SI,58,62,270,28,8,368,65,305,46,23,439
2020,52032,Siena,SI,59,40,239,21,4,304,71,296,49,23,439
2020,52032,Siena,SI,60,47,250,23,6,326,48,272,49,19,388
2020,52032,Siena,SI,61,54,258,21,7,342,50,266,31,37,384
2020,52032,Siena,SI,62,46,238,18,10,313,45,286,35,32,398
2020,52032,Siena,SI,63,35,251,32,4,322,44,250,46,27,367
2020,52032,Siena,SI,64,31,253,20,6,310,49,276,36,22,383
2020,52032,Siena,SI,65,34,240,18,4,296,39,236,32,40,347
2020,52032,Siena,SI,66,12,218,12,6,248,33,256,40,31,360
2020,52032,Siena,SI,67,27,221,11,10,269,31,238,37,46,352
2020,52032,Siena,SI,68,35,211,13,10,269,35,247,33,51,366
2020,52032,Siena,SI,69,30,217,13,17,277,26,217,30,48,321
2020,52032,Siena,SI,70,18,210,15,7,250,25,235,24,58,342
2020,52032,Siena,SI,71,24,254,11,15,304,23,239,25,65,352
2020,52032,Siena,SI,72,16,276,14,20,326,30,250,23,77,380
2020,52032,Siena,SI,73,23,259,10,28,320,30,265,20,92,407
2020,52032,Siena,SI,74,16,273,18,21,329,22,276,16,77,391
2020,52032,Siena,SI,75,7,184,8,28,228,24,197,9,68,298
2020,52032,Siena,SI,76,10,200,8,25,243,19,184,7,85,295
2020,52032,Siena,SI,77,11,215,6,29,261,20,179,9,95,303
2020,52032,Siena,SI,78,24,175,6,27,232,24,156,10,117,307
2020,52032,Siena,SI,79,9,180,3,24,216,24,174,10,131,339
2020,52032,Siena,SI,80,16,213,6,40,275,23,184,10,174,391
2020,52032,Siena,SI,81,15,211,4,42,272,13,134,5,153,305
2020,52032,Siena,SI,82,7,169,1,29,206,22,122,7,194,345
2020,52032,Siena,SI,83,11,177,4,23,215,12,109,8,185,314
2020,52032,Siena,SI,84,14,139,2,26,181,14,83,9,143,249
2020,52032,Siena,SI,85,16,127,2,31,176,18,93,11,174,296
2020,52032,Siena,SI,86,11,109,4,33,157,19,62,5,157,243
2020,52032,Siena,SI,87,5,98,3,32,138,17,42,2,148,209
2020,52032,Siena,SI,88,2,56,2,33,93,18,35,1,153,207
2020,52032,Siena,SI,89,4,70,0,36,110,19,26,1,139,185
2020,52032,Siena,SI,90,5,39,2,23,69,14,17,1,148,180
2020,52032,Siena,SI,91,2,41,2,28,73,15,13,4,136,168
2020,52032,Siena,SI,92,5,32,0,18,55,11,5,1,104,121
2020,52032,Siena,SI,93,4,14,0,17,35,14,2,1,89,106
2020,52032,Siena,SI,94,2,20,0,19,41,7,2,0,81,90
2020,52032,Siena,SI,95,0,6,1,13,20,3,3,0,64,70
2020,52032,Siena,SI,96,0,2,0,11,13,9,0,1,38,48
2020,52032,Siena,SI,97,0,1,0,5,6,5,0,0,34,39
2020,52032,Siena,SI,98,0,1,0,5,6,3,0,0,34,37
2020,52032,Siena,SI,99,0,0,0,1,1,3,0,0,21,24
2020,52032,Siena,SI,100 e più,0,1,0,3,4,4,0,0,22,26
2020,52033,Sinalunga,SI,0,33,0,0,0,33,41,0,0,0,41
2020,52033,Sinalunga,SI,1,38,0,0,0,38,39,0,0,0,39
2020,52033,Sinalunga,SI,2,41,0,0,0,41,42,0,0,0,42
2020,52033,Sinalunga,SI,3,43,0,0,0,43,40,0,0,0,40
2020,52033,Sinalunga,SI,4,44,0,0,0,44,39,0,0,0,39
2020,52033,Sinalunga,SI,5,61,0,0,0,61,46,0,0,0,46
2020,52033,Sinalunga,SI,6,56,0,0,0,56,58,0,0,0,58
2020,52033,Sinalunga,SI,7,58,0,0,0,58,48,0,0,0,48
2020,52033,Sinalunga,SI,8,54,0,0,0,54,60,0,0,0,60
2020,52033,Sinalunga,SI,9,68,0,0,0,68,64,0,0,0,64
2020,52033,Sinalunga,SI,10,54,0,0,0,54,51,0,0,0,51
2020,52033,Sinalunga,SI,11,56,0,0,0,56,59,0,0,0,59
2020,52033,Sinalunga,SI,12,54,0,0,0,54,48,0,0,0,48
2020,52033,Sinalunga,SI,13,41,0,0,0,41,50,0,0,0,50
2020,52033,Sinalunga,SI,14,73,0,0,0,73,43,0,0,0,43
2020,52033,Sinalunga,SI,15,51,0,0,0,51,42,0,0,0,42
2020,52033,Sinalunga,SI,16,53,0,0,0,53,41,0,0,0,41
2020,52033,Sinalunga,SI,17,70,0,0,0,70,51,0,0,0,51
2020,52033,Sinalunga,SI,18,42,0,0,0,42,60,0,0,0,60
2020,52033,Sinalunga,SI,19,56,0,0,0,56,50,0,0,0,50
2020,52033,Sinalunga,SI,20,56,1,0,0,57,52,0,0,0,52
2020,52033,Sinalunga,SI,21,55,0,0,0,55,52,2,0,0,54
2020,52033,Sinalunga,SI,22,45,0,0,0,45,52,3,0,0,55
2020,52033,Sinalunga,SI,23,56,0,0,0,56,55,2,0,0,57
2020,52033,Sinalunga,SI,24,56,2,0,0,58,49,2,0,0,51
2020,52033,Sinalunga,SI,25,50,3,0,0,53,51,10,0,0,61
2020,52033,Sinalunga,SI,26,60,3,0,0,63,64,10,0,0,74
2020,52033,Sinalunga,SI,27,40,5,0,0,45,47,12,0,0,59
2020,52033,Sinalunga,SI,28,59,10,0,0,69,32,17,0,0,49
2020,52033,Sinalunga,SI,29,53,7,0,0,60,44,13,0,0,57
2020,52033,Sinalunga,SI,30,57,12,0,0,69,48,19,0,0,67
2020,52033,Sinalunga,SI,31,51,13,1,0,65,44,22,0,0,66
2020,52033,Sinalunga,SI,32,64,16,0,0,80,34,29,1,0,64
2020,52033,Sinalunga,SI,33,49,11,0,0,60,40,30,1,0,71
2020,52033,Sinalunga,SI,34,32,17,0,0,49,27,35,1,0,63
2020,52033,Sinalunga,SI,35,52,24,0,0,76,36,36,0,0,72
2020,52033,Sinalunga,SI,36,38,22,0,0,60,36,32,1,0,69
2020,52033,Sinalunga,SI,37,45,30,1,0,76,32,43,4,0,79
2020,52033,Sinalunga,SI,38,38,34,0,0,72,25,42,0,1,68
2020,52033,Sinalunga,SI,39,20,34,0,0,54,16,41,3,0,60
2020,52033,Sinalunga,SI,40,26,51,3,0,80,30,51,2,0,83
2020,52033,Sinalunga,SI,41,31,44,2,0,77,24,62,3,0,89
2020,52033,Sinalunga,SI,42,31,53,1,0,85,27,60,0,0,87
2020,52033,Sinalunga,SI,43,25,60,2,0,87,37,70,4,1,112
2020,52033,Sinalunga,SI,44,24,51,1,1,77,20,64,3,1,88
2020,52033,Sinalunga,SI,45,31,73,5,0,109,8,67,8,0,83
2020,52033,Sinalunga,SI,46,29,59,4,0,92,18,53,3,1,75
2020,52033,Sinalunga,SI,47,20,72,2,0,94,16,56,1,2,75
2020,52033,Sinalunga,SI,48,26,61,5,0,92,15,65,3,1,84
2020,52033,Sinalunga,SI,49,24,48,1,2,75,16,77,6,2,101
2020,52033,Sinalunga,SI,50,17,74,7,1,99,12,74,9,0,95
2020,52033,Sinalunga,SI,51,20,63,4,1,88,6,88,10,2,106
2020,52033,Sinalunga,SI,52,15,75,5,1,96,8,67,4,5,84
2020,52033,Sinalunga,SI,53,19,70,8,0,97,17,83,8,1,109
2020,52033,Sinalunga,SI,54,18,80,6,0,104,8,77,12,1,98
2020,52033,Sinalunga,SI,55,10,83,7,0,100,10,80,4,3,97
2020,52033,Sinalunga,SI,56,8,85,8,2,103,8,67,18,2,95
2020,52033,Sinalunga,SI,57,6,62,4,2,74,8,85,9,2,104
2020,52033,Sinalunga,SI,58,14,67,5,1,87,8,70,3,3,84
2020,52033,Sinalunga,SI,59,7,83,7,1,98,8,72,7,6,93
2020,52033,Sinalunga,SI,60,12,63,3,3,81,3,66,9,7,85
2020,52033,Sinalunga,SI,61,6,70,4,4,84,5,67,8,8,88
2020,52033,Sinalunga,SI,62,8,78,3,1,90,4,83,4,10,101
2020,52033,Sinalunga,SI,63,3,50,3,2,58,4,71,9,10,94
2020,52033,Sinalunga,SI,64,3,66,5,3,77,2,68,5,10,85
2020,52033,Sinalunga,SI,65,6,45,5,1,57,3,66,3,14,86
2020,52033,Sinalunga,SI,66,5,78,2,3,88,3,68,5,13,89
2020,52033,Sinalunga,SI,67,5,67,4,2,78,5,67,0,12,84
2020,52033,Sinalunga,SI,68,3,51,2,4,60,1,51,5,14,71
2020,52033,Sinalunga,SI,69,4,63,3,5,75,2,47,2,17,68
2020,52033,Sinalunga,SI,70,6,57,2,4,69,1,54,3,13,71
2020,52033,Sinalunga,SI,71,7,60,2,6,75,0,54,1,12,67
2020,52033,Sinalunga,SI,72,6,79,0,2,87,2,64,3,22,91
2020,52033,Sinalunga,SI,73,5,64,0,1,70,0,48,2,26,76
2020,52033,Sinalunga,SI,74,8,57,1,7,73,3,49,1,32,85
2020,52033,Sinalunga,SI,75,3,32,1,6,42,1,34,0,21,56
2020,52033,Sinalunga,SI,76,7,35,1,4,47,1,36,1,15,53
2020,52033,Sinalunga,SI,77,3,40,2,4,49,2,33,2,27,64
2020,52033,Sinalunga,SI,78,1,37,1,6,45,2,35,0,23,60
2020,52033,Sinalunga,SI,79,6,40,1,4,51,4,22,2,18,46
2020,52033,Sinalunga,SI,80,3,37,1,8,49,3,37,0,30,70
2020,52033,Sinalunga,SI,81,4,45,3,18,70,1,33,0,38,72
2020,52033,Sinalunga,SI,82,3,43,0,9,55,6,30,0,29,65
2020,52033,Sinalunga,SI,83,2,32,0,5,39,2,27,0,37,66
2020,52033,Sinalunga,SI,84,4,31,0,10,45,0,13,0,35,48
2020,52033,Sinalunga,SI,85,4,32,0,7,43,2,15,1,47,65
2020,52033,Sinalunga,SI,86,5,34,0,7,46,3,13,0,29,45
2020,52033,Sinalunga,SI,87,4,26,0,10,40,1,10,0,47,58
2020,52033,Sinalunga,SI,88,0,12,0,2,14,0,3,0,19,22
2020,52033,Sinalunga,SI,89,2,15,0,4,21,0,6,0,24,30
2020,52033,Sinalunga,SI,90,2,10,1,10,23,3,3,0,34,40
2020,52033,Sinalunga,SI,91,1,8,0,5,14,0,1,0,20,21
2020,52033,Sinalunga,SI,92,0,7,0,2,9,2,1,0,13,16
2020,52033,Sinalunga,SI,93,0,4,0,4,8,1,1,1,17,20
2020,52033,Sinalunga,SI,94,1,1,0,3,5,0,0,0,10,10
2020,52033,Sinalunga,SI,95,0,0,0,2,2,0,0,0,11,11
2020,52033,Sinalunga,SI,96,0,1,0,0,1,0,0,0,6,6
2020,52033,Sinalunga,SI,97,0,1,0,1,2,0,0,0,8,8
2020,52033,Sinalunga,SI,98,0,1,0,0,1,0,0,0,4,4
2020,52033,Sinalunga,SI,99,1,0,0,1,2,0,0,0,5,5
2020,52033,Sinalunga,SI,100 e più,0,0,0,0,0,0,0,0,4,4
2020,52034,Sovicille,SI,0,44,0,0,0,44,38,0,0,0,38
2020,52034,Sovicille,SI,1,34,0,0,0,34,40,0,0,0,40
2020,52034,Sovicille,SI,2,39,0,0,0,39,39,0,0,0,39
2020,52034,Sovicille,SI,3,36,0,0,0,36,37,0,0,0,37
2020,52034,Sovicille,SI,4,52,0,0,0,52,50,0,0,0,50
2020,52034,Sovicille,SI,5,43,0,0,0,43,35,0,0,0,35
2020,52034,Sovicille,SI,6,55,0,0,0,55,39,0,0,0,39
2020,52034,Sovicille,SI,7,60,0,0,0,60,39,0,0,0,39
2020,52034,Sovicille,SI,8,35,0,0,0,35,37,0,0,0,37
2020,52034,Sovicille,SI,9,53,0,0,0,53,45,0,0,0,45
2020,52034,Sovicille,SI,10,49,0,0,0,49,51,0,0,0,51
2020,52034,Sovicille,SI,11,39,0,0,0,39,36,0,0,0,36
2020,52034,Sovicille,SI,12,50,0,0,0,50,37,0,0,0,37
2020,52034,Sovicille,SI,13,50,0,0,0,50,46,0,0,0,46
2020,52034,Sovicille,SI,14,50,0,0,0,50,57,0,0,0,57
2020,52034,Sovicille,SI,15,52,0,0,0,52,55,0,0,0,55
2020,52034,Sovicille,SI,16,46,0,0,0,46,45,0,0,0,45
2020,52034,Sovicille,SI,17,40,0,0,0,40,36,0,0,0,36
2020,52034,Sovicille,SI,18,52,0,0,0,52,42,1,0,0,43
2020,52034,Sovicille,SI,19,48,0,0,0,48,37,0,0,0,37
2020,52034,Sovicille,SI,20,44,0,0,0,44,53,1,0,0,54
2020,52034,Sovicille,SI,21,36,0,0,0,36,32,0,0,0,32
2020,52034,Sovicille,SI,22,52,1,0,0,53,46,3,0,0,49
2020,52034,Sovicille,SI,23,46,1,0,0,47,27,9,0,0,36
2020,52034,Sovicille,SI,24,42,0,0,0,42,40,6,0,0,46
2020,52034,Sovicille,SI,25,37,5,0,0,42,35,7,0,0,42
2020,52034,Sovicille,SI,26,46,2,0,0,48,47,9,0,0,56
2020,52034,Sovicille,SI,27,39,2,0,0,41,23,6,0,0,29
2020,52034,Sovicille,SI,28,45,6,0,0,51,44,15,1,0,60
2020,52034,Sovicille,SI,29,41,10,0,0,51,32,9,0,0,41
2020,52034,Sovicille,SI,30,34,11,0,0,45,35,7,0,0,42
2020,52034,Sovicille,SI,31,41,13,0,0,54,40,26,0,1,67
2020,52034,Sovicille,SI,32,35,16,0,0,51,40,22,2,0,64
2020,52034,Sovicille,SI,33,45,11,0,0,56,36,24,0,0,60
2020,52034,Sovicille,SI,34,30,21,0,0,51,37,20,0,0,57
2020,52034,Sovicille,SI,35,34,15,0,0,49,31,34,1,1,67
2020,52034,Sovicille,SI,36,35,29,0,0,64,30,33,0,0,63
2020,52034,Sovicille,SI,37,30,21,1,0,52,29,30,3,0,62
2020,52034,Sovicille,SI,38,32,29,2,0,63,24,35,0,0,59
2020,52034,Sovicille,SI,39,29,32,1,0,62,29,35,3,0,67
2020,52034,Sovicille,SI,40,24,28,0,0,52,19,32,1,0,52
2020,52034,Sovicille,SI,41,49,31,2,0,82,25,51,2,0,78
2020,52034,Sovicille,SI,42,37,45,2,0,84,27,42,4,0,73
2020,52034,Sovicille,SI,43,35,39,0,0,74,26,51,3,0,80
2020,52034,Sovicille,SI,44,26,42,3,0,71,26,51,5,1,83
2020,52034,Sovicille,SI,45,29,56,3,0,88,28,53,5,0,86
2020,52034,Sovicille,SI,46,39,57,3,0,99,24,46,11,5,86
2020,52034,Sovicille,SI,47,30,41,4,0,75,18,50,3,1,72
2020,52034,Sovicille,SI,48,28,52,3,0,83,20,57,8,2,87
2020,52034,Sovicille,SI,49,29,54,2,0,85,14,51,4,1,70
2020,52034,Sovicille,SI,50,16,41,5,0,62,17,75,9,1,102
2020,52034,Sovicille,SI,51,16,51,8,1,76,22,60,11,1,94
2020,52034,Sovicille,SI,52,17,56,10,0,83,18,55,6,2,81
2020,52034,Sovicille,SI,53,15,60,6,0,81,17,46,7,2,72
2020,52034,Sovicille,SI,54,21,58,3,1,83,16,64,11,2,93
2020,52034,Sovicille,SI,55,19,39,8,0,66,14,55,8,0,77
2020,52034,Sovicille,SI,56,10,65,3,2,80,13,64,8,1,86
2020,52034,Sovicille,SI,57,17,44,6,1,68,11,46,9,2,68
2020,52034,Sovicille,SI,58,9,53,11,0,73,14,54,9,4,81
2020,52034,Sovicille,SI,59,14,46,6,1,67,14,70,4,4,92
2020,52034,Sovicille,SI,60,7,63,5,2,77,6,57,5,8,76
2020,52034,Sovicille,SI,61,14,45,4,1,64,9,47,6,7,69
2020,52034,Sovicille,SI,62,9,45,1,2,57,6,54,5,10,75
2020,52034,Sovicille,SI,63,7,54,7,2,70,4,53,4,3,64
2020,52034,Sovicille,SI,64,11,67,4,1,83,2,47,2,4,55
2020,52034,Sovicille,SI,65,4,29,5,3,41,3,43,1,6,53
2020,52034,Sovicille,SI,66,7,59,6,3,75,6,48,7,12,73
2020,52034,Sovicille,SI,67,5,41,3,0,49,4,44,7,6,61
2020,52034,Sovicille,SI,68,6,49,4,1,60,2,49,5,12,68
2020,52034,Sovicille,SI,69,3,38,3,2,46,4,39,2,8,53
2020,52034,Sovicille,SI,70,4,42,2,4,52,3,40,2,8,53
2020,52034,Sovicille,SI,71,0,44,3,1,48,2,45,3,10,60
2020,52034,Sovicille,SI,72,5,48,1,5,59,3,30,3,11,47
2020,52034,Sovicille,SI,73,3,47,3,5,58,4,42,4,11,61
2020,52034,Sovicille,SI,74,3,36,2,3,44,2,37,4,19,62
2020,52034,Sovicille,SI,75,2,24,0,3,29,1,35,0,21,57
2020,52034,Sovicille,SI,76,2,31,0,5,38,1,22,4,18,45
2020,52034,Sovicille,SI,77,0,45,0,2,47,1,18,1,17,37
2020,52034,Sovicille,SI,78,2,30,4,3,39,0,22,3,17,42
2020,52034,Sovicille,SI,79,2,29,0,6,37,3,19,0,15,37
2020,52034,Sovicille,SI,80,2,22,1,2,27,0,22,0,21,43
2020,52034,Sovicille,SI,81,2,23,0,2,27,4,14,1,32,51
2020,52034,Sovicille,SI,82,1,26,0,4,31,1,14,1,31,47
2020,52034,Sovicille,SI,83,1,24,0,2,27,1,13,2,25,41
2020,52034,Sovicille,SI,84,2,13,2,7,24,0,8,0,23,31
2020,52034,Sovicille,SI,85,1,15,0,3,19,1,6,0,36,43
2020,52034,Sovicille,SI,86,0,19,0,5,24,0,9,1,23,33
2020,52034,Sovicille,SI,87,3,12,0,1,16,2,5,0,28,35
2020,52034,Sovicille,SI,88,1,11,0,6,18,1,2,0,18,21
2020,52034,Sovicille,SI,89,3,6,0,4,13,0,3,2,23,28
2020,52034,Sovicille,SI,90,1,3,0,7,11,0,2,1,24,27
2020,52034,Sovicille,SI,91,1,8,0,2,11,0,0,0,20,20
2020,52034,Sovicille,SI,92,0,3,0,3,6,0,3,0,14,17
2020,52034,Sovicille,SI,93,0,2,0,1,3,0,3,0,10,13
2020,52034,Sovicille,SI,94,0,5,0,0,5,0,0,0,12,12
2020,52034,Sovicille,SI,95,1,2,0,0,3,0,0,0,7,7
2020,52034,Sovicille,SI,96,0,0,0,0,0,0,0,0,6,6
2020,52034,Sovicille,SI,97,1,0,0,2,3,0,1,0,2,3
2020,52034,Sovicille,SI,98,0,0,0,1,1,0,0,0,1,1
2020,52034,Sovicille,SI,99,0,0,0,2,2,0,0,0,1,1
2020,52034,Sovicille,SI,100 e più,0,0,0,1,1,0,0,0,2,2
2020,52035,Torrita di Siena,SI,0,17,0,0,0,17,23,0,0,0,23
2020,52035,Torrita di Siena,SI,1,23,0,0,0,23,22,0,0,0,22
2020,52035,Torrita di Siena,SI,2,35,0,0,0,35,30,0,0,0,30
2020,52035,Torrita di Siena,SI,3,26,0,0,0,26,21,0,0,0,21
2020,52035,Torrita di Siena,SI,4,25,0,0,0,25,24,0,0,0,24
2020,52035,Torrita di Siena,SI,5,29,0,0,0,29,26,0,0,0,26
2020,52035,Torrita di Siena,SI,6,35,0,0,0,35,28,0,0,0,28
2020,52035,Torrita di Siena,SI,7,30,0,0,0,30,32,0,0,0,32
2020,52035,Torrita di Siena,SI,8,28,0,0,0,28,33,0,0,0,33
2020,52035,Torrita di Siena,SI,9,26,0,0,0,26,40,0,0,0,40
2020,52035,Torrita di Siena,SI,10,41,0,0,0,41,22,0,0,0,22
2020,52035,Torrita di Siena,SI,11,41,0,0,0,41,31,0,0,0,31
2020,52035,Torrita di Siena,SI,12,42,0,0,0,42,21,0,0,0,21
2020,52035,Torrita di Siena,SI,13,31,0,0,0,31,33,0,0,0,33
2020,52035,Torrita di Siena,SI,14,25,0,0,0,25,31,0,0,0,31
2020,52035,Torrita di Siena,SI,15,43,0,0,0,43,28,0,0,0,28
2020,52035,Torrita di Siena,SI,16,26,0,0,0,26,29,0,0,0,29
2020,52035,Torrita di Siena,SI,17,39,0,0,0,39,28,0,0,0,28
2020,52035,Torrita di Siena,SI,18,32,0,0,0,32,25,0,0,0,25
2020,52035,Torrita di Siena,SI,19,41,0,0,0,41,29,0,0,0,29
2020,52035,Torrita di Siena,SI,20,36,0,0,0,36,39,0,0,0,39
2020,52035,Torrita di Siena,SI,21,27,0,0,0,27,29,0,0,0,29
2020,52035,Torrita di Siena,SI,22,36,0,0,0,36,21,0,0,0,21
2020,52035,Torrita di Siena,SI,23,31,0,0,0,31,29,0,0,0,29
2020,52035,Torrita di Siena,SI,24,36,0,0,0,36,22,0,0,0,22
2020,52035,Torrita di Siena,SI,25,31,0,0,0,31,28,2,0,0,30
2020,52035,Torrita di Siena,SI,26,23,2,0,0,25,28,2,0,0,30
2020,52035,Torrita di Siena,SI,27,22,0,0,0,22,17,1,0,0,18
2020,52035,Torrita di Siena,SI,28,17,3,0,0,20,23,9,0,0,32
2020,52035,Torrita di Siena,SI,29,22,3,0,0,25,19,9,0,0,28
2020,52035,Torrita di Siena,SI,30,29,6,0,0,35,23,12,0,0,35
2020,52035,Torrita di Siena,SI,31,28,2,0,0,30,15,4,0,1,20
2020,52035,Torrita di Siena,SI,32,27,6,1,0,34,26,11,1,0,38
2020,52035,Torrita di Siena,SI,33,23,15,0,0,38,26,11,0,0,37
2020,52035,Torrita di Siena,SI,34,30,13,0,0,43,18,15,0,0,33
2020,52035,Torrita di Siena,SI,35,33,17,1,0,51,22,14,0,0,36
2020,52035,Torrita di Siena,SI,36,22,11,0,0,33,11,28,0,0,39
2020,52035,Torrita di Siena,SI,37,17,15,0,0,32,12,16,1,0,29
2020,52035,Torrita di Siena,SI,38,22,20,1,0,43,18,38,3,0,59
2020,52035,Torrita di Siena,SI,39,17,14,1,0,32,15,20,1,0,36
2020,52035,Torrita di Siena,SI,40,20,35,0,0,55,15,38,0,0,53
2020,52035,Torrita di Siena,SI,41,24,25,0,0,49,13,32,5,0,50
2020,52035,Torrita di Siena,SI,42,18,23,1,0,42,25,43,4,1,73
2020,52035,Torrita di Siena,SI,43,19,21,1,0,41,13,36,1,0,50
2020,52035,Torrita di Siena,SI,44,23,38,4,0,65,11,28,1,1,41
2020,52035,Torrita di Siena,SI,45,20,36,1,0,57,11,43,3,1,58
2020,52035,Torrita di Siena,SI,46,15,38,2,0,55,12,44,2,0,58
2020,52035,Torrita di Siena,SI,47,16,35,2,1,54,12,40,5,0,57
2020,52035,Torrita di Siena,SI,48,21,35,4,0,60,8,48,2,1,59
2020,52035,Torrita di Siena,SI,49,17,34,4,0,55,10,33,1,2,46
2020,52035,Torrita di Siena,SI,50,19,44,1,1,65,6,36,3,1,46
2020,52035,Torrita di Siena,SI,51,3,37,2,1,43,5,47,4,1,57
2020,52035,Torrita di Siena,SI,52,12,40,2,0,54,10,33,3,2,48
2020,52035,Torrita di Siena,SI,53,14,39,1,2,56,10,43,6,0,59
2020,52035,Torrita di Siena,SI,54,10,39,3,0,52,4,47,4,2,57
2020,52035,Torrita di Siena,SI,55,6,29,3,0,38,3,43,3,1,50
2020,52035,Torrita di Siena,SI,56,9,38,4,0,51,6,36,3,2,47
2020,52035,Torrita di Siena,SI,57,7,40,5,0,52,5,38,7,0,50
2020,52035,Torrita di Siena,SI,58,5,21,4,1,31,3,41,1,5,50
2020,52035,Torrita di Siena,SI,59,2,45,1,0,48,5,36,4,2,47
2020,52035,Torrita di Siena,SI,60,8,29,3,1,41,3,43,4,5,55
2020,52035,Torrita di Siena,SI,61,7,50,0,1,58,2,43,1,6,52
2020,52035,Torrita di Siena,SI,62,5,45,1,0,51,1,41,3,3,48
2020,52035,Torrita di Siena,SI,63,2,36,3,0,41,10,35,2,6,53
2020,52035,Torrita di Siena,SI,64,2,46,0,1,49,4,37,2,3,46
2020,52035,Torrita di Siena,SI,65,7,43,2,1,53,2,44,3,2,51
2020,52035,Torrita di Siena,SI,66,3,39,1,3,46,1,51,1,8,61
2020,52035,Torrita di Siena,SI,67,3,35,2,0,40,0,31,3,7,41
2020,52035,Torrita di Siena,SI,68,2,28,1,4,35,3,40,3,7,53
2020,52035,Torrita di Siena,SI,69,4,33,1,0,38,2,42,0,10,54
2020,52035,Torrita di Siena,SI,70,4,44,1,1,50,3,45,0,8,56
2020,52035,Torrita di Siena,SI,71,4,44,2,0,50,0,33,3,8,44
2020,52035,Torrita di Siena,SI,72,4,49,1,5,59,0,46,3,9,58
2020,52035,Torrita di Siena,SI,73,3,41,1,3,48,2,47,0,12,61
2020,52035,Torrita di Siena,SI,74,1,39,1,3,44,2,38,0,16,56
2020,52035,Torrita di Siena,SI,75,2,25,2,1,30,2,20,1,8,31
2020,52035,Torrita di Siena,SI,76,5,35,0,0,40,1,14,0,8,23
2020,52035,Torrita di Siena,SI,77,1,31,0,2,34,1,15,1,19,36
2020,52035,Torrita di Siena,SI,78,3,25,0,2,30,4,11,0,14,29
2020,52035,Torrita di Siena,SI,79,1,19,2,1,23,0,14,1,18,33
2020,52035,Torrita di Siena,SI,80,2,22,0,7,31,0,27,1,14,42
2020,52035,Torrita di Siena,SI,81,1,29,0,4,34,0,18,0,19,37
2020,52035,Torrita di Siena,SI,82,2,21,1,3,27,0,7,0,31,38
2020,52035,Torrita di Siena,SI,83,0,21,0,5,26,0,17,1,27,45
2020,52035,Torrita di Siena,SI,84,0,20,0,1,21,1,10,0,21,32
2020,52035,Torrita di Siena,SI,85,2,12,0,4,18,1,9,0,21,31
2020,52035,Torrita di Siena,SI,86,1,19,0,3,23,1,8,1,16,26
2020,52035,Torrita di Siena,SI,87,3,13,0,5,21,0,4,0,23,27
2020,52035,Torrita di Siena,SI,88,1,6,0,8,15,1,2,0,24,27
2020,52035,Torrita di Siena,SI,89,2,17,0,3,22,0,3,0,17,20
2020,52035,Torrita di Siena,SI,90,1,4,0,2,7,0,4,1,15,20
2020,52035,Torrita di Siena,SI,91,0,4,0,1,5,1,3,0,12,16
2020,52035,Torrita di Siena,SI,92,1,5,0,3,9,0,0,0,11,11
2020,52035,Torrita di Siena,SI,93,0,1,0,0,1,1,0,0,16,17
2020,52035,Torrita di Siena,SI,94,0,1,0,2,3,1,0,0,14,15
2020,52035,Torrita di Siena,SI,95,0,0,0,4,4,0,0,0,5,5
2020,52035,Torrita di Siena,SI,96,0,0,0,2,2,0,0,0,11,11
2020,52035,Torrita di Siena,SI,97,0,0,0,1,1,0,0,0,3,3
2020,52035,Torrita di Siena,SI,98,0,0,0,1,1,1,0,0,6,7
2020,52035,Torrita di Siena,SI,99,0,0,0,0,0,0,0,0,0,0
2020,52035,Torrita di Siena,SI,100 e più,0,0,0,0,0,0,0,0,6,6
2020,52036,Trequanda,SI,0,0,0,0,0,0,3,0,0,0,3
2020,52036,Trequanda,SI,1,4,0,0,0,4,2,0,0,0,2
2020,52036,Trequanda,SI,2,1,0,0,0,1,2,0,0,0,2
2020,52036,Trequanda,SI,3,4,0,0,0,4,4,0,0,0,4
2020,52036,Trequanda,SI,4,3,0,0,0,3,3,0,0,0,3
2020,52036,Trequanda,SI,5,4,0,0,0,4,4,0,0,0,4
2020,52036,Trequanda,SI,6,4,0,0,0,4,6,0,0,0,6
2020,52036,Trequanda,SI,7,4,0,0,0,4,2,0,0,0,2
2020,52036,Trequanda,SI,8,3,0,0,0,3,3,0,0,0,3
2020,52036,Trequanda,SI,9,7,0,0,0,7,3,0,0,0,3
2020,52036,Trequanda,SI,10,8,0,0,0,8,6,0,0,0,6
2020,52036,Trequanda,SI,11,5,0,0,0,5,3,0,0,0,3
2020,52036,Trequanda,SI,12,7,0,0,0,7,5,0,0,0,5
2020,52036,Trequanda,SI,13,3,0,0,0,3,1,0,0,0,1
2020,52036,Trequanda,SI,14,6,0,0,0,6,5,0,0,0,5
2020,52036,Trequanda,SI,15,5,0,0,0,5,7,0,0,0,7
2020,52036,Trequanda,SI,16,6,0,0,0,6,3,0,0,0,3
2020,52036,Trequanda,SI,17,7,0,0,0,7,2,0,0,0,2
2020,52036,Trequanda,SI,18,7,0,0,0,7,2,0,0,0,2
2020,52036,Trequanda,SI,19,4,0,0,0,4,1,0,0,0,1
2020,52036,Trequanda,SI,20,6,0,0,0,6,5,0,0,0,5
2020,52036,Trequanda,SI,21,6,0,0,0,6,11,0,0,0,11
2020,52036,Trequanda,SI,22,2,0,0,0,2,5,0,0,0,5
2020,52036,Trequanda,SI,23,3,0,0,0,3,4,0,0,0,4
2020,52036,Trequanda,SI,24,8,0,0,0,8,9,0,0,0,9
2020,52036,Trequanda,SI,25,5,0,0,0,5,5,0,0,0,5
2020,52036,Trequanda,SI,26,6,0,0,0,6,1,1,0,0,2
2020,52036,Trequanda,SI,27,4,0,0,0,4,2,0,0,0,2
2020,52036,Trequanda,SI,28,6,0,0,0,6,2,0,0,0,2
2020,52036,Trequanda,SI,29,6,0,0,0,6,3,0,0,0,3
2020,52036,Trequanda,SI,30,6,0,0,0,6,5,2,0,0,7
2020,52036,Trequanda,SI,31,4,1,0,0,5,5,0,0,0,5
2020,52036,Trequanda,SI,32,3,0,0,0,3,3,2,0,0,5
2020,52036,Trequanda,SI,33,6,0,0,0,6,3,1,0,0,4
2020,52036,Trequanda,SI,34,3,3,0,0,6,2,1,0,0,3
2020,52036,Trequanda,SI,35,7,1,0,0,8,1,3,0,0,4
2020,52036,Trequanda,SI,36,1,3,0,0,4,2,4,0,0,6
2020,52036,Trequanda,SI,37,3,2,0,0,5,1,3,0,0,4
2020,52036,Trequanda,SI,38,3,2,0,0,5,1,3,0,0,4
2020,52036,Trequanda,SI,39,1,4,0,0,5,3,4,0,0,7
2020,52036,Trequanda,SI,40,3,3,0,0,6,2,4,0,1,7
2020,52036,Trequanda,SI,41,2,2,0,0,4,3,6,0,0,9
2020,52036,Trequanda,SI,42,4,5,0,0,9,7,3,1,0,11
2020,52036,Trequanda,SI,43,3,2,0,0,5,1,6,0,0,7
2020,52036,Trequanda,SI,44,2,7,0,0,9,4,3,1,0,8
2020,52036,Trequanda,SI,45,7,0,1,0,8,4,3,3,0,10
2020,52036,Trequanda,SI,46,8,3,0,0,11,3,6,0,1,10
2020,52036,Trequanda,SI,47,0,2,0,0,2,2,2,0,0,4
2020,52036,Trequanda,SI,48,1,8,0,0,9,4,6,0,0,10
2020,52036,Trequanda,SI,49,2,7,0,0,9,1,9,1,0,11
2020,52036,Trequanda,SI,50,6,4,0,0,10,5,7,1,0,13
2020,52036,Trequanda,SI,51,3,11,0,0,14,1,5,2,0,8
2020,52036,Trequanda,SI,52,2,3,1,0,6,4,9,2,0,15
2020,52036,Trequanda,SI,53,1,13,1,1,16,1,13,0,0,14
2020,52036,Trequanda,SI,54,2,7,2,0,11,0,5,1,0,6
2020,52036,Trequanda,SI,55,4,9,0,0,13,2,9,1,1,13
2020,52036,Trequanda,SI,56,4,6,0,0,10,1,9,0,1,11
2020,52036,Trequanda,SI,57,1,9,1,0,11,1,2,2,0,5
2020,52036,Trequanda,SI,58,0,3,0,0,3,0,6,2,1,9
2020,52036,Trequanda,SI,59,2,4,3,0,9,1,7,0,2,10
2020,52036,Trequanda,SI,60,0,12,0,0,12,0,6,1,2,9
2020,52036,Trequanda,SI,61,2,4,1,0,7,1,10,0,0,11
2020,52036,Trequanda,SI,62,0,9,0,0,9,0,8,1,0,9
2020,52036,Trequanda,SI,63,1,11,0,0,12,0,7,2,0,9
2020,52036,Trequanda,SI,64,1,6,1,0,8,0,5,0,0,5
2020,52036,Trequanda,SI,65,0,7,0,0,7,0,5,0,1,6
2020,52036,Trequanda,SI,66,2,4,1,1,8,4,5,0,0,9
2020,52036,Trequanda,SI,67,0,6,0,0,6,1,4,0,0,5
2020,52036,Trequanda,SI,68,1,2,0,1,4,2,6,2,1,11
2020,52036,Trequanda,SI,69,2,5,1,0,8,0,9,0,0,9
2020,52036,Trequanda,SI,70,1,8,0,1,10,0,8,0,0,8
2020,52036,Trequanda,SI,71,3,8,0,0,11,0,5,0,2,7
2020,52036,Trequanda,SI,72,1,9,0,1,11,0,14,0,2,16
2020,52036,Trequanda,SI,73,0,13,0,3,16,0,8,0,3,11
2020,52036,Trequanda,SI,74,0,8,1,0,9,0,10,0,4,14
2020,52036,Trequanda,SI,75,0,6,0,1,7,0,11,0,2,13
2020,52036,Trequanda,SI,76,1,4,0,0,5,0,1,0,1,2
2020,52036,Trequanda,SI,77,1,6,0,0,7,0,4,0,5,9
2020,52036,Trequanda,SI,78,1,6,0,1,8,0,6,1,3,10
2020,52036,Trequanda,SI,79,1,4,0,2,7,0,2,0,5,7
2020,52036,Trequanda,SI,80,2,5,0,1,8,1,3,0,2,6
2020,52036,Trequanda,SI,81,1,6,1,0,8,0,4,0,3,7
2020,52036,Trequanda,SI,82,1,5,0,0,6,1,2,0,3,6
2020,52036,Trequanda,SI,83,0,5,0,2,7,0,3,0,3,6
2020,52036,Trequanda,SI,84,0,3,0,1,4,0,1,0,6,7
2020,52036,Trequanda,SI,85,0,1,0,0,1,0,0,0,8,8
2020,52036,Trequanda,SI,86,0,4,0,1,5,1,1,0,1,3
2020,52036,Trequanda,SI,87,1,1,0,1,3,0,1,0,3,4
2020,52036,Trequanda,SI,88,0,1,0,0,1,0,1,0,4,5
2020,52036,Trequanda,SI,89,1,2,0,1,4,0,0,0,0,0
2020,52036,Trequanda,SI,90,0,2,0,2,4,0,0,0,1,1
2020,52036,Trequanda,SI,91,0,0,0,0,0,1,0,0,0,1
2020,52036,Trequanda,SI,92,0,1,0,0,1,0,0,0,2,2
2020,52036,Trequanda,SI,93,0,1,0,0,1,0,1,0,2,3
2020,52036,Trequanda,SI,94,0,1,0,1,2,0,0,0,2,2
2020,52036,Trequanda,SI,95,0,0,0,0,0,0,1,1,1,3
2020,52036,Trequanda,SI,96,0,1,0,1,2,0,0,0,2,2
2020,52036,Trequanda,SI,97,0,0,0,0,0,0,0,0,0,0
2020,52036,Trequanda,SI,98,0,0,0,0,0,0,0,0,0,0
2020,52036,Trequanda,SI,99,0,0,0,1,1,0,0,0,0,0
2020,52036,Trequanda,SI,100 e più,0,0,0,0,0,0,0,0,0,0
2020,52037,Montalcino,SI,0,27,0,0,0,27,12,0,0,0,12
2020,52037,Montalcino,SI,1,26,0,0,0,26,17,0,0,0,17
2020,52037,Montalcino,SI,2,24,0,0,0,24,26,0,0,0,26
2020,52037,Montalcino,SI,3,22,0,0,0,22,18,0,0,0,18
2020,52037,Montalcino,SI,4,17,0,0,0,17,15,0,0,0,15
2020,52037,Montalcino,SI,5,19,0,0,0,19,24,0,0,0,24
2020,52037,Montalcino,SI,6,28,0,0,0,28,22,0,0,0,22
2020,52037,Montalcino,SI,7,18,0,0,0,18,24,0,0,0,24
2020,52037,Montalcino,SI,8,21,0,0,0,21,28,0,0,0,28
2020,52037,Montalcino,SI,9,26,0,0,0,26,19,0,0,0,19
2020,52037,Montalcino,SI,10,27,0,0,0,27,26,0,0,0,26
2020,52037,Montalcino,SI,11,24,0,0,0,24,28,0,0,0,28
2020,52037,Montalcino,SI,12,33,0,0,0,33,22,0,0,0,22
2020,52037,Montalcino,SI,13,25,0,0,0,25,18,0,0,0,18
2020,52037,Montalcino,SI,14,25,0,0,0,25,24,0,0,0,24
2020,52037,Montalcino,SI,15,31,0,0,0,31,28,0,0,0,28
2020,52037,Montalcino,SI,16,23,0,0,0,23,23,0,0,0,23
2020,52037,Montalcino,SI,17,19,0,0,0,19,18,0,0,0,18
2020,52037,Montalcino,SI,18,17,0,0,0,17,23,0,0,0,23
2020,52037,Montalcino,SI,19,20,0,0,0,20,17,1,0,0,18
2020,52037,Montalcino,SI,20,33,0,0,0,33,31,1,0,0,32
2020,52037,Montalcino,SI,21,18,0,0,0,18,25,0,0,0,25
2020,52037,Montalcino,SI,22,23,0,0,0,23,23,1,0,0,24
2020,52037,Montalcino,SI,23,22,1,0,0,23,18,2,0,0,20
2020,52037,Montalcino,SI,24,30,0,0,0,30,16,1,0,0,17
2020,52037,Montalcino,SI,25,28,3,0,0,31,12,4,0,0,16
2020,52037,Montalcino,SI,26,29,0,0,0,29,13,4,0,0,17
2020,52037,Montalcino,SI,27,26,4,0,0,30,19,2,0,0,21
2020,52037,Montalcino,SI,28,24,1,0,0,25,12,5,0,0,17
2020,52037,Montalcino,SI,29,24,3,0,0,27,22,12,0,0,34
2020,52037,Montalcino,SI,30,28,4,0,0,32,11,15,1,0,27
2020,52037,Montalcino,SI,31,22,5,0,0,27,18,6,0,0,24
2020,52037,Montalcino,SI,32,19,10,0,0,29,23,9,0,0,32
2020,52037,Montalcino,SI,33,19,11,0,0,30,17,8,0,0,25
2020,52037,Montalcino,SI,34,20,10,1,0,31,14,19,1,0,34
2020,52037,Montalcino,SI,35,18,16,0,0,34,13,18,1,0,32
2020,52037,Montalcino,SI,36,26,13,0,0,39,14,22,0,0,36
2020,52037,Montalcino,SI,37,21,12,1,0,34,17,19,1,0,37
2020,52037,Montalcino,SI,38,23,12,0,0,35,16,19,0,0,35
2020,52037,Montalcino,SI,39,14,17,1,1,33,9,15,1,0,25
2020,52037,Montalcino,SI,40,14,19,0,0,33,10,23,1,0,34
2020,52037,Montalcino,SI,41,8,18,0,0,26,11,25,2,0,38
2020,52037,Montalcino,SI,42,14,21,1,1,37,9,23,1,0,33
2020,52037,Montalcino,SI,43,20,23,2,0,45,15,23,1,1,40
2020,52037,Montalcino,SI,44,14,24,2,0,40,11,35,2,0,48
2020,52037,Montalcino,SI,45,21,26,1,1,49,15,19,3,0,37
2020,52037,Montalcino,SI,46,15,22,3,0,40,8,25,3,0,36
2020,52037,Montalcino,SI,47,16,17,2,0,35,11,30,4,0,45
2020,52037,Montalcino,SI,48,21,29,2,0,52,7,30,3,1,41
2020,52037,Montalcino,SI,49,16,34,5,0,55,11,41,1,0,53
2020,52037,Montalcino,SI,50,11,41,2,0,54,7,34,1,1,43
2020,52037,Montalcino,SI,51,7,32,1,1,41,15,25,3,1,44
2020,52037,Montalcino,SI,52,10,43,0,0,53,11,38,2,1,52
2020,52037,Montalcino,SI,53,18,28,1,0,47,7,33,5,0,45
2020,52037,Montalcino,SI,54,20,32,2,0,54,5,31,4,0,40
2020,52037,Montalcino,SI,55,7,29,3,1,40,6,28,1,2,37
2020,52037,Montalcino,SI,56,9,31,2,1,43,8,33,4,1,46
2020,52037,Montalcino,SI,57,9,30,1,0,40,3,30,5,2,40
2020,52037,Montalcino,SI,58,11,34,0,0,45,6,30,2,1,39
2020,52037,Montalcino,SI,59,11,29,5,0,45,5,32,1,5,43
2020,52037,Montalcino,SI,60,5,36,4,0,45,3,29,5,4,41
2020,52037,Montalcino,SI,61,5,30,1,0,36,3,30,3,5,41
2020,52037,Montalcino,SI,62,3,21,1,0,25,2,31,2,8,43
2020,52037,Montalcino,SI,63,4,25,0,0,29,1,17,1,5,24
2020,52037,Montalcino,SI,64,4,22,0,0,26,4,24,2,6,36
2020,52037,Montalcino,SI,65,4,23,3,3,33,6,31,2,7,46
2020,52037,Montalcino,SI,66,3,27,3,1,34,3,25,4,10,42
2020,52037,Montalcino,SI,67,5,21,1,0,27,4,26,2,3,35
2020,52037,Montalcino,SI,68,2,38,2,2,44,2,31,2,8,43
2020,52037,Montalcino,SI,69,4,24,2,1,31,0,26,1,9,36
2020,52037,Montalcino,SI,70,5,23,3,3,34,2,20,1,8,31
2020,52037,Montalcino,SI,71,8,24,0,0,32,2,26,1,2,31
2020,52037,Montalcino,SI,72,1,30,0,3,34,1,22,4,10,37
2020,52037,Montalcino,SI,73,2,34,1,1,38,1,24,0,11,36
2020,52037,Montalcino,SI,74,3,26,2,2,33,3,21,2,12,38
2020,52037,Montalcino,SI,75,6,26,1,5,38,1,14,1,12,28
2020,52037,Montalcino,SI,76,3,15,1,0,19,0,15,1,12,28
2020,52037,Montalcino,SI,77,5,17,2,4,28,1,16,0,10,27
2020,52037,Montalcino,SI,78,2,23,0,1,26,1,10,1,12,24
2020,52037,Montalcino,SI,79,3,8,1,3,15,1,18,0,12,31
2020,52037,Montalcino,SI,80,2,31,0,0,33,0,14,1,21,36
2020,52037,Montalcino,SI,81,1,13,1,1,16,2,16,0,11,29
2020,52037,Montalcino,SI,82,2,17,0,1,20,1,6,0,19,26
2020,52037,Montalcino,SI,83,3,11,0,4,18,2,14,0,27,43
2020,52037,Montalcino,SI,84,0,19,0,3,22,1,7,0,22,30
2020,52037,Montalcino,SI,85,2,10,0,2,14,0,7,0,18,25
2020,52037,Montalcino,SI,86,3,13,0,4,20,0,5,1,18,24
2020,52037,Montalcino,SI,87,2,16,0,5,23,3,7,0,20,30
2020,52037,Montalcino,SI,88,2,6,0,4,12,0,2,0,23,25
2020,52037,Montalcino,SI,89,4,10,0,2,16,1,3,0,18,22
2020,52037,Montalcino,SI,90,0,5,0,1,6,0,1,1,18,20
2020,52037,Montalcino,SI,91,1,2,0,1,4,1,1,0,10,12
2020,52037,Montalcino,SI,92,0,3,0,1,4,1,0,0,14,15
2020,52037,Montalcino,SI,93,1,2,0,0,3,0,2,0,14,16
2020,52037,Montalcino,SI,94,0,3,0,0,3,0,1,0,9,10
2020,52037,Montalcino,SI,95,0,1,0,1,2,0,1,0,5,6
2020,52037,Montalcino,SI,96,1,1,0,1,3,0,0,0,5,5
2020,52037,Montalcino,SI,97,0,1,0,0,1,0,0,0,5,5
2020,52037,Montalcino,SI,98,0,0,0,0,0,0,0,0,4,4
2020,52037,Montalcino,SI,99,0,0,0,1,1,0,1,0,5,6
2020,52037,Montalcino,SI,100 e più,0,1,0,1,2,0,0,0,0,0
2020,51001,Anghiari,AR,0,18,0,0,0,18,17,0,0,0,17
2020,51001,Anghiari,AR,1,8,0,0,0,8,23,0,0,0,23
2020,51001,Anghiari,AR,2,22,0,0,0,22,24,0,0,0,24
2020,51001,Anghiari,AR,3,18,0,0,0,18,22,0,0,0,22
2020,51001,Anghiari,AR,4,21,0,0,0,21,16,0,0,0,16
2020,51001,Anghiari,AR,5,20,0,0,0,20,26,0,0,0,26
2020,51001,Anghiari,AR,6,26,0,0,0,26,18,0,0,0,18
2020,51001,Anghiari,AR,7,16,0,0,0,16,21,0,0,0,21
2020,51001,Anghiari,AR,8,21,0,0,0,21,17,0,0,0,17
2020,51001,Anghiari,AR,9,28,0,0,0,28,18,0,0,0,18
2020,51001,Anghiari,AR,10,25,0,0,0,25,15,0,0,0,15
2020,51001,Anghiari,AR,11,21,0,0,0,21,18,0,0,0,18
2020,51001,Anghiari,AR,12,14,0,0,0,14,16,0,0,0,16
2020,51001,Anghiari,AR,13,20,0,0,0,20,24,0,0,0,24
2020,51001,Anghiari,AR,14,20,0,0,0,20,23,0,0,0,23
2020,51001,Anghiari,AR,15,22,0,0,0,22,24,0,0,0,24
2020,51001,Anghiari,AR,16,20,0,0,0,20,27,0,0,0,27
2020,51001,Anghiari,AR,17,29,0,0,0,29,18,0,0,0,18
2020,51001,Anghiari,AR,18,19,0,0,0,19,14,0,0,0,14
2020,51001,Anghiari,AR,19,22,0,0,0,22,23,0,0,0,23
2020,51001,Anghiari,AR,20,17,0,0,0,17,23,0,0,0,23
2020,51001,Anghiari,AR,21,23,0,0,0,23,18,1,0,0,19
2020,51001,Anghiari,AR,22,36,0,0,0,36,18,0,0,0,18
2020,51001,Anghiari,AR,23,21,0,0,0,21,17,2,0,0,19
2020,51001,Anghiari,AR,24,25,1,0,0,26,16,1,0,0,17
2020,51001,Anghiari,AR,25,21,0,0,0,21,13,1,0,0,14
2020,51001,Anghiari,AR,26,23,3,0,0,26,20,3,0,0,23
2020,51001,Anghiari,AR,27,27,1,0,0,28,24,2,0,0,26
2020,51001,Anghiari,AR,28,24,3,0,0,27,23,4,0,0,27
2020,51001,Anghiari,AR,29,16,2,0,0,18,11,5,1,0,17
2020,51001,Anghiari,AR,30,24,5,0,0,29,22,2,0,0,24
2020,51001,Anghiari,AR,31,16,3,0,0,19,14,9,0,0,23
2020,51001,Anghiari,AR,32,18,4,0,0,22,14,14,0,0,28
2020,51001,Anghiari,AR,33,23,10,0,0,33,18,12,2,0,32
2020,51001,Anghiari,AR,34,23,11,1,0,35,9,10,0,0,19
2020,51001,Anghiari,AR,35,23,8,1,0,32,15,8,1,0,24
2020,51001,Anghiari,AR,36,24,13,0,0,37,15,19,1,0,35
2020,51001,Anghiari,AR,37,19,10,0,0,29,8,21,0,0,29
2020,51001,Anghiari,AR,38,20,9,0,0,29,8,14,0,0,22
2020,51001,Anghiari,AR,39,16,14,0,0,30,16,16,3,1,36
2020,51001,Anghiari,AR,40,14,18,1,0,33,12,14,0,0,26
2020,51001,Anghiari,AR,41,23,10,0,0,33,11,27,3,0,41
2020,51001,Anghiari,AR,42,11,21,2,0,34,11,18,0,1,30
2020,51001,Anghiari,AR,43,11,21,2,0,34,9,24,2,0,35
2020,51001,Anghiari,AR,44,18,22,1,0,41,10,20,3,0,33
2020,51001,Anghiari,AR,45,17,22,1,0,40,11,22,4,0,37
2020,51001,Anghiari,AR,46,14,17,5,0,36,7,23,2,0,32
2020,51001,Anghiari,AR,47,14,27,2,0,43,13,21,4,1,39
2020,51001,Anghiari,AR,48,7,27,5,0,39,12,29,4,0,45
2020,51001,Anghiari,AR,49,13,20,6,0,39,10,24,7,2,43
2020,51001,Anghiari,AR,50,3,31,1,0,35,8,29,4,0,41
2020,51001,Anghiari,AR,51,8,33,3,0,44,7,30,5,0,42
2020,51001,Anghiari,AR,52,5,23,4,0,32,7,28,4,1,40
2020,51001,Anghiari,AR,53,4,23,1,0,28,6,30,6,0,42
2020,51001,Anghiari,AR,54,7,27,3,0,37,7,25,1,1,34
2020,51001,Anghiari,AR,55,7,24,4,0,35,4,29,1,5,39
2020,51001,Anghiari,AR,56,7,29,7,1,44,6,34,6,2,48
2020,51001,Anghiari,AR,57,9,30,2,1,42,2,30,3,1,36
2020,51001,Anghiari,AR,58,8,27,0,0,35,6,43,3,3,55
2020,51001,Anghiari,AR,59,5,28,6,1,40,2,41,1,3,47
2020,51001,Anghiari,AR,60,8,41,0,0,49,5,42,4,4,55
2020,51001,Anghiari,AR,61,3,32,5,0,40,3,31,4,4,42
2020,51001,Anghiari,AR,62,2,33,4,1,40,2,31,3,0,36
2020,51001,Anghiari,AR,63,5,33,1,1,40,6,31,3,6,46
2020,51001,Anghiari,AR,64,4,38,2,1,45,5,29,1,2,37
2020,51001,Anghiari,AR,65,5,32,1,1,39,5,23,3,7,38
2020,51001,Anghiari,AR,66,5,32,3,2,42,1,27,3,8,39
2020,51001,Anghiari,AR,67,3,29,2,0,34,2,34,3,5,44
2020,51001,Anghiari,AR,68,2,30,0,1,33,3,28,1,3,35
2020,51001,Anghiari,AR,69,4,18,2,3,27,2,29,1,6,38
2020,51001,Anghiari,AR,70,6,25,4,1,36,1,25,2,6,34
2020,51001,Anghiari,AR,71,4,40,3,2,49,0,34,5,7,46
2020,51001,Anghiari,AR,72,2,39,1,2,44,3,33,5,9,50
2020,51001,Anghiari,AR,73,7,23,1,4,35,0,33,2,10,45
2020,51001,Anghiari,AR,74,0,36,0,3,39,3,26,1,5,35
2020,51001,Anghiari,AR,75,1,17,0,2,20,2,22,2,12,38
2020,51001,Anghiari,AR,76,2,21,1,3,27,1,24,3,8,36
2020,51001,Anghiari,AR,77,4,18,0,3,25,2,20,0,11,33
2020,51001,Anghiari,AR,78,4,25,1,4,34,0,14,0,6,20
2020,51001,Anghiari,AR,79,1,20,0,5,26,5,7,2,9,23
2020,51001,Anghiari,AR,80,1,21,1,3,26,0,16,0,14,30
2020,51001,Anghiari,AR,81,0,24,4,6,34,0,19,0,17,36
2020,51001,Anghiari,AR,82,3,28,1,3,35,0,21,0,13,34
2020,51001,Anghiari,AR,83,1,21,1,0,23,1,7,0,13,21
2020,51001,Anghiari,AR,84,4,10,2,2,18,2,8,0,13,23
2020,51001,Anghiari,AR,85,1,19,0,0,20,0,9,0,23,32
2020,51001,Anghiari,AR,86,0,10,2,2,14,1,2,0,17,20
2020,51001,Anghiari,AR,87,3,7,0,0,10,0,7,0,21,28
2020,51001,Anghiari,AR,88,1,5,0,2,8,0,2,0,13,15
2020,51001,Anghiari,AR,89,1,7,1,4,13,0,4,0,18,22
2020,51001,Anghiari,AR,90,0,4,0,4,8,2,1,0,17,20
2020,51001,Anghiari,AR,91,1,6,0,2,9,0,1,0,10,11
2020,51001,Anghiari,AR,92,1,3,0,4,8,2,0,0,12,14
2020,51001,Anghiari,AR,93,0,5,0,1,6,0,0,0,12,12
2020,51001,Anghiari,AR,94,0,1,0,0,1,0,0,0,3,3
2020,51001,Anghiari,AR,95,0,0,0,0,0,1,0,0,7,8
2020,51001,Anghiari,AR,96,0,0,0,0,0,0,0,0,3,3
2020,51001,Anghiari,AR,97,0,0,0,2,2,2,0,0,4,6
2020,51001,Anghiari,AR,98,0,0,0,1,1,0,0,0,1,1
2020,51001,Anghiari,AR,99,0,0,0,0,0,0,0,0,1,1
2020,51001,Anghiari,AR,100 e più,0,0,0,0,0,0,0,0,2,2
2020,51002,Arezzo,AR,0,321,0,0,0,321,319,0,0,0,319
2020,51002,Arezzo,AR,1,332,0,0,0,332,325,0,0,0,325
2020,51002,Arezzo,AR,2,313,0,0,0,313,318,0,0,0,318
2020,51002,Arezzo,AR,3,353,0,0,0,353,331,0,0,0,331
2020,51002,Arezzo,AR,4,347,0,0,0,347,384,0,0,0,384
2020,51002,Arezzo,AR,5,397,0,0,0,397,367,0,0,0,367
2020,51002,Arezzo,AR,6,360,0,0,0,360,365,0,0,0,365
2020,51002,Arezzo,AR,7,404,0,0,0,404,361,0,0,0,361
2020,51002,Arezzo,AR,8,418,0,0,0,418,378,0,0,0,378
2020,51002,Arezzo,AR,9,425,0,0,0,425,423,0,0,0,423
2020,51002,Arezzo,AR,10,463,0,0,0,463,403,0,0,0,403
2020,51002,Arezzo,AR,11,447,0,0,0,447,377,0,0,0,377
2020,51002,Arezzo,AR,12,444,0,0,0,444,417,0,0,0,417
2020,51002,Arezzo,AR,13,458,0,0,0,458,433,0,0,0,433
2020,51002,Arezzo,AR,14,439,0,0,0,439,432,0,0,0,432
2020,51002,Arezzo,AR,15,454,0,0,0,454,400,0,0,0,400
2020,51002,Arezzo,AR,16,424,0,0,0,424,477,0,0,0,477
2020,51002,Arezzo,AR,17,419,0,0,0,419,405,0,0,0,405
2020,51002,Arezzo,AR,18,463,0,0,0,463,423,0,0,0,423
2020,51002,Arezzo,AR,19,481,0,0,0,481,406,1,0,0,407
2020,51002,Arezzo,AR,20,456,2,0,0,458,412,7,0,0,419
2020,51002,Arezzo,AR,21,469,1,0,0,470,423,8,0,0,431
2020,51002,Arezzo,AR,22,507,2,0,0,509,388,13,0,0,401
2020,51002,Arezzo,AR,23,477,4,0,0,481,400,12,0,0,412
2020,51002,Arezzo,AR,24,519,6,0,0,525,403,26,0,0,429
2020,51002,Arezzo,AR,25,491,7,0,0,498,415,40,1,0,456
2020,51002,Arezzo,AR,26,434,19,0,0,454,382,40,0,0,422
2020,51002,Arezzo,AR,27,429,18,1,0,448,397,62,0,0,459
2020,51002,Arezzo,AR,28,477,27,0,0,504,397,58,2,1,458
2020,51002,Arezzo,AR,29,496,44,0,0,540,363,86,2,0,451
2020,51002,Arezzo,AR,30,470,81,0,0,553,340,155,4,2,501
2020,51002,Arezzo,AR,31,445,90,3,0,539,335,139,5,0,479
2020,51002,Arezzo,AR,32,469,103,1,1,574,341,158,4,0,503
2020,51002,Arezzo,AR,33,413,139,1,0,553,307,230,7,1,545
2020,51002,Arezzo,AR,34,385,161,3,0,549,314,202,7,0,523
2020,51002,Arezzo,AR,35,358,183,5,1,548,275,266,8,1,550
2020,51002,Arezzo,AR,36,380,212,10,0,604,292,283,16,1,592
2020,51002,Arezzo,AR,37,347,233,8,1,589,224,292,20,0,536
2020,51002,Arezzo,AR,38,346,245,13,1,606,225,339,15,1,580
2020,51002,Arezzo,AR,39,258,277,11,1,548,197,299,15,0,511
2020,51002,Arezzo,AR,40,289,338,12,0,640,188,356,23,7,574
2020,51002,Arezzo,AR,41,240,351,20,0,611,220,363,33,8,624
2020,51002,Arezzo,AR,42,257,315,14,5,591,229,381,48,3,661
2020,51002,Arezzo,AR,43,273,375,24,1,673,202,438,68,9,718
2020,51002,Arezzo,AR,44,256,389,23,0,669,180,458,71,5,715
2020,51002,Arezzo,AR,45,252,417,35,1,707,192,477,66,8,744
2020,51002,Arezzo,AR,46,239,460,46,5,750,180,499,61,10,750
2020,51002,Arezzo,AR,47,223,467,37,3,730,174,583,78,10,846
2020,51002,Arezzo,AR,48,202,505,40,5,752,165,585,77,14,842
2020,51002,Arezzo,AR,49,222,491,57,7,779,158,585,79,10,832
2020,51002,Arezzo,AR,50,190,535,52,2,779,146,576,73,15,810
2020,51002,Arezzo,AR,51,175,525,65,1,767,134,590,86,19,829
2020,51002,Arezzo,AR,52,145,491,53,2,692,129,569,85,19,802
2020,51002,Arezzo,AR,53,155,534,58,4,752,132,574,100,27,833
2020,51002,Arezzo,AR,54,178,525,68,7,779,116,554,92,34,796
2020,51002,Arezzo,AR,55,115,620,62,6,804,110,606,83,22,821
2020,51002,Arezzo,AR,56,136,584,73,9,802,97,593,108,26,824
2020,51002,Arezzo,AR,57,121,504,57,9,691,78,529,86,30,723
2020,51002,Arezzo,AR,58,96,521,58,7,682,53,548,85,45,731
2020,51002,Arezzo,AR,59,94,497,54,11,656,73,525,108,45,751
2020,51002,Arezzo,AR,60,75,508,56,10,651,54,591,82,38,765
2020,51002,Arezzo,AR,61,68,476,44,17,605,61,512,76,42,691
2020,51002,Arezzo,AR,62,72,456,43,9,580,40,540,70,58,708
2020,51002,Arezzo,AR,63,48,490,48,12,599,50,485,48,40,623
2020,51002,Arezzo,AR,64,49,468,42,17,576,48,501,65,74,688
2020,51002,Arezzo,AR,65,45,458,34,12,549,37,474,51,62,624
2020,51002,Arezzo,AR,66,49,443,38,24,554,40,486,51,78,655
2020,51002,Arezzo,AR,67,36,433,31,12,512,45,457,42,88,632
2020,51002,Arezzo,AR,68,40,427,28,15,510,29,404,50,73,556
2020,51002,Arezzo,AR,69,37,437,29,27,530,35,436,41,97,609
2020,51002,Arezzo,AR,70,34,440,17,28,519,38,410,42,98,588
2020,51002,Arezzo,AR,71,38,498,24,27,587,38,506,32,132,708
2020,51002,Arezzo,AR,72,35,525,27,40,627,35,514,36,144,729
2020,51002,Arezzo,AR,73,43,481,19,43,586,39,457,37,162,695
2020,51002,Arezzo,AR,74,31,470,18,49,569,43,414,29,175,661
2020,51002,Arezzo,AR,75,20,352,18,40,430,21,321,21,159,522
2020,51002,Arezzo,AR,76,10,329,10,37,386,23,268,19,163,473
2020,51002,Arezzo,AR,77,17,372,12,49,450,27,304,17,180,528
2020,51002,Arezzo,AR,78,20,334,16,31,401,18,273,21,210,522
2020,51002,Arezzo,AR,79,18,324,3,41,386,21,278,11,202,512
2020,51002,Arezzo,AR,80,24,335,7,66,432,23,243,18,288,572
2020,51002,Arezzo,AR,81,19,281,7,52,359,26,221,15,255,517
2020,51002,Arezzo,AR,82,20,305,4,58,387,21,202,9,301,533
2020,51002,Arezzo,AR,83,10,235,9,49,303,21,177,7,291,496
2020,51002,Arezzo,AR,84,23,228,4,61,316,19,120,10,243,392
2020,51002,Arezzo,AR,85,10,207,4,54,275,15,125,9,282,431
2020,51002,Arezzo,AR,86,10,151,4,61,226,21,81,8,231,341
2020,51002,Arezzo,AR,87,8,131,2,60,201,16,63,3,243,325
2020,51002,Arezzo,AR,88,7,97,1,47,152,11,46,1,229,287
2020,51002,Arezzo,AR,89,8,107,0,54,169,10,29,2,245,286
2020,51002,Arezzo,AR,90,10,82,1,35,128,12,31,1,211,255
2020,51002,Arezzo,AR,91,4,56,1,45,106,9,16,1,155,181
2020,51002,Arezzo,AR,92,3,46,1,30,80,10,11,3,152,176
2020,51002,Arezzo,AR,93,2,25,1,25,53,16,9,2,129,156
2020,51002,Arezzo,AR,94,3,19,0,18,40,3,4,1,94,102
2020,51002,Arezzo,AR,95,0,10,0,15,25,6,4,1,74,85
2020,51002,Arezzo,AR,96,1,5,1,14,21,5,2,0,43,50
2020,51002,Arezzo,AR,97,0,2,0,6,8,1,1,2,49,53
2020,51002,Arezzo,AR,98,0,4,0,6,10,3,2,0,35,40
2020,51002,Arezzo,AR,99,0,0,0,1,1,3,1,0,18,22
2020,51002,Arezzo,AR,100 e più,1,1,0,6,8,3,0,0,27,30
2020,51003,Badia Tedalda,AR,0,2,0,0,0,2,0,0,0,0,0
2020,51003,Badia Tedalda,AR,1,9,0,0,0,9,2,0,0,0,2
2020,51003,Badia Tedalda,AR,2,4,0,0,0,4,2,0,0,0,2
2020,51003,Badia Tedalda,AR,3,3,0,0,0,3,1,0,0,0,1
2020,51003,Badia Tedalda,AR,4,4,0,0,0,4,0,0,0,0,0
2020,51003,Badia Tedalda,AR,5,4,0,0,0,4,1,0,0,0,1
2020,51003,Badia Tedalda,AR,6,4,0,0,0,4,2,0,0,0,2
2020,51003,Badia Tedalda,AR,7,4,0,0,0,4,0,0,0,0,0
2020,51003,Badia Tedalda,AR,8,3,0,0,0,3,4,0,0,0,4
2020,51003,Badia Tedalda,AR,9,1,0,0,0,1,3,0,0,0,3
2020,51003,Badia Tedalda,AR,10,4,0,0,0,4,4,0,0,0,4
2020,51003,Badia Tedalda,AR,11,2,0,0,0,2,3,0,0,0,3
2020,51003,Badia Tedalda,AR,12,4,0,0,0,4,1,0,0,0,1
2020,51003,Badia Tedalda,AR,13,5,0,0,0,5,3,0,0,0,3
2020,51003,Badia Tedalda,AR,14,0,0,0,0,0,2,0,0,0,2
2020,51003,Badia Tedalda,AR,15,6,0,0,0,6,4,0,0,0,4
2020,51003,Badia Tedalda,AR,16,2,0,0,0,2,1,0,0,0,1
2020,51003,Badia Tedalda,AR,17,1,0,0,0,1,2,0,0,0,2
2020,51003,Badia Tedalda,AR,18,1,0,0,0,1,1,0,0,0,1
2020,51003,Badia Tedalda,AR,19,4,0,0,0,4,4,0,0,0,4
2020,51003,Badia Tedalda,AR,20,3,0,0,0,3,6,0,0,0,6
2020,51003,Badia Tedalda,AR,21,6,0,0,0,6,1,0,0,0,1
2020,51003,Badia Tedalda,AR,22,8,0,0,0,8,1,0,0,0,1
2020,51003,Badia Tedalda,AR,23,3,0,0,0,3,2,0,0,0,2
2020,51003,Badia Tedalda,AR,24,3,0,0,0,3,3,0,0,0,3
2020,51003,Badia Tedalda,AR,25,2,0,0,0,2,2,0,0,0,2
2020,51003,Badia Tedalda,AR,26,5,0,0,0,5,2,0,0,0,2
2020,51003,Badia Tedalda,AR,27,5,0,0,0,5,0,1,0,0,1
2020,51003,Badia Tedalda,AR,28,9,0,0,0,9,4,1,0,0,5
2020,51003,Badia Tedalda,AR,29,8,0,0,0,8,3,0,0,0,3
2020,51003,Badia Tedalda,AR,30,6,1,0,0,7,5,4,0,0,9
2020,51003,Badia Tedalda,AR,31,6,0,0,0,6,1,0,0,0,1
2020,51003,Badia Tedalda,AR,32,7,0,0,1,8,3,1,0,0,4
2020,51003,Badia Tedalda,AR,33,5,0,0,0,5,2,3,0,0,5
2020,51003,Badia Tedalda,AR,34,2,3,0,0,5,1,1,0,0,2
2020,51003,Badia Tedalda,AR,35,2,2,0,0,4,2,1,0,0,3
2020,51003,Badia Tedalda,AR,36,4,0,0,0,4,2,3,0,0,5
2020,51003,Badia Tedalda,AR,37,4,1,0,0,5,4,7,1,0,12
2020,51003,Badia Tedalda,AR,38,4,3,0,0,7,3,0,0,0,3
2020,51003,Badia Tedalda,AR,39,1,1,0,0,2,2,4,0,0,6
2020,51003,Badia Tedalda,AR,40,3,6,0,0,9,1,1,0,0,2
2020,51003,Badia Tedalda,AR,41,1,1,0,0,2,3,5,0,0,8
2020,51003,Badia Tedalda,AR,42,2,4,1,0,7,3,4,0,0,7
2020,51003,Badia Tedalda,AR,43,5,3,0,0,8,0,5,0,0,5
2020,51003,Badia Tedalda,AR,44,1,2,0,0,3,1,3,0,0,4
2020,51003,Badia Tedalda,AR,45,1,4,1,0,6,1,3,1,0,5
2020,51003,Badia Tedalda,AR,46,0,5,0,0,5,1,2,0,0,3
2020,51003,Badia Tedalda,AR,47,1,2,0,0,3,2,3,1,0,6
2020,51003,Badia Tedalda,AR,48,3,4,0,0,7,1,4,0,0,5
2020,51003,Badia Tedalda,AR,49,3,2,0,0,5,2,3,0,1,6
2020,51003,Badia Tedalda,AR,50,1,5,0,0,6,1,8,1,0,10
2020,51003,Badia Tedalda,AR,51,3,4,0,0,7,1,5,0,0,6
2020,51003,Badia Tedalda,AR,52,1,3,1,0,5,1,5,1,0,7
2020,51003,Badia Tedalda,AR,53,1,6,0,0,7,2,4,0,0,6
2020,51003,Badia Tedalda,AR,54,2,5,1,0,8,0,7,2,0,9
2020,51003,Badia Tedalda,AR,55,3,8,1,0,12,0,6,0,1,7
2020,51003,Badia Tedalda,AR,56,4,9,1,0,14,0,6,0,1,7
2020,51003,Badia Tedalda,AR,57,1,2,0,0,3,2,7,0,0,9
2020,51003,Badia Tedalda,AR,58,1,3,0,0,4,0,7,0,0,7
2020,51003,Badia Tedalda,AR,59,4,5,0,0,9,0,5,0,0,5
2020,51003,Badia Tedalda,AR,60,3,9,1,0,13,0,12,1,0,13
2020,51003,Badia Tedalda,AR,61,1,6,0,0,7,1,7,0,0,8
2020,51003,Badia Tedalda,AR,62,1,6,1,0,8,2,10,0,0,12
2020,51003,Badia Tedalda,AR,63,3,4,1,0,8,3,4,0,0,7
2020,51003,Badia Tedalda,AR,64,2,6,0,1,9,0,7,1,0,8
2020,51003,Badia Tedalda,AR,65,1,13,0,1,15,0,10,0,0,10
2020,51003,Badia Tedalda,AR,66,1,10,0,0,11,0,9,0,2,11
2020,51003,Badia Tedalda,AR,67,0,8,0,0,8,1,4,0,1,6
2020,51003,Badia Tedalda,AR,68,1,8,1,0,10,1,4,1,1,7
2020,51003,Badia Tedalda,AR,69,1,5,0,0,6,2,3,1,4,10
2020,51003,Badia Tedalda,AR,70,2,4,0,0,6,0,2,0,2,4
2020,51003,Badia Tedalda,AR,71,2,12,1,0,15,0,3,0,1,4
2020,51003,Badia Tedalda,AR,72,2,7,0,0,9,1,5,0,3,9
2020,51003,Badia Tedalda,AR,73,1,5,0,2,8,1,9,0,4,14
2020,51003,Badia Tedalda,AR,74,2,4,0,1,7,0,6,0,3,9
2020,51003,Badia Tedalda,AR,75,0,3,0,0,3,0,3,0,1,4
2020,51003,Badia Tedalda,AR,76,0,8,1,0,9,0,4,0,1,5
2020,51003,Badia Tedalda,AR,77,0,3,0,0,3,0,2,0,2,4
2020,51003,Badia Tedalda,AR,78,1,3,0,0,4,0,3,0,1,4
2020,51003,Badia Tedalda,AR,79,0,2,0,1,3,0,3,0,0,3
2020,51003,Badia Tedalda,AR,80,0,2,0,0,2,0,3,0,4,7
2020,51003,Badia Tedalda,AR,81,0,5,0,1,6,0,3,0,5,8
2020,51003,Badia Tedalda,AR,82,0,5,0,0,5,0,2,0,5,7
2020,51003,Badia Tedalda,AR,83,1,3,0,0,4,0,7,0,4,11
2020,51003,Badia Tedalda,AR,84,0,4,0,0,4,0,1,0,2,3
2020,51003,Badia Tedalda,AR,85,0,1,0,1,2,0,2,0,3,5
2020,51003,Badia Tedalda,AR,86,1,2,0,2,5,0,2,0,5,7
2020,51003,Badia Tedalda,AR,87,2,6,0,0,8,0,1,0,3,4
2020,51003,Badia Tedalda,AR,88,2,0,0,1,3,1,0,0,0,1
2020,51003,Badia Tedalda,AR,89,2,6,0,1,9,1,2,0,3,6
2020,51003,Badia Tedalda,AR,90,2,2,0,1,5,1,0,0,2,3
2020,51003,Badia Tedalda,AR,91,1,0,0,1,2,0,0,0,1,1
2020,51003,Badia Tedalda,AR,92,0,1,0,0,1,0,0,0,9,9
2020,51003,Badia Tedalda,AR,93,0,2,0,1,3,0,0,0,1,1
2020,51003,Badia Tedalda,AR,94,0,0,0,1,1,0,0,0,3,3
2020,51003,Badia Tedalda,AR,95,1,0,0,0,1,0,0,0,0,0
2020,51003,Badia Tedalda,AR,96,0,0,0,0,0,0,0,0,0,0
2020,51003,Badia Tedalda,AR,97,0,0,0,0,0,0,0,0,1,1
2020,51003,Badia Tedalda,AR,98,0,0,0,0,0,0,0,0,0,0
2020,51003,Badia Tedalda,AR,99,0,0,0,0,0,0,0,0,0,0
2020,51003,Badia Tedalda,AR,100 e più,0,0,0,0,0,0,0,0,2,2
2020,51004,Bibbiena,AR,0,40,0,0,0,40,30,0,0,0,30
2020,51004,Bibbiena,AR,1,42,0,0,0,42,35,0,0,0,35
2020,51004,Bibbiena,AR,2,43,0,0,0,43,38,0,0,0,38
2020,51004,Bibbiena,AR,3,46,0,0,0,46,32,0,0,0,32
2020,51004,Bibbiena,AR,4,59,0,0,0,59,35,0,0,0,35
2020,51004,Bibbiena,AR,5,37,0,0,0,37,39,0,0,0,39
2020,51004,Bibbiena,AR,6,58,0,0,0,58,48,0,0,0,48
2020,51004,Bibbiena,AR,7,52,0,0,0,52,48,0,0,0,48
2020,51004,Bibbiena,AR,8,52,0,0,0,52,53,0,0,0,53
2020,51004,Bibbiena,AR,9,57,0,0,0,57,52,0,0,0,52
2020,51004,Bibbiena,AR,10,55,0,0,0,55,49,0,0,0,49
2020,51004,Bibbiena,AR,11,48,0,0,0,48,49,0,0,0,49
2020,51004,Bibbiena,AR,12,57,0,0,0,57,45,0,0,0,45
2020,51004,Bibbiena,AR,13,59,0,0,0,59,53,0,0,0,53
2020,51004,Bibbiena,AR,14,55,0,0,0,55,64,0,0,0,64
2020,51004,Bibbiena,AR,15,49,0,0,0,49,48,0,0,0,48
2020,51004,Bibbiena,AR,16,58,0,0,0,58,53,0,0,0,53
2020,51004,Bibbiena,AR,17,62,0,0,0,62,45,0,0,0,45
2020,51004,Bibbiena,AR,18,77,0,0,0,77,58,0,0,0,58
2020,51004,Bibbiena,AR,19,50,0,0,0,50,64,0,0,0,64
2020,51004,Bibbiena,AR,20,60,0,0,0,60,53,0,0,0,53
2020,51004,Bibbiena,AR,21,53,0,0,0,53,41,1,0,0,42
2020,51004,Bibbiena,AR,22,61,1,0,0,62,44,1,0,0,45
2020,51004,Bibbiena,AR,23,60,2,0,0,62,41,1,0,0,42
2020,51004,Bibbiena,AR,24,62,1,0,0,63,55,5,0,0,60
2020,51004,Bibbiena,AR,25,56,3,0,0,59,41,12,0,0,53
2020,51004,Bibbiena,AR,26,71,2,0,0,73,46,6,1,0,53
2020,51004,Bibbiena,AR,27,65,4,0,0,69,54,12,0,0,66
2020,51004,Bibbiena,AR,28,53,6,0,0,59,47,14,0,0,61
2020,51004,Bibbiena,AR,29,51,11,0,0,62,45,18,0,0,63
2020,51004,Bibbiena,AR,30,46,7,0,0,53,40,17,1,0,58
2020,51004,Bibbiena,AR,31,48,21,0,0,69,31,19,0,0,50
2020,51004,Bibbiena,AR,32,50,14,0,0,64,38,34,0,0,72
2020,51004,Bibbiena,AR,33,48,22,1,0,71,28,37,0,0,65
2020,51004,Bibbiena,AR,34,31,23,1,0,55,26,30,1,0,57
2020,51004,Bibbiena,AR,35,44,28,0,0,72,22,34,2,0,58
2020,51004,Bibbiena,AR,36,35,25,1,0,61,18,32,3,0,53
2020,51004,Bibbiena,AR,37,41,34,0,0,75,21,41,1,0,63
2020,51004,Bibbiena,AR,38,33,29,0,0,62,20,42,1,0,63
2020,51004,Bibbiena,AR,39,21,29,0,0,50,15,42,3,0,60
2020,51004,Bibbiena,AR,40,28,37,0,0,65,20,55,3,0,78
2020,51004,Bibbiena,AR,41,31,49,3,0,83,14,46,1,0,61
2020,51004,Bibbiena,AR,42,26,53,3,0,82,20,47,2,0,69
2020,51004,Bibbiena,AR,43,21,53,4,1,79,10,51,5,1,67
2020,51004,Bibbiena,AR,44,31,47,2,0,80,19,56,8,2,85
2020,51004,Bibbiena,AR,45,27,68,7,0,102,16,72,8,0,96
2020,51004,Bibbiena,AR,46,25,67,6,0,98,17,68,10,0,95
2020,51004,Bibbiena,AR,47,16,72,5,0,93,14,62,13,3,92
2020,51004,Bibbiena,AR,48,23,53,5,0,81,16,66,11,2,95
2020,51004,Bibbiena,AR,49,30,59,3,0,92,18,80,8,1,107
2020,51004,Bibbiena,AR,50,20,54,5,0,79,13,77,11,1,102
2020,51004,Bibbiena,AR,51,19,73,6,0,98,10,85,13,5,113
2020,51004,Bibbiena,AR,52,16,86,2,2,106,17,68,10,0,95
2020,51004,Bibbiena,AR,53,17,73,5,0,95,10,78,9,2,99
2020,51004,Bibbiena,AR,54,12,76,7,0,95,11,73,10,4,98
2020,51004,Bibbiena,AR,55,14,97,6,1,118,17,82,6,2,107
2020,51004,Bibbiena,AR,56,17,69,5,2,93,9,84,10,5,108
2020,51004,Bibbiena,AR,57,10,73,11,1,95,8,78,5,2,93
2020,51004,Bibbiena,AR,58,10,60,7,1,78,7,62,8,5,82
2020,51004,Bibbiena,AR,59,11,68,4,2,85,4,82,6,6,98
2020,51004,Bibbiena,AR,60,5,84,4,3,96,1,66,3,5,75
2020,51004,Bibbiena,AR,61,8,66,2,2,78,8,69,7,7,91
2020,51004,Bibbiena,AR,62,10,64,2,2,78,12,60,3,7,82
2020,51004,Bibbiena,AR,63,8,59,2,2,71,6,44,5,6,61
2020,51004,Bibbiena,AR,64,6,58,3,1,68,5,60,3,11,79
2020,51004,Bibbiena,AR,65,6,58,6,2,72,5,50,3,8,66
2020,51004,Bibbiena,AR,66,9,63,3,6,81,3,63,6,7,79
2020,51004,Bibbiena,AR,67,8,66,2,2,78,4,52,1,11,68
2020,51004,Bibbiena,AR,68,2,54,3,3,62,3,58,2,10,73
2020,51004,Bibbiena,AR,69,8,67,2,3,80,2,64,1,11,78
2020,51004,Bibbiena,AR,70,5,75,1,2,83,1,49,3,12,65
2020,51004,Bibbiena,AR,71,3,54,1,6,64,3,73,4,14,94
2020,51004,Bibbiena,AR,72,9,70,4,4,87,2,66,2,27,97
2020,51004,Bibbiena,AR,73,4,62,1,5,72,2,55,1,17,75
2020,51004,Bibbiena,AR,74,2,64,2,4,72,5,53,2,16,76
2020,51004,Bibbiena,AR,75,0,39,1,6,46,1,35,3,17,56
2020,51004,Bibbiena,AR,76,1,42,0,2,45,3,27,1,18,49
2020,51004,Bibbiena,AR,77,5,45,1,4,55,2,30,2,25,59
2020,51004,Bibbiena,AR,78,3,44,1,4,52,6,22,0,26,54
2020,51004,Bibbiena,AR,79,1,36,1,8,46,3,31,0,18,52
2020,51004,Bibbiena,AR,80,1,25,1,5,32,2,32,0,32,66
2020,51004,Bibbiena,AR,81,2,37,0,6,45,0,23,0,39,62
2020,51004,Bibbiena,AR,82,2,34,0,5,41,1,27,0,34,62
2020,51004,Bibbiena,AR,83,5,35,0,4,44,0,23,1,17,41
2020,51004,Bibbiena,AR,84,4,33,0,10,47,0,14,0,26,40
2020,51004,Bibbiena,AR,85,0,21,0,10,31,0,8,0,38,46
2020,51004,Bibbiena,AR,86,2,15,0,10,27,3,11,0,30,44
2020,51004,Bibbiena,AR,87,4,14,0,11,29,1,3,1,28,33
2020,51004,Bibbiena,AR,88,1,10,0,8,19,0,3,0,33,36
2020,51004,Bibbiena,AR,89,3,4,0,6,13,3,5,1,26,35
2020,51004,Bibbiena,AR,90,2,11,0,4,17,0,3,0,27,30
2020,51004,Bibbiena,AR,91,2,7,0,2,11,1,0,0,30,31
2020,51004,Bibbiena,AR,92,2,2,0,2,6,3,4,0,17,24
2020,51004,Bibbiena,AR,93,0,5,0,3,8,0,1,0,15,16
2020,51004,Bibbiena,AR,94,1,1,0,5,7,1,1,0,15,17
2020,51004,Bibbiena,AR,95,0,2,0,0,2,1,0,0,9,10
2020,51004,Bibbiena,AR,96,0,1,0,2,3,0,0,0,14,14
2020,51004,Bibbiena,AR,97,0,0,0,3,3,0,1,0,5,6
2020,51004,Bibbiena,AR,98,1,1,0,0,2,0,0,0,3,3
2020,51004,Bibbiena,AR,99,0,0,0,0,0,0,0,0,2,2
2020,51004,Bibbiena,AR,100 e più,0,0,0,1,1,0,1,0,2,3
2020,51005,Bucine,AR,0,29,0,0,0,29,34,0,0,0,34
2020,51005,Bucine,AR,1,32,0,0,0,32,29,0,0,0,29
2020,51005,Bucine,AR,2,34,0,0,0,34,38,0,0,0,38
2020,51005,Bucine,AR,3,35,0,0,0,35,39,0,0,0,39
2020,51005,Bucine,AR,4,38,0,0,0,38,39,0,0,0,39
2020,51005,Bucine,AR,5,29,0,0,0,29,42,0,0,0,42
2020,51005,Bucine,AR,6,39,0,0,0,39,35,0,0,0,35
2020,51005,Bucine,AR,7,41,0,0,0,41,36,0,0,0,36
2020,51005,Bucine,AR,8,27,0,0,0,27,50,0,0,0,50
2020,51005,Bucine,AR,9,40,0,0,0,40,57,0,0,0,57
2020,51005,Bucine,AR,10,40,0,0,0,40,52,0,0,0,52
2020,51005,Bucine,AR,11,47,0,0,0,47,56,0,0,0,56
2020,51005,Bucine,AR,12,47,0,0,0,47,46,0,0,0,46
2020,51005,Bucine,AR,13,65,0,0,0,65,44,0,0,0,44
2020,51005,Bucine,AR,14,66,0,0,0,66,47,0,0,0,47
2020,51005,Bucine,AR,15,59,0,0,0,59,44,0,0,0,44
2020,51005,Bucine,AR,16,50,0,0,0,50,55,0,0,0,55
2020,51005,Bucine,AR,17,55,0,0,0,55,26,0,0,0,26
2020,51005,Bucine,AR,18,41,0,0,0,41,47,0,0,0,47
2020,51005,Bucine,AR,19,49,0,0,0,49,40,0,0,0,40
2020,51005,Bucine,AR,20,44,0,0,0,44,32,1,0,0,33
2020,51005,Bucine,AR,21,37,0,0,0,37,46,0,0,0,46
2020,51005,Bucine,AR,22,48,0,0,0,48,36,0,0,0,36
2020,51005,Bucine,AR,23,61,0,0,0,61,42,1,0,0,43
2020,51005,Bucine,AR,24,40,2,0,0,42,31,2,0,0,33
2020,51005,Bucine,AR,25,40,0,0,0,40,38,4,0,0,42
2020,51005,Bucine,AR,26,43,5,0,0,48,28,6,0,0,34
2020,51005,Bucine,AR,27,54,3,0,0,57,39,4,0,0,43
2020,51005,Bucine,AR,28,51,5,0,0,56,35,12,0,0,47
2020,51005,Bucine,AR,29,52,10,0,0,62,32,15,3,0,50
2020,51005,Bucine,AR,30,50,4,0,0,54,30,18,0,0,48
2020,51005,Bucine,AR,31,35,7,0,0,42,34,11,0,0,45
2020,51005,Bucine,AR,32,40,19,1,0,60,33,20,1,0,54
2020,51005,Bucine,AR,33,41,9,0,0,50,28,16,0,0,44
2020,51005,Bucine,AR,34,24,10,1,0,35,28,40,0,1,69
2020,51005,Bucine,AR,35,38,15,2,0,55,35,31,1,0,67
2020,51005,Bucine,AR,36,31,14,1,0,46,25,26,3,0,54
2020,51005,Bucine,AR,37,26,21,0,0,47,21,26,0,0,47
2020,51005,Bucine,AR,38,28,15,0,0,43,16,37,1,0,54
2020,51005,Bucine,AR,39,33,32,0,0,65,18,30,1,0,49
2020,51005,Bucine,AR,40,22,23,4,0,49,20,32,0,0,52
2020,51005,Bucine,AR,41,31,36,1,0,68,21,30,7,0,58
2020,51005,Bucine,AR,42,26,39,1,0,66,30,39,7,2,78
2020,51005,Bucine,AR,43,19,40,3,0,62,22,47,6,1,76
2020,51005,Bucine,AR,44,23,58,5,0,86,18,56,4,2,80
2020,51005,Bucine,AR,45,30,52,4,0,86,18,48,1,1,68
2020,51005,Bucine,AR,46,29,43,8,1,81,24,52,4,1,81
2020,51005,Bucine,AR,47,36,56,2,1,95,14,57,8,3,82
2020,51005,Bucine,AR,48,17,58,6,0,81,12,52,7,1,72
2020,51005,Bucine,AR,49,24,63,6,0,93,15,62,6,1,84
2020,51005,Bucine,AR,50,17,58,5,1,81,13,48,5,1,67
2020,51005,Bucine,AR,51,19,52,4,0,75,19,73,4,3,99
2020,51005,Bucine,AR,52,27,50,4,2,83,13,57,5,3,78
2020,51005,Bucine,AR,53,17,73,4,1,95,11,56,6,2,75
2020,51005,Bucine,AR,54,13,71,0,1,85,12,81,3,3,99
2020,51005,Bucine,AR,55,14,54,8,1,77,7,53,3,3,66
2020,51005,Bucine,AR,56,15,54,7,1,77,12,70,3,4,89
2020,51005,Bucine,AR,57,14,64,7,1,86,7,58,7,6,78
2020,51005,Bucine,AR,58,11,51,2,1,65,15,49,5,4,73
2020,51005,Bucine,AR,59,9,64,8,1,82,7,60,7,5,79
2020,51005,Bucine,AR,60,4,62,3,0,69,3,69,4,8,84
2020,51005,Bucine,AR,61,11,54,5,0,70,3,45,6,6,60
2020,51005,Bucine,AR,62,3,45,0,2,50,6,38,1,6,51
2020,51005,Bucine,AR,63,13,45,5,2,65,3,56,2,7,68
2020,51005,Bucine,AR,64,5,40,4,1,50,8,53,2,4,67
2020,51005,Bucine,AR,65,6,50,5,1,62,5,40,6,4,55
2020,51005,Bucine,AR,66,5,40,2,3,50,1,43,9,4,57
2020,51005,Bucine,AR,67,3,44,5,6,58,3,55,4,12,74
2020,51005,Bucine,AR,68,12,49,3,1,65,2,45,1,12,60
2020,51005,Bucine,AR,69,8,44,3,0,55,1,56,3,11,71
2020,51005,Bucine,AR,70,2,39,2,5,48,3,55,3,15,76
2020,51005,Bucine,AR,71,4,63,0,1,68,2,49,2,9,62
2020,51005,Bucine,AR,72,8,52,1,2,63,3,49,0,13,65
2020,51005,Bucine,AR,73,4,62,2,2,70,1,42,0,18,61
2020,51005,Bucine,AR,74,4,42,1,3,50,4,42,3,9,58
2020,51005,Bucine,AR,75,2,39,3,3,47,3,27,0,25,55
2020,51005,Bucine,AR,76,1,34,0,3,38,1,33,0,19,53
2020,51005,Bucine,AR,77,4,31,0,8,43,0,24,0,14,38
2020,51005,Bucine,AR,78,2,37,0,2,41,1,27,1,23,52
2020,51005,Bucine,AR,79,5,33,1,4,43,3,19,1,23,46
2020,51005,Bucine,AR,80,3,33,0,4,40,3,18,0,28,49
2020,51005,Bucine,AR,81,4,27,2,4,37,0,31,0,32,63
2020,51005,Bucine,AR,82,3,35,1,6,45,1,18,3,32,54
2020,51005,Bucine,AR,83,5,21,0,10,36,2,23,0,30,55
2020,51005,Bucine,AR,84,3,23,0,6,32,3,14,0,16,33
2020,51005,Bucine,AR,85,1,27,0,1,29,0,11,0,27,38
2020,51005,Bucine,AR,86,3,21,0,6,30,0,8,0,26,34
2020,51005,Bucine,AR,87,0,17,0,4,21,0,11,0,31,42
2020,51005,Bucine,AR,88,0,12,0,2,14,0,0,0,14,14
2020,51005,Bucine,AR,89,1,13,0,5,19,1,4,0,17,22
2020,51005,Bucine,AR,90,0,5,0,5,10,2,0,0,25,27
2020,51005,Bucine,AR,91,0,8,0,2,10,0,1,0,19,20
2020,51005,Bucine,AR,92,1,3,0,7,11,0,1,0,17,18
2020,51005,Bucine,AR,93,0,3,0,3,6,0,0,0,23,23
2020,51005,Bucine,AR,94,0,2,0,0,2,0,1,0,12,13
2020,51005,Bucine,AR,95,0,1,0,1,2,0,0,0,5,5
2020,51005,Bucine,AR,96,0,0,0,2,2,0,0,0,5,5
2020,51005,Bucine,AR,97,0,1,0,1,2,0,0,0,1,1
2020,51005,Bucine,AR,98,0,0,0,0,0,0,0,0,2,2
2020,51005,Bucine,AR,99,0,0,0,0,0,0,0,0,3,3
2020,51005,Bucine,AR,100 e più,0,0,0,2,2,0,0,0,2,2
2020,51006,Capolona,AR,0,19,0,0,0,19,11,0,0,0,11
2020,51006,Capolona,AR,1,20,0,0,0,20,15,0,0,0,15
2020,51006,Capolona,AR,2,17,0,0,0,17,19,0,0,0,19
2020,51006,Capolona,AR,3,26,0,0,0,26,20,0,0,0,20
2020,51006,Capolona,AR,4,17,0,0,0,17,25,0,0,0,25
2020,51006,Capolona,AR,5,22,0,0,0,22,19,0,0,0,19
2020,51006,Capolona,AR,6,16,0,0,0,16,20,0,0,0,20
2020,51006,Capolona,AR,7,25,0,0,0,25,17,0,0,0,17
2020,51006,Capolona,AR,8,17,0,0,0,17,27,0,0,0,27
2020,51006,Capolona,AR,9,24,0,0,0,24,25,0,0,0,25
2020,51006,Capolona,AR,10,24,0,0,0,24,21,0,0,0,21
2020,51006,Capolona,AR,11,27,0,0,0,27,23,0,0,0,23
2020,51006,Capolona,AR,12,21,0,0,0,21,29,0,0,0,29
2020,51006,Capolona,AR,13,28,0,0,0,28,32,0,0,0,32
2020,51006,Capolona,AR,14,25,0,0,0,25,34,0,0,0,34
2020,51006,Capolona,AR,15,27,0,0,0,27,20,0,0,0,20
2020,51006,Capolona,AR,16,22,0,0,0,22,21,0,0,0,21
2020,51006,Capolona,AR,17,23,0,0,0,23,27,0,0,0,27
2020,51006,Capolona,AR,18,25,0,0,0,25,20,0,0,0,20
2020,51006,Capolona,AR,19,21,0,0,0,21,23,0,0,0,23
2020,51006,Capolona,AR,20,20,0,0,0,20,23,1,0,0,24
2020,51006,Capolona,AR,21,25,0,0,0,25,17,2,0,0,19
2020,51006,Capolona,AR,22,26,0,0,0,26,18,0,0,0,18
2020,51006,Capolona,AR,23,20,0,0,0,20,26,0,0,0,26
2020,51006,Capolona,AR,24,20,0,0,0,20,22,1,0,0,23
2020,51006,Capolona,AR,25,30,0,0,0,30,19,1,0,0,20
2020,51006,Capolona,AR,26,23,1,0,0,24,20,1,0,0,21
2020,51006,Capolona,AR,27,28,0,0,0,28,15,1,0,0,16
2020,51006,Capolona,AR,28,26,1,0,0,27,16,8,0,0,24
2020,51006,Capolona,AR,29,20,4,0,0,24,20,8,0,0,28
2020,51006,Capolona,AR,30,18,9,0,0,27,19,6,1,1,27
2020,51006,Capolona,AR,31,23,10,0,0,33,15,8,0,0,23
2020,51006,Capolona,AR,32,19,2,0,0,21,18,10,0,0,28
2020,51006,Capolona,AR,33,22,13,0,0,35,14,18,0,0,32
2020,51006,Capolona,AR,34,13,5,1,0,19,12,21,0,0,33
2020,51006,Capolona,AR,35,15,12,1,0,28,11,12,0,0,23
2020,51006,Capolona,AR,36,15,11,1,0,27,10,20,1,0,31
2020,51006,Capolona,AR,37,15,16,1,0,32,16,21,2,0,39
2020,51006,Capolona,AR,38,18,16,1,0,35,11,23,1,0,35
2020,51006,Capolona,AR,39,26,15,0,0,41,4,29,2,0,35
2020,51006,Capolona,AR,40,12,15,0,0,27,10,29,2,0,41
2020,51006,Capolona,AR,41,13,19,1,0,33,6,24,0,0,30
2020,51006,Capolona,AR,42,15,25,1,0,41,8,26,3,1,38
2020,51006,Capolona,AR,43,16,24,3,0,43,7,21,2,1,31
2020,51006,Capolona,AR,44,10,25,0,0,35,9,22,2,1,34
2020,51006,Capolona,AR,45,18,23,0,0,41,4,23,4,0,31
2020,51006,Capolona,AR,46,16,26,1,0,43,8,23,3,0,34
2020,51006,Capolona,AR,47,11,28,1,0,40,14,31,4,0,49
2020,51006,Capolona,AR,48,10,31,1,0,42,7,33,4,1,45
2020,51006,Capolona,AR,49,14,26,2,0,42,7,44,6,2,59
2020,51006,Capolona,AR,50,5,34,1,0,40,4,26,2,1,33
2020,51006,Capolona,AR,51,11,34,2,0,47,8,36,2,0,46
2020,51006,Capolona,AR,52,4,31,1,0,36,8,43,1,2,54
2020,51006,Capolona,AR,53,6,26,4,1,37,3,36,5,1,45
2020,51006,Capolona,AR,54,9,33,0,0,42,8,33,2,1,44
2020,51006,Capolona,AR,55,8,30,4,0,42,6,33,4,1,44
2020,51006,Capolona,AR,56,8,26,6,0,40,5,29,3,1,38
2020,51006,Capolona,AR,57,2,36,4,1,43,2,33,2,3,40
2020,51006,Capolona,AR,58,2,35,2,0,39,3,32,2,3,40
2020,51006,Capolona,AR,59,3,35,6,1,45,1,34,7,4,46
2020,51006,Capolona,AR,60,3,20,2,0,25,4,26,3,3,36
2020,51006,Capolona,AR,61,3,34,3,1,41,4,24,0,4,32
2020,51006,Capolona,AR,62,3,27,6,0,36,3,32,6,2,43
2020,51006,Capolona,AR,63,2,36,2,2,42,1,31,5,4,41
2020,51006,Capolona,AR,64,2,26,4,2,34,4,30,1,9,44
2020,51006,Capolona,AR,65,0,24,3,1,28,1,31,1,6,39
2020,51006,Capolona,AR,66,0,32,1,3,36,2,22,2,7,33
2020,51006,Capolona,AR,67,0,28,1,0,29,2,26,1,6,35
2020,51006,Capolona,AR,68,2,25,3,2,32,1,26,1,4,32
2020,51006,Capolona,AR,69,1,28,0,0,29,0,20,2,6,28
2020,51006,Capolona,AR,70,2,31,1,0,34,2,19,2,3,26
2020,51006,Capolona,AR,71,0,27,0,3,30,1,22,0,12,35
2020,51006,Capolona,AR,72,2,27,1,3,33,3,23,0,11,37
2020,51006,Capolona,AR,73,3,26,1,2,32,0,24,0,7,31
2020,51006,Capolona,AR,74,3,24,0,1,28,0,28,0,8,36
2020,51006,Capolona,AR,75,1,21,0,3,25,0,16,0,5,21
2020,51006,Capolona,AR,76,4,8,1,0,13,0,13,0,8,21
2020,51006,Capolona,AR,77,2,20,0,4,26,0,17,1,11,29
2020,51006,Capolona,AR,78,1,15,1,2,19,1,9,0,12,22
2020,51006,Capolona,AR,79,0,17,0,2,19,1,7,0,15,23
2020,51006,Capolona,AR,80,3,15,0,1,19,1,11,1,14,27
2020,51006,Capolona,AR,81,2,14,1,1,18,1,12,0,13,26
2020,51006,Capolona,AR,82,1,14,0,5,20,0,5,0,11,16
2020,51006,Capolona,AR,83,3,11,0,1,15,0,3,0,15,18
2020,51006,Capolona,AR,84,2,9,0,2,13,1,6,1,8,16
2020,51006,Capolona,AR,85,0,5,0,3,8,0,8,0,12,20
2020,51006,Capolona,AR,86,2,8,0,2,12,0,4,0,15,19
2020,51006,Capolona,AR,87,1,15,0,3,19,1,3,0,9,13
2020,51006,Capolona,AR,88,0,4,0,1,5,1,2,0,10,13
2020,51006,Capolona,AR,89,0,3,0,3,6,0,2,0,10,12
2020,51006,Capolona,AR,90,0,2,0,0,2,2,0,0,17,19
2020,51006,Capolona,AR,91,0,3,0,3,6,0,2,0,2,4
2020,51006,Capolona,AR,92,0,0,0,1,1,0,0,0,10,10
2020,51006,Capolona,AR,93,0,2,0,3,5,0,0,0,10,10
2020,51006,Capolona,AR,94,0,0,0,0,0,0,0,0,7,7
2020,51006,Capolona,AR,95,0,1,0,0,1,0,0,0,4,4
2020,51006,Capolona,AR,96,1,0,0,1,2,0,0,0,3,3
2020,51006,Capolona,AR,97,0,1,0,0,1,0,0,0,2,2
2020,51006,Capolona,AR,98,0,0,0,0,0,0,0,0,0,0
2020,51006,Capolona,AR,99,0,0,0,0,0,0,0,0,0,0
2020,51006,Capolona,AR,100 e più,0,1,0,1,2,0,0,0,1,1
2020,51007,Caprese Michelangelo,AR,0,2,0,0,0,2,2,0,0,0,2
2020,51007,Caprese Michelangelo,AR,1,5,0,0,0,5,5,0,0,0,5
2020,51007,Caprese Michelangelo,AR,2,5,0,0,0,5,5,0,0,0,5
2020,51007,Caprese Michelangelo,AR,3,4,0,0,0,4,4,0,0,0,4
2020,51007,Caprese Michelangelo,AR,4,4,0,0,0,4,3,0,0,0,3
2020,51007,Caprese Michelangelo,AR,5,2,0,0,0,2,6,0,0,0,6
2020,51007,Caprese Michelangelo,AR,6,6,0,0,0,6,4,0,0,0,4
2020,51007,Caprese Michelangelo,AR,7,7,0,0,0,7,3,0,0,0,3
2020,51007,Caprese Michelangelo,AR,8,6,0,0,0,6,3,0,0,0,3
2020,51007,Caprese Michelangelo,AR,9,2,0,0,0,2,9,0,0,0,9
2020,51007,Caprese Michelangelo,AR,10,3,0,0,0,3,4,0,0,0,4
2020,51007,Caprese Michelangelo,AR,11,5,0,0,0,5,4,0,0,0,4
2020,51007,Caprese Michelangelo,AR,12,4,0,0,0,4,4,0,0,0,4
2020,51007,Caprese Michelangelo,AR,13,4,0,0,0,4,2,0,0,0,2
2020,51007,Caprese Michelangelo,AR,14,6,0,0,0,6,5,0,0,0,5
2020,51007,Caprese Michelangelo,AR,15,2,0,0,0,2,5,0,0,0,5
2020,51007,Caprese Michelangelo,AR,16,3,0,0,0,3,3,0,0,0,3
2020,51007,Caprese Michelangelo,AR,17,9,0,0,0,9,5,0,0,0,5
2020,51007,Caprese Michelangelo,AR,18,7,0,0,0,7,4,0,0,0,4
2020,51007,Caprese Michelangelo,AR,19,2,0,0,0,2,5,0,0,0,5
2020,51007,Caprese Michelangelo,AR,20,10,0,0,0,10,6,0,0,0,6
2020,51007,Caprese Michelangelo,AR,21,7,0,0,0,7,2,0,0,0,2
2020,51007,Caprese Michelangelo,AR,22,5,0,0,0,5,9,0,0,0,9
2020,51007,Caprese Michelangelo,AR,23,7,1,0,0,8,0,1,0,0,1
2020,51007,Caprese Michelangelo,AR,24,10,0,0,0,10,4,0,0,0,4
2020,51007,Caprese Michelangelo,AR,25,7,0,0,0,7,4,0,0,0,4
2020,51007,Caprese Michelangelo,AR,26,6,0,0,0,6,6,1,0,0,7
2020,51007,Caprese Michelangelo,AR,27,7,0,0,0,7,5,1,0,0,6
2020,51007,Caprese Michelangelo,AR,28,5,0,0,0,5,1,1,0,0,2
2020,51007,Caprese Michelangelo,AR,29,6,0,0,0,6,2,3,0,0,5
2020,51007,Caprese Michelangelo,AR,30,6,0,0,0,6,10,0,0,0,10
2020,51007,Caprese Michelangelo,AR,31,2,2,0,0,4,3,3,0,0,6
2020,51007,Caprese Michelangelo,AR,32,5,1,0,0,6,3,4,0,0,7
2020,51007,Caprese Michelangelo,AR,33,4,3,0,0,7,6,3,0,0,9
2020,51007,Caprese Michelangelo,AR,34,6,2,0,0,8,4,1,0,0,5
2020,51007,Caprese Michelangelo,AR,35,6,1,0,0,7,3,1,0,0,4
2020,51007,Caprese Michelangelo,AR,36,1,1,0,0,2,2,0,1,0,3
2020,51007,Caprese Michelangelo,AR,37,2,1,0,0,3,5,2,0,0,7
2020,51007,Caprese Michelangelo,AR,38,4,0,0,0,4,3,5,0,0,8
2020,51007,Caprese Michelangelo,AR,39,4,2,1,0,7,2,1,0,0,3
2020,51007,Caprese Michelangelo,AR,40,4,1,0,0,5,0,5,0,0,5
2020,51007,Caprese Michelangelo,AR,41,4,4,0,0,8,5,8,1,0,14
2020,51007,Caprese Michelangelo,AR,42,3,7,0,0,10,1,4,0,0,5
2020,51007,Caprese Michelangelo,AR,43,4,4,1,0,9,2,1,1,0,4
2020,51007,Caprese Michelangelo,AR,44,8,3,1,0,12,8,6,1,0,15
2020,51007,Caprese Michelangelo,AR,45,2,7,0,0,9,2,6,0,0,8
2020,51007,Caprese Michelangelo,AR,46,3,8,0,0,11,1,6,0,0,7
2020,51007,Caprese Michelangelo,AR,47,3,6,0,0,9,3,15,1,1,20
2020,51007,Caprese Michelangelo,AR,48,3,9,0,0,12,3,7,1,0,11
2020,51007,Caprese Michelangelo,AR,49,3,6,0,0,9,2,2,1,0,5
2020,51007,Caprese Michelangelo,AR,50,4,7,0,0,11,3,5,1,0,9
2020,51007,Caprese Michelangelo,AR,51,1,5,1,0,7,1,11,2,0,14
2020,51007,Caprese Michelangelo,AR,52,0,5,2,0,7,0,13,0,0,13
2020,51007,Caprese Michelangelo,AR,53,0,12,1,0,13,2,14,1,1,18
2020,51007,Caprese Michelangelo,AR,54,1,11,0,0,12,1,9,3,1,14
2020,51007,Caprese Michelangelo,AR,55,0,7,0,0,7,0,7,1,0,8
2020,51007,Caprese Michelangelo,AR,56,1,4,2,0,7,0,9,0,1,10
2020,51007,Caprese Michelangelo,AR,57,2,12,0,0,14,1,15,0,0,16
2020,51007,Caprese Michelangelo,AR,58,1,9,0,0,10,2,8,3,0,13
2020,51007,Caprese Michelangelo,AR,59,3,4,0,0,7,0,8,0,0,8
2020,51007,Caprese Michelangelo,AR,60,3,5,2,0,10,0,10,0,2,12
2020,51007,Caprese Michelangelo,AR,61,5,8,1,0,14,0,9,1,1,11
2020,51007,Caprese Michelangelo,AR,62,2,6,0,0,8,0,6,0,1,7
2020,51007,Caprese Michelangelo,AR,63,5,9,1,0,15,0,9,1,0,10
2020,51007,Caprese Michelangelo,AR,64,2,3,1,0,6,0,10,0,0,10
2020,51007,Caprese Michelangelo,AR,65,0,7,0,0,7,0,13,1,1,15
2020,51007,Caprese Michelangelo,AR,66,1,11,0,1,13,0,7,0,2,9
2020,51007,Caprese Michelangelo,AR,67,2,5,2,1,10,0,5,1,1,7
2020,51007,Caprese Michelangelo,AR,68,3,9,1,0,13,0,5,1,2,8
2020,51007,Caprese Michelangelo,AR,69,0,14,0,1,15,0,11,0,1,12
2020,51007,Caprese Michelangelo,AR,70,2,8,0,1,11,0,7,1,3,11
2020,51007,Caprese Michelangelo,AR,71,0,16,0,0,16,0,13,0,3,16
2020,51007,Caprese Michelangelo,AR,72,1,6,2,1,10,0,9,0,1,10
2020,51007,Caprese Michelangelo,AR,73,1,5,1,0,7,1,6,1,3,11
2020,51007,Caprese Michelangelo,AR,74,1,6,1,0,8,1,8,0,4,13
2020,51007,Caprese Michelangelo,AR,75,0,11,0,0,11,1,8,0,1,10
2020,51007,Caprese Michelangelo,AR,76,0,2,0,1,3,0,3,0,3,6
2020,51007,Caprese Michelangelo,AR,77,1,4,0,1,6,0,0,0,2,2
2020,51007,Caprese Michelangelo,AR,78,1,8,0,0,9,0,0,0,2,2
2020,51007,Caprese Michelangelo,AR,79,0,7,1,0,8,0,2,1,1,4
2020,51007,Caprese Michelangelo,AR,80,0,3,0,0,3,0,3,0,6,9
2020,51007,Caprese Michelangelo,AR,81,3,5,0,0,8,0,5,0,3,8
2020,51007,Caprese Michelangelo,AR,82,0,4,0,0,4,0,5,0,7,12
2020,51007,Caprese Michelangelo,AR,83,1,1,0,3,5,1,2,1,7,11
2020,51007,Caprese Michelangelo,AR,84,0,4,0,0,4,0,1,0,2,3
2020,51007,Caprese Michelangelo,AR,85,0,5,0,1,6,2,4,0,3,9
2020,51007,Caprese Michelangelo,AR,86,0,2,0,2,4,0,3,0,5,8
2020,51007,Caprese Michelangelo,AR,87,0,2,0,2,4,0,1,0,5,6
2020,51007,Caprese Michelangelo,AR,88,1,1,0,3,5,0,2,0,10,12
2020,51007,Caprese Michelangelo,AR,89,0,2,0,0,2,0,1,0,5,6
2020,51007,Caprese Michelangelo,AR,90,1,2,0,1,4,1,1,0,2,4
2020,51007,Caprese Michelangelo,AR,91,0,2,0,1,3,0,0,0,8,8
2020,51007,Caprese Michelangelo,AR,92,0,0,0,0,0,0,0,0,1,1
2020,51007,Caprese Michelangelo,AR,93,0,3,0,2,5,0,0,0,3,3
2020,51007,Caprese Michelangelo,AR,94,0,0,0,1,1,0,0,0,1,1
2020,51007,Caprese Michelangelo,AR,95,0,0,0,0,0,0,0,0,0,0
2020,51007,Caprese Michelangelo,AR,96,0,0,0,0,0,0,0,0,1,1
2020,51007,Caprese Michelangelo,AR,97,0,0,0,0,0,0,1,0,0,1
2020,51007,Caprese Michelangelo,AR,98,0,0,0,0,0,0,0,0,0,0
2020,51007,Caprese Michelangelo,AR,99,0,0,0,0,0,0,0,0,1,1
2020,51007,Caprese Michelangelo,AR,100 e più,0,0,0,0,0,0,0,0,1,1
2020,51008,Castel Focognano,AR,0,9,0,0,0,9,12,0,0,0,12
2020,51008,Castel Focognano,AR,1,10,0,0,0,10,5,0,0,0,5
2020,51008,Castel Focognano,AR,2,4,0,0,0,4,7,0,0,0,7
2020,51008,Castel Focognano,AR,3,12,0,0,0,12,9,0,0,0,9
2020,51008,Castel Focognano,AR,4,9,0,0,0,9,8,0,0,0,8
2020,51008,Castel Focognano,AR,5,15,0,0,0,15,9,0,0,0,9
2020,51008,Castel Focognano,AR,6,10,0,0,0,10,10,0,0,0,10
2020,51008,Castel Focognano,AR,7,4,0,0,0,4,5,0,0,0,5
2020,51008,Castel Focognano,AR,8,14,0,0,0,14,9,0,0,0,9
2020,51008,Castel Focognano,AR,9,13,0,0,0,13,12,0,0,0,12
2020,51008,Castel Focognano,AR,10,7,0,0,0,7,12,0,0,0,12
2020,51008,Castel Focognano,AR,11,13,0,0,0,13,7,0,0,0,7
2020,51008,Castel Focognano,AR,12,17,0,0,0,17,14,0,0,0,14
2020,51008,Castel Focognano,AR,13,14,0,0,0,14,15,0,0,0,15
2020,51008,Castel Focognano,AR,14,14,0,0,0,14,9,0,0,0,9
2020,51008,Castel Focognano,AR,15,10,0,0,0,10,13,0,0,0,13
2020,51008,Castel Focognano,AR,16,12,0,0,0,12,19,0,0,0,19
2020,51008,Castel Focognano,AR,17,9,0,0,0,9,10,0,0,0,10
2020,51008,Castel Focognano,AR,18,12,0,0,0,12,11,0,0,0,11
2020,51008,Castel Focognano,AR,19,13,0,0,0,13,9,0,0,0,9
2020,51008,Castel Focognano,AR,20,9,0,0,0,9,8,0,0,0,8
2020,51008,Castel Focognano,AR,21,21,0,0,0,21,10,0,0,0,10
2020,51008,Castel Focognano,AR,22,10,0,0,0,10,15,1,0,0,16
2020,51008,Castel Focognano,AR,23,22,0,0,0,22,10,2,0,0,12
2020,51008,Castel Focognano,AR,24,17,0,0,0,17,19,0,0,0,19
2020,51008,Castel Focognano,AR,25,14,0,0,0,14,11,3,0,0,14
2020,51008,Castel Focognano,AR,26,12,0,0,0,12,10,2,0,0,12
2020,51008,Castel Focognano,AR,27,23,1,0,0,24,10,3,0,0,13
2020,51008,Castel Focognano,AR,28,21,3,0,0,24,14,4,0,0,18
2020,51008,Castel Focognano,AR,29,13,2,0,0,15,6,2,0,0,8
2020,51008,Castel Focognano,AR,30,9,2,0,0,11,12,3,0,0,15
2020,51008,Castel Focognano,AR,31,10,1,0,0,11,8,6,0,0,14
2020,51008,Castel Focognano,AR,32,17,0,0,0,17,9,5,0,0,14
2020,51008,Castel Focognano,AR,33,16,0,0,0,16,9,5,0,0,14
2020,51008,Castel Focognano,AR,34,17,8,0,0,25,10,5,1,0,16
2020,51008,Castel Focognano,AR,35,11,5,0,0,16,8,9,0,0,17
2020,51008,Castel Focognano,AR,36,10,8,0,0,18,16,3,0,0,19
2020,51008,Castel Focognano,AR,37,13,9,0,0,22,8,15,0,0,23
2020,51008,Castel Focognano,AR,38,12,4,0,0,16,8,8,1,0,17
2020,51008,Castel Focognano,AR,39,12,6,0,0,18,6,6,0,0,12
2020,51008,Castel Focognano,AR,40,7,8,2,0,17,7,8,0,0,15
2020,51008,Castel Focognano,AR,41,4,5,1,0,10,7,12,0,0,19
2020,51008,Castel Focognano,AR,42,10,10,1,0,21,3,12,3,0,18
2020,51008,Castel Focognano,AR,43,11,8,1,0,20,3,14,1,0,18
2020,51008,Castel Focognano,AR,44,3,7,0,0,10,5,8,0,0,13
2020,51008,Castel Focognano,AR,45,6,8,1,0,15,8,14,0,0,22
2020,51008,Castel Focognano,AR,46,7,15,2,0,24,4,12,1,0,17
2020,51008,Castel Focognano,AR,47,7,17,1,0,25,0,16,0,0,16
2020,51008,Castel Focognano,AR,48,5,19,4,0,28,1,19,0,0,20
2020,51008,Castel Focognano,AR,49,7,11,0,0,18,5,21,2,0,28
2020,51008,Castel Focognano,AR,50,6,18,0,0,24,3,20,1,1,25
2020,51008,Castel Focognano,AR,51,5,20,1,0,26,1,20,1,0,22
2020,51008,Castel Focognano,AR,52,1,21,0,1,23,4,21,2,0,27
2020,51008,Castel Focognano,AR,53,4,19,3,0,26,3,20,2,0,25
2020,51008,Castel Focognano,AR,54,2,14,1,0,17,4,20,2,0,26
2020,51008,Castel Focognano,AR,55,8,14,1,1,24,1,17,1,0,19
2020,51008,Castel Focognano,AR,56,8,22,2,1,33,4,19,1,0,24
2020,51008,Castel Focognano,AR,57,5,23,1,0,29,3,15,1,2,21
2020,51008,Castel Focognano,AR,58,6,25,2,1,34,2,24,0,2,28
2020,51008,Castel Focognano,AR,59,2,16,2,0,20,3,22,1,0,26
2020,51008,Castel Focognano,AR,60,2,19,0,0,21,1,16,0,1,18
2020,51008,Castel Focognano,AR,61,0,20,1,0,21,2,16,1,3,22
2020,51008,Castel Focognano,AR,62,5,21,1,0,27,2,16,3,2,23
2020,51008,Castel Focognano,AR,63,0,20,2,1,23,1,22,0,3,26
2020,51008,Castel Focognano,AR,64,5,18,1,0,24,3,18,2,7,30
2020,51008,Castel Focognano,AR,65,2,23,4,2,31,2,14,0,6,22
2020,51008,Castel Focognano,AR,66,5,16,2,0,23,0,16,2,3,21
2020,51008,Castel Focognano,AR,67,2,14,0,1,17,2,17,0,2,21
2020,51008,Castel Focognano,AR,68,3,15,0,0,18,1,13,0,1,15
2020,51008,Castel Focognano,AR,69,2,12,0,0,14,0,7,0,3,10
2020,51008,Castel Focognano,AR,70,2,16,0,0,18,0,13,4,5,22
2020,51008,Castel Focognano,AR,71,0,13,1,0,14,1,20,1,7,29
2020,51008,Castel Focognano,AR,72,3,17,0,1,21,0,19,1,5,25
2020,51008,Castel Focognano,AR,73,2,15,0,2,19,0,10,0,1,11
2020,51008,Castel Focognano,AR,74,1,9,0,1,11,1,8,1,11,21
2020,51008,Castel Focognano,AR,75,0,9,1,0,10,0,12,0,4,16
2020,51008,Castel Focognano,AR,76,0,14,0,1,15,2,7,1,5,15
2020,51008,Castel Focognano,AR,77,1,17,0,1,19,0,7,0,4,11
2020,51008,Castel Focognano,AR,78,2,8,0,0,10,0,11,1,1,13
2020,51008,Castel Focognano,AR,79,3,12,0,2,17,0,6,0,7,13
2020,51008,Castel Focognano,AR,80,2,9,0,2,13,1,11,0,7,19
2020,51008,Castel Focognano,AR,81,1,12,0,2,15,2,4,0,8,14
2020,51008,Castel Focognano,AR,82,0,9,0,1,10,0,8,0,7,15
2020,51008,Castel Focognano,AR,83,1,7,0,2,10,2,10,1,11,24
2020,51008,Castel Focognano,AR,84,2,15,0,1,18,0,6,0,9,15
2020,51008,Castel Focognano,AR,85,2,10,0,1,13,0,4,0,9,13
2020,51008,Castel Focognano,AR,86,0,5,0,0,5,0,4,0,8,12
2020,51008,Castel Focognano,AR,87,1,4,0,2,7,0,4,0,11,15
2020,51008,Castel Focognano,AR,88,0,5,0,3,8,0,2,0,10,12
2020,51008,Castel Focognano,AR,89,0,4,0,3,7,0,0,0,10,10
2020,51008,Castel Focognano,AR,90,0,1,0,0,1,0,1,0,10,11
2020,51008,Castel Focognano,AR,91,1,2,0,0,3,0,0,0,5,5
2020,51008,Castel Focognano,AR,92,0,1,0,0,1,0,0,0,0,0
2020,51008,Castel Focognano,AR,93,0,1,0,0,1,0,0,0,5,5
2020,51008,Castel Focognano,AR,94,0,1,0,1,2,0,0,0,2,2
2020,51008,Castel Focognano,AR,95,0,1,0,1,2,0,0,0,4,4
2020,51008,Castel Focognano,AR,96,0,0,0,0,0,0,0,0,0,0
2020,51008,Castel Focognano,AR,97,0,0,0,0,0,0,0,0,2,2
2020,51008,Castel Focognano,AR,98,0,0,0,1,1,0,0,0,0,0
2020,51008,Castel Focognano,AR,99,0,0,0,0,0,0,0,0,2,2
2020,51008,Castel Focognano,AR,100 e più,0,0,0,1,1,0,0,0,4,4
2020,51010,Castel San Niccolò,AR,0,8,0,0,0,8,6,0,0,0,6
2020,51010,Castel San Niccolò,AR,1,6,0,0,0,6,6,0,0,0,6
2020,51010,Castel San Niccolò,AR,2,6,0,0,0,6,4,0,0,0,4
2020,51010,Castel San Niccolò,AR,3,11,0,0,0,11,11,0,0,0,11
2020,51010,Castel San Niccolò,AR,4,9,0,0,0,9,11,0,0,0,11
2020,51010,Castel San Niccolò,AR,5,7,0,0,0,7,7,0,0,0,7
2020,51010,Castel San Niccolò,AR,6,8,0,0,0,8,8,0,0,0,8
2020,51010,Castel San Niccolò,AR,7,6,0,0,0,6,9,0,0,0,9
2020,51010,Castel San Niccolò,AR,8,7,0,0,0,7,16,0,0,0,16
2020,51010,Castel San Niccolò,AR,9,6,0,0,0,6,13,0,0,0,13
2020,51010,Castel San Niccolò,AR,10,9,0,0,0,9,10,0,0,0,10
2020,51010,Castel San Niccolò,AR,11,12,0,0,0,12,6,0,0,0,6
2020,51010,Castel San Niccolò,AR,12,12,0,0,0,12,9,0,0,0,9
2020,51010,Castel San Niccolò,AR,13,7,0,0,0,7,11,0,0,0,11
2020,51010,Castel San Niccolò,AR,14,14,0,0,0,14,6,0,0,0,6
2020,51010,Castel San Niccolò,AR,15,10,0,0,0,10,5,0,0,0,5
2020,51010,Castel San Niccolò,AR,16,21,0,0,0,21,10,0,0,0,10
2020,51010,Castel San Niccolò,AR,17,5,0,0,0,5,12,0,0,0,12
2020,51010,Castel San Niccolò,AR,18,16,0,0,0,16,7,0,0,0,7
2020,51010,Castel San Niccolò,AR,19,12,0,0,0,12,10,0,0,0,10
2020,51010,Castel San Niccolò,AR,20,10,0,0,0,10,16,0,0,0,16
2020,51010,Castel San Niccolò,AR,21,10,0,0,0,10,6,0,0,0,6
2020,51010,Castel San Niccolò,AR,22,12,1,0,0,13,9,1,0,0,10
2020,51010,Castel San Niccolò,AR,23,11,0,0,0,11,12,1,0,0,13
2020,51010,Castel San Niccolò,AR,24,11,1,0,0,12,16,0,0,0,16
2020,51010,Castel San Niccolò,AR,25,15,1,0,0,16,5,0,0,0,5
2020,51010,Castel San Niccolò,AR,26,11,1,0,0,12,7,1,0,0,8
2020,51010,Castel San Niccolò,AR,27,5,0,0,0,5,7,0,0,0,7
2020,51010,Castel San Niccolò,AR,28,9,0,0,0,9,5,3,0,0,8
2020,51010,Castel San Niccolò,AR,29,5,1,0,0,6,7,3,0,0,10
2020,51010,Castel San Niccolò,AR,30,7,2,0,0,9,3,7,0,0,10
2020,51010,Castel San Niccolò,AR,31,9,6,0,0,15,5,6,0,0,11
2020,51010,Castel San Niccolò,AR,32,5,2,0,0,7,9,2,0,0,11
2020,51010,Castel San Niccolò,AR,33,12,1,0,0,13,8,5,0,0,13
2020,51010,Castel San Niccolò,AR,34,3,4,0,0,7,7,7,0,0,14
2020,51010,Castel San Niccolò,AR,35,11,1,0,0,12,8,7,0,0,15
2020,51010,Castel San Niccolò,AR,36,11,5,0,0,16,3,5,0,0,8
2020,51010,Castel San Niccolò,AR,37,9,3,0,0,12,6,7,0,0,13
2020,51010,Castel San Niccolò,AR,38,6,5,0,0,11,8,5,0,0,13
2020,51010,Castel San Niccolò,AR,39,7,8,0,0,15,5,7,2,0,14
2020,51010,Castel San Niccolò,AR,40,6,7,0,0,13,7,6,0,0,13
2020,51010,Castel San Niccolò,AR,41,15,9,1,0,25,7,8,0,0,15
2020,51010,Castel San Niccolò,AR,42,5,5,0,0,10,7,8,0,0,15
2020,51010,Castel San Niccolò,AR,43,5,5,0,0,10,5,15,1,0,21
2020,51010,Castel San Niccolò,AR,44,10,9,2,0,21,4,16,1,0,21
2020,51010,Castel San Niccolò,AR,45,12,6,1,0,19,2,10,1,0,13
2020,51010,Castel San Niccolò,AR,46,6,15,0,0,21,2,14,0,2,18
2020,51010,Castel San Niccolò,AR,47,9,11,0,0,20,2,15,0,0,17
2020,51010,Castel San Niccolò,AR,48,4,14,0,0,18,6,17,2,1,26
2020,51010,Castel San Niccolò,AR,49,6,12,0,0,18,5,12,0,0,17
2020,51010,Castel San Niccolò,AR,50,8,12,1,0,21,5,12,3,0,20
2020,51010,Castel San Niccolò,AR,51,9,23,0,0,32,4,15,2,1,22
2020,51010,Castel San Niccolò,AR,52,4,12,2,0,18,4,7,1,0,12
2020,51010,Castel San Niccolò,AR,53,7,17,3,0,27,5,10,0,2,17
2020,51010,Castel San Niccolò,AR,54,5,20,0,2,27,2,13,0,2,17
2020,51010,Castel San Niccolò,AR,55,4,13,2,0,19,4,19,1,1,25
2020,51010,Castel San Niccolò,AR,56,4,15,5,1,25,6,14,1,0,21
2020,51010,Castel San Niccolò,AR,57,6,12,2,0,20,3,17,2,1,23
2020,51010,Castel San Niccolò,AR,58,4,16,4,0,24,2,22,0,0,24
2020,51010,Castel San Niccolò,AR,59,3,17,2,0,22,0,11,0,0,11
2020,51010,Castel San Niccolò,AR,60,4,12,0,0,16,1,20,1,1,23
2020,51010,Castel San Niccolò,AR,61,1,20,3,1,25,5,18,2,1,26
2020,51010,Castel San Niccolò,AR,62,1,15,0,0,16,2,14,0,1,17
2020,51010,Castel San Niccolò,AR,63,1,9,1,1,12,1,10,1,1,13
2020,51010,Castel San Niccolò,AR,64,3,12,4,0,19,1,16,0,3,20
2020,51010,Castel San Niccolò,AR,65,0,21,1,2,24,2,14,1,4,21
2020,51010,Castel San Niccolò,AR,66,0,12,1,2,15,1,11,0,3,15
2020,51010,Castel San Niccolò,AR,67,2,10,0,0,12,1,8,0,1,10
2020,51010,Castel San Niccolò,AR,68,4,17,0,0,21,1,10,0,1,12
2020,51010,Castel San Niccolò,AR,69,1,15,0,3,19,1,11,1,5,18
2020,51010,Castel San Niccolò,AR,70,1,16,3,2,22,1,9,0,3,13
2020,51010,Castel San Niccolò,AR,71,1,14,0,0,15,0,17,0,5,22
2020,51010,Castel San Niccolò,AR,72,0,11,0,0,11,4,15,2,2,23
2020,51010,Castel San Niccolò,AR,73,3,10,2,0,15,1,14,1,3,19
2020,51010,Castel San Niccolò,AR,74,2,16,1,4,23,0,11,2,7,20
2020,51010,Castel San Niccolò,AR,75,1,10,0,0,11,0,6,2,6,14
2020,51010,Castel San Niccolò,AR,76,0,8,1,1,10,1,7,1,5,14
2020,51010,Castel San Niccolò,AR,77,3,9,0,1,13,2,6,1,9,18
2020,51010,Castel San Niccolò,AR,78,0,8,0,3,11,1,9,0,2,12
2020,51010,Castel San Niccolò,AR,79,0,11,1,0,12,0,4,0,8,12
2020,51010,Castel San Niccolò,AR,80,0,6,1,0,7,2,6,0,14,22
2020,51010,Castel San Niccolò,AR,81,1,9,2,1,13,0,9,2,8,19
2020,51010,Castel San Niccolò,AR,82,2,7,0,3,12,2,10,0,3,15
2020,51010,Castel San Niccolò,AR,83,1,8,0,0,9,2,6,0,11,19
2020,51010,Castel San Niccolò,AR,84,1,8,0,2,11,0,4,0,9,13
2020,51010,Castel San Niccolò,AR,85,3,8,0,2,13,0,3,0,8,11
2020,51010,Castel San Niccolò,AR,86,0,7,0,1,8,0,1,0,9,10
2020,51010,Castel San Niccolò,AR,87,1,5,1,2,9,0,1,0,9,10
2020,51010,Castel San Niccolò,AR,88,3,3,0,1,7,0,0,0,6,6
2020,51010,Castel San Niccolò,AR,89,0,2,1,2,5,1,2,0,11,14
2020,51010,Castel San Niccolò,AR,90,0,4,0,0,4,0,1,0,6,7
2020,51010,Castel San Niccolò,AR,91,0,4,0,1,5,1,0,0,4,5
2020,51010,Castel San Niccolò,AR,92,2,0,0,2,4,1,1,0,7,9
2020,51010,Castel San Niccolò,AR,93,0,0,0,0,0,0,0,0,5,5
2020,51010,Castel San Niccolò,AR,94,0,0,0,0,0,1,0,0,2,3
2020,51010,Castel San Niccolò,AR,95,0,1,0,0,1,1,0,0,3,4
2020,51010,Castel San Niccolò,AR,96,0,0,0,0,0,0,0,0,4,4
2020,51010,Castel San Niccolò,AR,97,0,0,0,0,0,0,0,0,4,4
2020,51010,Castel San Niccolò,AR,98,0,0,0,0,0,0,0,0,2,2
2020,51010,Castel San Niccolò,AR,99,0,0,0,0,0,0,0,0,0,0
2020,51010,Castel San Niccolò,AR,100 e più,0,0,0,1,1,0,0,0,0,0
2020,51011,Castiglion Fibocchi,AR,0,5,0,0,0,5,7,0,0,0,7
2020,51011,Castiglion Fibocchi,AR,1,3,0,0,0,3,7,0,0,0,7
2020,51011,Castiglion Fibocchi,AR,2,5,0,0,0,5,6,0,0,0,6
2020,51011,Castiglion Fibocchi,AR,3,10,0,0,0,10,1,0,0,0,1
2020,51011,Castiglion Fibocchi,AR,4,2,0,0,0,2,9,0,0,0,9
2020,51011,Castiglion Fibocchi,AR,5,13,0,0,0,13,3,0,0,0,3
2020,51011,Castiglion Fibocchi,AR,6,9,0,0,0,9,6,0,0,0,6
2020,51011,Castiglion Fibocchi,AR,7,13,0,0,0,13,8,0,0,0,8
2020,51011,Castiglion Fibocchi,AR,8,8,0,0,0,8,10,0,0,0,10
2020,51011,Castiglion Fibocchi,AR,9,12,0,0,0,12,10,0,0,0,10
2020,51011,Castiglion Fibocchi,AR,10,13,0,0,0,13,7,0,0,0,7
2020,51011,Castiglion Fibocchi,AR,11,14,0,0,0,14,8,0,0,0,8
2020,51011,Castiglion Fibocchi,AR,12,9,0,0,0,9,13,0,0,0,13
2020,51011,Castiglion Fibocchi,AR,13,14,0,0,0,14,11,0,0,0,11
2020,51011,Castiglion Fibocchi,AR,14,9,0,0,0,9,8,0,0,0,8
2020,51011,Castiglion Fibocchi,AR,15,17,0,0,0,17,10,0,0,0,10
2020,51011,Castiglion Fibocchi,AR,16,8,0,0,0,8,6,0,0,0,6
2020,51011,Castiglion Fibocchi,AR,17,10,0,0,0,10,15,0,0,0,15
2020,51011,Castiglion Fibocchi,AR,18,9,0,0,0,9,9,0,0,0,9
2020,51011,Castiglion Fibocchi,AR,19,7,0,0,0,7,7,0,0,0,7
2020,51011,Castiglion Fibocchi,AR,20,8,0,0,0,8,5,0,0,0,5
2020,51011,Castiglion Fibocchi,AR,21,16,0,0,0,16,10,1,0,0,11
2020,51011,Castiglion Fibocchi,AR,22,9,0,0,0,9,9,0,0,0,9
2020,51011,Castiglion Fibocchi,AR,23,11,0,0,0,11,11,0,0,0,11
2020,51011,Castiglion Fibocchi,AR,24,13,0,0,0,13,6,0,0,0,6
2020,51011,Castiglion Fibocchi,AR,25,12,0,0,0,12,8,0,0,0,8
2020,51011,Castiglion Fibocchi,AR,26,6,0,0,0,6,11,2,0,0,13
2020,51011,Castiglion Fibocchi,AR,27,14,0,0,0,14,3,1,0,0,4
2020,51011,Castiglion Fibocchi,AR,28,10,0,0,0,10,8,2,0,0,10
2020,51011,Castiglion Fibocchi,AR,29,12,2,0,0,14,11,1,0,0,12
2020,51011,Castiglion Fibocchi,AR,30,11,1,0,0,12,7,3,0,0,10
2020,51011,Castiglion Fibocchi,AR,31,15,2,1,0,18,6,2,0,0,8
2020,51011,Castiglion Fibocchi,AR,32,7,1,0,0,8,5,5,0,0,10
2020,51011,Castiglion Fibocchi,AR,33,7,2,1,0,10,4,5,0,0,9
2020,51011,Castiglion Fibocchi,AR,34,12,3,0,0,15,9,6,0,0,15
2020,51011,Castiglion Fibocchi,AR,35,8,6,1,0,15,4,6,0,0,10
2020,51011,Castiglion Fibocchi,AR,36,3,5,0,0,8,5,9,0,0,14
2020,51011,Castiglion Fibocchi,AR,37,4,8,0,0,12,7,3,0,0,10
2020,51011,Castiglion Fibocchi,AR,38,6,4,0,0,10,3,2,1,0,6
2020,51011,Castiglion Fibocchi,AR,39,10,4,0,0,14,8,6,1,0,15
2020,51011,Castiglion Fibocchi,AR,40,2,7,2,0,11,1,6,0,0,7
2020,51011,Castiglion Fibocchi,AR,41,3,4,0,0,7,3,8,1,1,13
2020,51011,Castiglion Fibocchi,AR,42,4,8,0,0,12,3,12,0,0,15
2020,51011,Castiglion Fibocchi,AR,43,4,8,1,0,13,5,11,0,0,16
2020,51011,Castiglion Fibocchi,AR,44,11,7,4,0,22,4,12,1,0,17
2020,51011,Castiglion Fibocchi,AR,45,4,9,1,0,14,6,10,3,1,20
2020,51011,Castiglion Fibocchi,AR,46,1,12,1,0,14,5,10,1,1,17
2020,51011,Castiglion Fibocchi,AR,47,1,15,1,0,17,3,22,1,0,26
2020,51011,Castiglion Fibocchi,AR,48,6,7,0,0,13,4,7,0,0,11
2020,51011,Castiglion Fibocchi,AR,49,4,14,0,1,19,3,15,1,0,19
2020,51011,Castiglion Fibocchi,AR,50,6,15,2,0,23,3,9,2,0,14
2020,51011,Castiglion Fibocchi,AR,51,4,15,0,0,19,5,13,4,0,22
2020,51011,Castiglion Fibocchi,AR,52,3,10,1,0,14,1,12,3,2,18
2020,51011,Castiglion Fibocchi,AR,53,1,14,1,0,16,2,18,1,0,21
2020,51011,Castiglion Fibocchi,AR,54,2,18,2,0,22,2,9,1,1,13
2020,51011,Castiglion Fibocchi,AR,55,0,12,2,0,14,2,16,2,1,21
2020,51011,Castiglion Fibocchi,AR,56,0,13,1,0,14,1,14,0,0,15
2020,51011,Castiglion Fibocchi,AR,57,2,13,1,0,16,0,11,1,0,12
2020,51011,Castiglion Fibocchi,AR,58,3,13,0,0,16,1,17,1,0,19
2020,51011,Castiglion Fibocchi,AR,59,0,11,3,0,14,1,11,4,1,17
2020,51011,Castiglion Fibocchi,AR,60,2,12,1,0,15,0,10,2,1,13
2020,51011,Castiglion Fibocchi,AR,61,1,14,1,0,16,2,9,1,1,13
2020,51011,Castiglion Fibocchi,AR,62,1,9,1,1,12,0,18,0,0,18
2020,51011,Castiglion Fibocchi,AR,63,0,15,2,0,17,1,7,3,1,12
2020,51011,Castiglion Fibocchi,AR,64,1,10,0,0,11,0,15,1,1,17
2020,51011,Castiglion Fibocchi,AR,65,1,10,0,0,11,0,19,0,1,20
2020,51011,Castiglion Fibocchi,AR,66,1,13,0,0,14,1,10,1,2,14
2020,51011,Castiglion Fibocchi,AR,67,0,15,2,0,17,0,8,0,2,10
2020,51011,Castiglion Fibocchi,AR,68,0,13,0,0,13,0,8,2,1,11
2020,51011,Castiglion Fibocchi,AR,69,1,15,0,0,16,2,11,1,0,14
2020,51011,Castiglion Fibocchi,AR,70,1,13,0,0,14,1,12,0,4,17
2020,51011,Castiglion Fibocchi,AR,71,0,11,1,1,13,0,11,2,2,15
2020,51011,Castiglion Fibocchi,AR,72,0,12,1,0,13,1,14,1,5,21
2020,51011,Castiglion Fibocchi,AR,73,1,10,2,0,13,0,10,0,4,14
2020,51011,Castiglion Fibocchi,AR,74,0,6,1,1,8,0,7,0,5,12
2020,51011,Castiglion Fibocchi,AR,75,1,10,0,0,11,1,8,0,4,13
2020,51011,Castiglion Fibocchi,AR,76,0,11,0,2,13,0,7,0,6,13
2020,51011,Castiglion Fibocchi,AR,77,1,6,0,3,10,0,8,0,3,11
2020,51011,Castiglion Fibocchi,AR,78,0,5,0,0,5,1,5,0,3,9
2020,51011,Castiglion Fibocchi,AR,79,0,4,0,2,6,0,5,0,1,6
2020,51011,Castiglion Fibocchi,AR,80,0,7,1,1,9,0,4,1,5,10
2020,51011,Castiglion Fibocchi,AR,81,0,7,1,1,9,0,4,0,6,10
2020,51011,Castiglion Fibocchi,AR,82,1,4,0,0,5,1,2,0,2,5
2020,51011,Castiglion Fibocchi,AR,83,1,4,0,1,6,2,4,0,2,8
2020,51011,Castiglion Fibocchi,AR,84,0,1,0,1,2,0,1,0,6,7
2020,51011,Castiglion Fibocchi,AR,85,1,5,0,0,6,1,3,0,5,9
2020,51011,Castiglion Fibocchi,AR,86,0,3,0,0,3,0,1,0,1,2
2020,51011,Castiglion Fibocchi,AR,87,0,5,0,2,7,1,0,0,1,2
2020,51011,Castiglion Fibocchi,AR,88,0,1,0,2,3,1,0,0,7,8
2020,51011,Castiglion Fibocchi,AR,89,0,2,0,2,4,0,0,0,3,3
2020,51011,Castiglion Fibocchi,AR,90,0,2,0,0,2,0,0,0,3,3
2020,51011,Castiglion Fibocchi,AR,91,0,0,0,2,2,0,0,0,3,3
2020,51011,Castiglion Fibocchi,AR,92,0,0,0,0,0,0,0,0,2,2
2020,51011,Castiglion Fibocchi,AR,93,0,0,0,0,0,0,0,0,2,2
2020,51011,Castiglion Fibocchi,AR,94,0,0,0,1,1,0,0,0,1,1
2020,51011,Castiglion Fibocchi,AR,95,0,0,0,0,0,0,0,0,2,2
2020,51011,Castiglion Fibocchi,AR,96,0,0,0,0,0,0,0,0,0,0
2020,51011,Castiglion Fibocchi,AR,97,0,0,0,0,0,0,0,0,0,0
2020,51011,Castiglion Fibocchi,AR,98,0,0,0,0,0,0,0,0,0,0
2020,51011,Castiglion Fibocchi,AR,99,1,0,0,0,1,0,0,0,2,2
2020,51011,Castiglion Fibocchi,AR,100 e più,0,0,0,0,0,0,0,0,1,1
2020,51012,Castiglion Fiorentino,AR,0,47,0,0,0,47,43,0,0,0,43
2020,51012,Castiglion Fiorentino,AR,1,56,0,0,0,56,38,0,0,0,38
2020,51012,Castiglion Fiorentino,AR,2,42,0,0,0,42,42,0,0,0,42
2020,51012,Castiglion Fiorentino,AR,3,68,0,0,0,68,43,0,0,0,43
2020,51012,Castiglion Fiorentino,AR,4,67,0,0,0,67,40,0,0,0,40
2020,51012,Castiglion Fiorentino,AR,5,59,0,0,0,59,43,0,0,0,43
2020,51012,Castiglion Fiorentino,AR,6,58,0,0,0,58,45,0,0,0,45
2020,51012,Castiglion Fiorentino,AR,7,66,0,0,0,66,53,0,0,0,53
2020,51012,Castiglion Fiorentino,AR,8,53,0,0,0,53,59,0,0,0,59
2020,51012,Castiglion Fiorentino,AR,9,55,0,0,0,55,65,0,0,0,65
2020,51012,Castiglion Fiorentino,AR,10,53,0,0,0,53,59,0,0,0,59
2020,51012,Castiglion Fiorentino,AR,11,54,0,0,0,54,48,0,0,0,48
2020,51012,Castiglion Fiorentino,AR,12,66,0,0,0,66,52,0,0,0,52
2020,51012,Castiglion Fiorentino,AR,13,69,0,0,0,69,56,0,0,0,56
2020,51012,Castiglion Fiorentino,AR,14,57,0,0,0,57,67,0,0,0,67
2020,51012,Castiglion Fiorentino,AR,15,58,0,0,0,58,64,0,0,0,64
2020,51012,Castiglion Fiorentino,AR,16,66,0,0,0,66,64,0,0,0,64
2020,51012,Castiglion Fiorentino,AR,17,50,0,0,0,50,57,0,0,0,57
2020,51012,Castiglion Fiorentino,AR,18,67,0,0,0,67,61,0,0,0,61
2020,51012,Castiglion Fiorentino,AR,19,77,0,0,0,77,56,0,0,0,56
2020,51012,Castiglion Fiorentino,AR,20,62,0,0,0,62,65,1,0,0,66
2020,51012,Castiglion Fiorentino,AR,21,57,0,0,0,57,53,1,0,0,54
2020,51012,Castiglion Fiorentino,AR,22,60,0,0,0,60,50,1,0,0,51
2020,51012,Castiglion Fiorentino,AR,23,65,0,0,0,65,59,3,0,0,62
2020,51012,Castiglion Fiorentino,AR,24,47,2,0,0,49,59,6,0,0,65
2020,51012,Castiglion Fiorentino,AR,25,64,2,0,0,66,52,7,0,0,59
2020,51012,Castiglion Fiorentino,AR,26,62,3,0,0,65,66,4,0,0,70
2020,51012,Castiglion Fiorentino,AR,27,70,3,0,0,73,48,11,0,0,59
2020,51012,Castiglion Fiorentino,AR,28,76,10,0,0,86,50,12,0,0,62
2020,51012,Castiglion Fiorentino,AR,29,59,6,0,0,65,54,20,0,0,74
2020,51012,Castiglion Fiorentino,AR,30,61,7,0,0,68,46,15,0,0,61
2020,51012,Castiglion Fiorentino,AR,31,66,13,0,0,79,36,28,0,0,64
2020,51012,Castiglion Fiorentino,AR,32,47,27,1,0,75,40,28,0,0,68
2020,51012,Castiglion Fiorentino,AR,33,55,30,0,0,85,41,41,1,0,83
2020,51012,Castiglion Fiorentino,AR,34,42,23,1,0,66,45,36,2,0,83
2020,51012,Castiglion Fiorentino,AR,35,49,24,1,0,74,35,34,1,0,70
2020,51012,Castiglion Fiorentino,AR,36,57,25,0,0,82,31,45,5,0,81
2020,51012,Castiglion Fiorentino,AR,37,43,48,1,0,92,32,31,1,0,64
2020,51012,Castiglion Fiorentino,AR,38,31,40,4,0,75,33,39,3,2,77
2020,51012,Castiglion Fiorentino,AR,39,30,52,1,0,83,35,46,5,0,86
2020,51012,Castiglion Fiorentino,AR,40,25,43,4,0,72,30,61,2,1,94
2020,51012,Castiglion Fiorentino,AR,41,45,33,1,1,80,21,80,5,1,107
2020,51012,Castiglion Fiorentino,AR,42,37,49,3,0,89,19,54,11,1,85
2020,51012,Castiglion Fiorentino,AR,43,21,56,5,0,82,27,73,1,2,103
2020,51012,Castiglion Fiorentino,AR,44,30,53,2,0,85,14,63,6,0,83
2020,51012,Castiglion Fiorentino,AR,45,39,64,2,0,105,17,67,6,3,93
2020,51012,Castiglion Fiorentino,AR,46,29,50,4,1,84,19,88,14,4,125
2020,51012,Castiglion Fiorentino,AR,47,20,67,6,0,93,18,77,8,1,104
2020,51012,Castiglion Fiorentino,AR,48,24,83,7,0,114,20,77,1,0,98
2020,51012,Castiglion Fiorentino,AR,49,18,70,6,1,95,15,74,5,3,97
2020,51012,Castiglion Fiorentino,AR,50,27,59,13,0,99,13,70,10,3,96
2020,51012,Castiglion Fiorentino,AR,51,27,92,6,1,126,8,82,9,1,100
2020,51012,Castiglion Fiorentino,AR,52,19,84,7,0,110,17,85,10,0,112
2020,51012,Castiglion Fiorentino,AR,53,18,74,4,0,96,9,87,5,3,104
2020,51012,Castiglion Fiorentino,AR,54,22,66,5,0,93,19,87,7,1,114
2020,51012,Castiglion Fiorentino,AR,55,25,74,10,1,110,9,99,9,5,122
2020,51012,Castiglion Fiorentino,AR,56,11,92,4,2,109,6,85,6,1,98
2020,51012,Castiglion Fiorentino,AR,57,14,64,7,2,87,5,70,7,4,86
2020,51012,Castiglion Fiorentino,AR,58,11,78,7,1,97,3,85,12,6,106
2020,51012,Castiglion Fiorentino,AR,59,8,87,2,1,98,4,78,15,4,101
2020,51012,Castiglion Fiorentino,AR,60,10,73,4,1,88,4,80,4,8,96
2020,51012,Castiglion Fiorentino,AR,61,7,84,4,1,96,5,91,3,3,102
2020,51012,Castiglion Fiorentino,AR,62,2,82,3,1,88,3,66,4,4,77
2020,51012,Castiglion Fiorentino,AR,63,10,75,6,3,94,3,70,4,7,84
2020,51012,Castiglion Fiorentino,AR,64,5,60,3,1,69,4,74,4,12,94
2020,51012,Castiglion Fiorentino,AR,65,8,65,3,7,83,7,66,4,12,89
2020,51012,Castiglion Fiorentino,AR,66,3,97,6,0,106,1,74,4,9,88
2020,51012,Castiglion Fiorentino,AR,67,7,69,5,2,83,1,55,4,8,68
2020,51012,Castiglion Fiorentino,AR,68,5,59,3,7,74,3,59,1,9,72
2020,51012,Castiglion Fiorentino,AR,69,8,70,3,3,84,3,59,2,11,75
2020,51012,Castiglion Fiorentino,AR,70,7,54,1,4,66,2,55,4,11,72
2020,51012,Castiglion Fiorentino,AR,71,4,54,4,3,65,2,68,3,10,83
2020,51012,Castiglion Fiorentino,AR,72,9,82,0,6,97,3,58,3,22,86
2020,51012,Castiglion Fiorentino,AR,73,5,62,3,2,72,2,39,0,25,66
2020,51012,Castiglion Fiorentino,AR,74,4,57,0,7,68,3,43,5,22,73
2020,51012,Castiglion Fiorentino,AR,75,8,42,0,6,56,1,44,4,26,75
2020,51012,Castiglion Fiorentino,AR,76,3,39,1,1,44,3,26,1,19,49
2020,51012,Castiglion Fiorentino,AR,77,4,40,1,4,49,1,25,1,27,54
2020,51012,Castiglion Fiorentino,AR,78,0,27,1,6,34,2,29,0,28,59
2020,51012,Castiglion Fiorentino,AR,79,9,41,0,6,56,2,27,1,22,52
2020,51012,Castiglion Fiorentino,AR,80,11,43,0,10,64,2,24,1,27,54
2020,51012,Castiglion Fiorentino,AR,81,2,42,1,3,48,5,33,0,33,71
2020,51012,Castiglion Fiorentino,AR,82,5,29,1,8,43,2,23,0,27,52
2020,51012,Castiglion Fiorentino,AR,83,3,35,0,7,45,4,23,2,36,65
2020,51012,Castiglion Fiorentino,AR,84,5,25,0,6,36,0,15,0,32,47
2020,51012,Castiglion Fiorentino,AR,85,4,26,0,6,36,0,16,3,27,46
2020,51012,Castiglion Fiorentino,AR,86,1,20,0,8,29,1,12,0,22,35
2020,51012,Castiglion Fiorentino,AR,87,1,22,0,8,31,1,8,0,24,33
2020,51012,Castiglion Fiorentino,AR,88,1,13,0,3,17,4,0,0,22,26
2020,51012,Castiglion Fiorentino,AR,89,2,14,0,9,25,1,4,0,30,35
2020,51012,Castiglion Fiorentino,AR,90,1,11,0,11,23,4,2,0,28,34
2020,51012,Castiglion Fiorentino,AR,91,0,5,0,4,9,1,2,0,23,26
2020,51012,Castiglion Fiorentino,AR,92,0,6,0,5,11,1,1,1,15,18
2020,51012,Castiglion Fiorentino,AR,93,0,6,0,3,9,0,0,0,15,15
2020,51012,Castiglion Fiorentino,AR,94,0,2,0,1,3,0,2,0,16,18
2020,51012,Castiglion Fiorentino,AR,95,1,1,0,3,5,0,1,0,7,8
2020,51012,Castiglion Fiorentino,AR,96,0,1,0,1,2,0,0,0,9,9
2020,51012,Castiglion Fiorentino,AR,97,0,0,0,0,0,0,0,0,11,11
2020,51012,Castiglion Fiorentino,AR,98,0,0,0,0,0,0,0,0,2,2
2020,51012,Castiglion Fiorentino,AR,99,0,0,0,0,0,0,0,0,2,2
2020,51012,Castiglion Fiorentino,AR,100 e più,0,1,0,0,1,0,0,0,1,1
2020,51013,Cavriglia,AR,0,30,0,0,0,30,19,0,0,0,19
2020,51013,Cavriglia,AR,1,33,0,0,0,33,19,0,0,0,19
2020,51013,Cavriglia,AR,2,33,0,0,0,33,24,0,0,0,24
2020,51013,Cavriglia,AR,3,32,0,0,0,32,26,0,0,0,26
2020,51013,Cavriglia,AR,4,34,0,0,0,34,37,0,0,0,37
2020,51013,Cavriglia,AR,5,37,0,0,0,37,27,0,0,0,27
2020,51013,Cavriglia,AR,6,48,0,0,0,48,43,0,0,0,43
2020,51013,Cavriglia,AR,7,58,0,0,0,58,28,0,0,0,28
2020,51013,Cavriglia,AR,8,45,0,0,0,45,35,0,0,0,35
2020,51013,Cavriglia,AR,9,46,0,0,0,46,44,0,0,0,44
2020,51013,Cavriglia,AR,10,47,0,0,0,47,44,0,0,0,44
2020,51013,Cavriglia,AR,11,52,0,0,0,52,40,0,0,0,40
2020,51013,Cavriglia,AR,12,48,0,0,0,48,56,0,0,0,56
2020,51013,Cavriglia,AR,13,46,0,0,0,46,43,0,0,0,43
2020,51013,Cavriglia,AR,14,43,0,0,0,43,58,0,0,0,58
2020,51013,Cavriglia,AR,15,40,0,0,0,40,51,0,0,0,51
2020,51013,Cavriglia,AR,16,51,0,0,0,51,47,0,0,0,47
2020,51013,Cavriglia,AR,17,55,0,0,0,55,46,0,0,0,46
2020,51013,Cavriglia,AR,18,57,0,0,0,57,48,0,0,0,48
2020,51013,Cavriglia,AR,19,49,0,0,0,49,50,0,0,0,50
2020,51013,Cavriglia,AR,20,49,0,0,0,49,37,1,0,0,38
2020,51013,Cavriglia,AR,21,41,0,0,0,41,45,1,0,0,46
2020,51013,Cavriglia,AR,22,41,0,0,0,41,48,2,0,0,50
2020,51013,Cavriglia,AR,23,45,1,0,0,46,33,2,0,0,35
2020,51013,Cavriglia,AR,24,52,0,0,0,52,39,2,0,0,41
2020,51013,Cavriglia,AR,25,44,1,0,0,45,37,4,0,0,41
2020,51013,Cavriglia,AR,26,35,1,0,0,36,29,5,1,0,35
2020,51013,Cavriglia,AR,27,42,3,0,0,45,31,7,0,0,38
2020,51013,Cavriglia,AR,28,33,3,0,0,36,39,11,0,0,50
2020,51013,Cavriglia,AR,29,36,6,0,0,42,44,3,0,0,47
2020,51013,Cavriglia,AR,30,22,6,0,0,28,40,16,2,0,58
2020,51013,Cavriglia,AR,31,36,6,0,0,42,33,7,1,0,41
2020,51013,Cavriglia,AR,32,39,8,0,0,47,23,14,1,0,38
2020,51013,Cavriglia,AR,33,49,13,1,0,63,30,17,1,0,48
2020,51013,Cavriglia,AR,34,33,9,0,0,42,21,28,0,0,49
2020,51013,Cavriglia,AR,35,40,17,0,0,57,27,29,0,0,56
2020,51013,Cavriglia,AR,36,29,20,2,0,51,25,22,1,0,48
2020,51013,Cavriglia,AR,37,32,24,0,0,56,21,27,2,0,50
2020,51013,Cavriglia,AR,38,23,32,0,0,55,24,40,1,1,66
2020,51013,Cavriglia,AR,39,31,23,0,0,54,19,41,1,0,61
2020,51013,Cavriglia,AR,40,31,45,2,0,78,21,30,3,0,54
2020,51013,Cavriglia,AR,41,28,31,1,0,60,12,36,2,0,50
2020,51013,Cavriglia,AR,42,28,32,2,1,63,27,40,2,0,69
2020,51013,Cavriglia,AR,43,34,41,0,0,75,25,48,6,2,81
2020,51013,Cavriglia,AR,44,33,38,5,0,76,15,41,5,1,62
2020,51013,Cavriglia,AR,45,33,46,8,0,87,20,58,12,1,91
2020,51013,Cavriglia,AR,46,27,43,3,0,73,21,63,6,0,90
2020,51013,Cavriglia,AR,47,24,61,7,0,92,17,64,7,0,88
2020,51013,Cavriglia,AR,48,27,50,6,0,83,8,58,7,1,74
2020,51013,Cavriglia,AR,49,18,74,4,0,96,17,65,6,1,89
2020,51013,Cavriglia,AR,50,23,64,9,0,96,11,69,12,1,93
2020,51013,Cavriglia,AR,51,17,63,10,0,90,11,63,5,3,82
2020,51013,Cavriglia,AR,52,16,60,2,1,79,17,56,9,0,82
2020,51013,Cavriglia,AR,53,27,61,8,0,96,7,69,7,4,87
2020,51013,Cavriglia,AR,54,20,69,10,0,99,6,69,7,8,90
2020,51013,Cavriglia,AR,55,24,48,8,2,82,10,58,5,3,76
2020,51013,Cavriglia,AR,56,12,68,4,2,86,11,54,5,5,75
2020,51013,Cavriglia,AR,57,6,48,8,2,64,3,49,8,1,61
2020,51013,Cavriglia,AR,58,13,65,7,1,86,3,60,11,3,77
2020,51013,Cavriglia,AR,59,7,58,5,3,73,4,44,9,5,62
2020,51013,Cavriglia,AR,60,3,47,5,1,56,5,54,1,2,62
2020,51013,Cavriglia,AR,61,3,46,6,3,58,8,48,1,4,61
2020,51013,Cavriglia,AR,62,7,48,4,0,59,4,42,4,4,54
2020,51013,Cavriglia,AR,63,10,44,7,0,61,2,50,4,2,58
2020,51013,Cavriglia,AR,64,7,39,7,0,53,2,38,3,7,50
2020,51013,Cavriglia,AR,65,8,36,2,3,49,4,29,4,6,43
2020,51013,Cavriglia,AR,66,5,30,4,1,40,5,36,2,2,45
2020,51013,Cavriglia,AR,67,1,41,2,1,45,2,46,5,10,63
2020,51013,Cavriglia,AR,68,1,49,1,2,53,3,33,1,8,45
2020,51013,Cavriglia,AR,69,5,38,1,3,47,2,49,1,14,66
2020,51013,Cavriglia,AR,70,1,52,2,5,60,0,46,0,11,57
2020,51013,Cavriglia,AR,71,2,39,6,5,52,2,37,3,11,53
2020,51013,Cavriglia,AR,72,3,42,1,0,46,1,61,2,17,81
2020,51013,Cavriglia,AR,73,2,53,1,1,57,0,42,1,14,57
2020,51013,Cavriglia,AR,74,2,38,2,4,46,3,32,2,15,52
2020,51013,Cavriglia,AR,75,5,41,1,9,56,2,32,0,5,39
2020,51013,Cavriglia,AR,76,2,48,1,7,58,1,25,2,14,42
2020,51013,Cavriglia,AR,77,4,31,1,5,41,6,27,2,18,53
2020,51013,Cavriglia,AR,78,6,29,1,4,40,2,17,1,20,40
2020,51013,Cavriglia,AR,79,5,27,2,4,38,1,19,0,21,41
2020,51013,Cavriglia,AR,80,7,35,2,4,48,1,13,0,13,27
2020,51013,Cavriglia,AR,81,1,20,0,6,27,4,13,0,21,38
2020,51013,Cavriglia,AR,82,2,29,1,9,41,0,17,2,29,48
2020,51013,Cavriglia,AR,83,4,19,1,8,32,0,14,1,26,41
2020,51013,Cavriglia,AR,84,3,13,1,6,23,2,10,0,20,32
2020,51013,Cavriglia,AR,85,2,20,1,5,28,1,7,0,18,26
2020,51013,Cavriglia,AR,86,1,13,0,4,18,1,8,0,16,25
2020,51013,Cavriglia,AR,87,0,4,0,2,6,2,4,0,16,22
2020,51013,Cavriglia,AR,88,2,8,0,7,17,1,5,0,16,22
2020,51013,Cavriglia,AR,89,1,7,1,3,12,0,1,0,21,22
2020,51013,Cavriglia,AR,90,1,8,0,2,11,0,1,0,14,15
2020,51013,Cavriglia,AR,91,0,3,0,2,5,0,1,0,13,14
2020,51013,Cavriglia,AR,92,0,1,0,2,3,0,0,0,13,13
2020,51013,Cavriglia,AR,93,1,1,0,1,3,0,0,0,7,7
2020,51013,Cavriglia,AR,94,0,1,0,7,8,0,0,0,7,7
2020,51013,Cavriglia,AR,95,0,0,0,0,0,0,0,0,10,10
2020,51013,Cavriglia,AR,96,0,0,0,0,0,0,0,0,7,7
2020,51013,Cavriglia,AR,97,0,0,0,0,0,0,0,0,6,6
2020,51013,Cavriglia,AR,98,0,0,0,0,0,0,0,0,3,3
2020,51013,Cavriglia,AR,99,0,0,0,0,0,0,0,0,3,3
2020,51013,Cavriglia,AR,100 e più,0,0,0,0,0,0,0,0,0,0
2020,51014,Chitignano,AR,0,3,0,0,0,3,2,0,0,0,2
2020,51014,Chitignano,AR,1,2,0,0,0,2,7,0,0,0,7
2020,51014,Chitignano,AR,2,1,0,0,0,1,0,0,0,0,0
2020,51014,Chitignano,AR,3,1,0,0,0,1,3,0,0,0,3
2020,51014,Chitignano,AR,4,3,0,0,0,3,1,0,0,0,1
2020,51014,Chitignano,AR,5,3,0,0,0,3,3,0,0,0,3
2020,51014,Chitignano,AR,6,4,0,0,0,4,2,0,0,0,2
2020,51014,Chitignano,AR,7,0,0,0,0,0,1,0,0,0,1
2020,51014,Chitignano,AR,8,5,0,0,0,5,2,0,0,0,2
2020,51014,Chitignano,AR,9,2,0,0,0,2,5,0,0,0,5
2020,51014,Chitignano,AR,10,1,0,0,0,1,2,0,0,0,2
2020,51014,Chitignano,AR,11,1,0,0,0,1,3,0,0,0,3
2020,51014,Chitignano,AR,12,2,0,0,0,2,2,0,0,0,2
2020,51014,Chitignano,AR,13,2,0,0,0,2,0,0,0,0,0
2020,51014,Chitignano,AR,14,5,0,0,0,5,4,0,0,0,4
2020,51014,Chitignano,AR,15,5,0,0,0,5,4,0,0,0,4
2020,51014,Chitignano,AR,16,2,0,0,0,2,2,0,0,0,2
2020,51014,Chitignano,AR,17,4,0,0,0,4,3,0,0,0,3
2020,51014,Chitignano,AR,18,5,0,0,0,5,5,0,0,0,5
2020,51014,Chitignano,AR,19,3,0,0,0,3,5,0,0,0,5
2020,51014,Chitignano,AR,20,5,0,0,0,5,5,0,0,0,5
2020,51014,Chitignano,AR,21,5,0,0,0,5,4,0,0,0,4
2020,51014,Chitignano,AR,22,4,0,0,0,4,6,0,0,0,6
2020,51014,Chitignano,AR,23,7,1,0,0,8,4,0,0,0,4
2020,51014,Chitignano,AR,24,2,0,0,0,2,7,0,0,0,7
2020,51014,Chitignano,AR,25,4,0,0,0,4,4,1,0,0,5
2020,51014,Chitignano,AR,26,4,0,0,0,4,5,0,0,0,5
2020,51014,Chitignano,AR,27,3,0,0,0,3,4,0,0,0,4
2020,51014,Chitignano,AR,28,3,0,0,0,3,1,0,0,0,1
2020,51014,Chitignano,AR,29,5,0,0,0,5,0,0,0,0,0
2020,51014,Chitignano,AR,30,3,0,0,0,3,1,1,0,0,2
2020,51014,Chitignano,AR,31,5,1,0,0,6,5,1,0,0,6
2020,51014,Chitignano,AR,32,3,0,0,0,3,3,1,0,0,4
2020,51014,Chitignano,AR,33,5,0,0,0,5,3,1,0,0,4
2020,51014,Chitignano,AR,34,5,0,0,0,5,2,1,0,0,3
2020,51014,Chitignano,AR,35,2,0,0,0,2,4,3,0,0,7
2020,51014,Chitignano,AR,36,2,3,0,0,5,2,1,0,0,3
2020,51014,Chitignano,AR,37,3,1,0,0,4,2,3,0,0,5
2020,51014,Chitignano,AR,38,4,1,0,0,5,4,3,0,0,7
2020,51014,Chitignano,AR,39,4,2,0,0,6,4,1,0,0,5
2020,51014,Chitignano,AR,40,2,1,0,0,3,1,3,0,0,4
2020,51014,Chitignano,AR,41,3,2,0,0,5,1,2,0,0,3
2020,51014,Chitignano,AR,42,3,4,0,0,7,0,5,0,0,5
2020,51014,Chitignano,AR,43,4,4,1,0,9,0,6,0,0,6
2020,51014,Chitignano,AR,44,4,3,0,0,7,0,4,0,0,4
2020,51014,Chitignano,AR,45,2,1,0,0,3,1,1,0,0,2
2020,51014,Chitignano,AR,46,1,2,0,0,3,0,8,0,0,8
2020,51014,Chitignano,AR,47,3,7,0,0,10,1,5,1,0,7
2020,51014,Chitignano,AR,48,0,4,1,0,5,0,2,2,1,5
2020,51014,Chitignano,AR,49,3,3,0,0,6,0,8,1,0,9
2020,51014,Chitignano,AR,50,0,5,0,0,5,1,3,0,0,4
2020,51014,Chitignano,AR,51,3,5,0,0,8,1,5,1,0,7
2020,51014,Chitignano,AR,52,0,7,1,0,8,2,5,1,0,8
2020,51014,Chitignano,AR,53,0,7,1,0,8,0,5,2,0,7
2020,51014,Chitignano,AR,54,2,5,0,0,7,1,2,3,0,6
2020,51014,Chitignano,AR,55,0,1,1,0,2,0,5,1,0,6
2020,51014,Chitignano,AR,56,1,9,0,0,10,3,8,0,0,11
2020,51014,Chitignano,AR,57,1,3,0,0,4,0,10,0,0,10
2020,51014,Chitignano,AR,58,1,3,2,0,6,0,4,0,0,4
2020,51014,Chitignano,AR,59,0,6,0,0,6,2,11,1,0,14
2020,51014,Chitignano,AR,60,0,5,0,0,5,2,2,1,0,5
2020,51014,Chitignano,AR,61,1,13,0,0,14,0,6,0,0,6
2020,51014,Chitignano,AR,62,0,9,0,0,9,1,15,0,1,17
2020,51014,Chitignano,AR,63,2,4,0,0,6,1,2,0,0,3
2020,51014,Chitignano,AR,64,0,4,0,0,4,1,2,0,0,3
2020,51014,Chitignano,AR,65,1,4,0,0,5,0,7,0,1,8
2020,51014,Chitignano,AR,66,1,4,1,0,6,0,5,0,0,5
2020,51014,Chitignano,AR,67,0,8,0,0,8,0,6,0,1,7
2020,51014,Chitignano,AR,68,1,4,0,1,6,1,5,0,0,6
2020,51014,Chitignano,AR,69,1,3,0,1,5,0,5,0,1,6
2020,51014,Chitignano,AR,70,0,5,0,0,5,0,2,1,0,3
2020,51014,Chitignano,AR,71,1,8,1,1,11,0,9,0,0,9
2020,51014,Chitignano,AR,72,0,6,0,0,6,1,5,0,0,6
2020,51014,Chitignano,AR,73,1,2,0,1,4,0,5,0,1,6
2020,51014,Chitignano,AR,74,0,7,1,0,8,0,7,0,0,7
2020,51014,Chitignano,AR,75,1,6,0,1,8,0,5,0,1,6
2020,51014,Chitignano,AR,76,0,7,0,1,8,0,1,0,1,2
2020,51014,Chitignano,AR,77,0,5,0,0,5,0,2,0,1,3
2020,51014,Chitignano,AR,78,0,4,1,0,5,0,2,0,3,5
2020,51014,Chitignano,AR,79,0,3,0,0,3,0,4,0,4,8
2020,51014,Chitignano,AR,80,0,4,0,1,5,0,3,0,5,8
2020,51014,Chitignano,AR,81,0,3,0,0,3,0,0,0,2,2
2020,51014,Chitignano,AR,82,0,3,0,0,3,0,3,1,2,6
2020,51014,Chitignano,AR,83,0,2,0,2,4,0,5,0,1,6
2020,51014,Chitignano,AR,84,1,3,0,0,4,0,1,0,1,2
2020,51014,Chitignano,AR,85,0,2,0,0,2,0,1,0,4,5
2020,51014,Chitignano,AR,86,0,1,0,0,1,0,1,0,4,5
2020,51014,Chitignano,AR,87,0,1,0,1,2,0,0,0,3,3
2020,51014,Chitignano,AR,88,0,1,0,0,1,0,0,0,0,0
2020,51014,Chitignano,AR,89,0,1,0,1,2,0,0,0,5,5
2020,51014,Chitignano,AR,90,0,1,0,0,1,1,0,0,2,3
2020,51014,Chitignano,AR,91,1,2,0,0,3,0,0,0,2,2
2020,51014,Chitignano,AR,92,0,1,0,1,2,0,0,0,3,3
2020,51014,Chitignano,AR,93,1,0,0,1,2,1,0,0,3,4
2020,51014,Chitignano,AR,94,0,0,0,0,0,0,0,0,1,1
2020,51014,Chitignano,AR,95,0,0,0,0,0,0,0,0,0,0
2020,51014,Chitignano,AR,96,0,1,0,0,1,0,0,0,0,0
2020,51014,Chitignano,AR,97,0,0,0,0,0,0,0,0,1,1
2020,51014,Chitignano,AR,98,0,0,0,0,0,0,0,0,0,0
2020,51014,Chitignano,AR,99,0,0,0,0,0,0,0,0,0,0
2020,51014,Chitignano,AR,100 e più,0,0,0,0,0,0,0,0,0,0
2020,51015,Chiusi della Verna,AR,0,8,0,0,0,8,4,0,0,0,4
2020,51015,Chiusi della Verna,AR,1,6,0,0,0,6,3,0,0,0,3
2020,51015,Chiusi della Verna,AR,2,5,0,0,0,5,8,0,0,0,8
2020,51015,Chiusi della Verna,AR,3,7,0,0,0,7,5,0,0,0,5
2020,51015,Chiusi della Verna,AR,4,5,0,0,0,5,2,0,0,0,2
2020,51015,Chiusi della Verna,AR,5,9,0,0,0,9,5,0,0,0,5
2020,51015,Chiusi della Verna,AR,6,4,0,0,0,4,3,0,0,0,3
2020,51015,Chiusi della Verna,AR,7,9,0,0,0,9,6,0,0,0,6
2020,51015,Chiusi della Verna,AR,8,9,0,0,0,9,7,0,0,0,7
2020,51015,Chiusi della Verna,AR,9,10,0,0,0,10,9,0,0,0,9
2020,51015,Chiusi della Verna,AR,10,8,0,0,0,8,4,0,0,0,4
2020,51015,Chiusi della Verna,AR,11,6,0,0,0,6,7,0,0,0,7
2020,51015,Chiusi della Verna,AR,12,10,0,0,0,10,5,0,0,0,5
2020,51015,Chiusi della Verna,AR,13,6,0,0,0,6,6,0,0,0,6
2020,51015,Chiusi della Verna,AR,14,5,0,0,0,5,10,0,0,0,10
2020,51015,Chiusi della Verna,AR,15,6,0,0,0,6,4,0,0,0,4
2020,51015,Chiusi della Verna,AR,16,13,0,0,0,13,2,0,0,0,2
2020,51015,Chiusi della Verna,AR,17,6,0,0,0,6,10,0,0,0,10
2020,51015,Chiusi della Verna,AR,18,4,0,0,0,4,8,1,0,0,9
2020,51015,Chiusi della Verna,AR,19,11,0,0,0,11,3,0,0,0,3
2020,51015,Chiusi della Verna,AR,20,9,0,0,0,9,7,0,0,0,7
2020,51015,Chiusi della Verna,AR,21,8,0,0,0,8,7,0,0,0,7
2020,51015,Chiusi della Verna,AR,22,7,0,0,0,7,4,0,0,0,4
2020,51015,Chiusi della Verna,AR,23,8,1,0,0,9,11,0,0,0,11
2020,51015,Chiusi della Verna,AR,24,6,0,0,0,6,8,1,0,0,9
2020,51015,Chiusi della Verna,AR,25,6,1,0,0,7,10,0,0,0,10
2020,51015,Chiusi della Verna,AR,26,7,0,0,0,7,5,4,0,0,9
2020,51015,Chiusi della Verna,AR,27,6,0,0,0,6,5,1,0,0,6
2020,51015,Chiusi della Verna,AR,28,7,1,0,0,8,8,0,0,0,8
2020,51015,Chiusi della Verna,AR,29,6,2,0,0,8,2,0,0,0,2
2020,51015,Chiusi della Verna,AR,30,12,0,0,0,12,10,2,0,0,12
2020,51015,Chiusi della Verna,AR,31,7,1,0,0,8,6,2,0,0,8
2020,51015,Chiusi della Verna,AR,32,2,8,0,0,10,4,3,0,0,7
2020,51015,Chiusi della Verna,AR,33,4,0,0,0,4,9,2,0,0,11
2020,51015,Chiusi della Verna,AR,34,6,1,0,0,7,8,1,0,0,9
2020,51015,Chiusi della Verna,AR,35,9,2,0,0,11,11,6,1,0,18
2020,51015,Chiusi della Verna,AR,36,7,2,0,0,9,8,6,0,0,14
2020,51015,Chiusi della Verna,AR,37,6,2,0,0,8,3,4,0,0,7
2020,51015,Chiusi della Verna,AR,38,9,6,0,0,15,8,7,0,0,15
2020,51015,Chiusi della Verna,AR,39,11,2,1,0,14,0,3,0,0,3
2020,51015,Chiusi della Verna,AR,40,8,5,0,0,13,7,7,0,0,14
2020,51015,Chiusi della Verna,AR,41,7,8,1,0,16,3,8,0,0,11
2020,51015,Chiusi della Verna,AR,42,6,4,1,0,11,0,6,1,0,7
2020,51015,Chiusi della Verna,AR,43,7,7,0,0,14,8,9,1,0,18
2020,51015,Chiusi della Verna,AR,44,3,4,0,0,7,3,4,1,1,9
2020,51015,Chiusi della Verna,AR,45,4,5,0,0,9,1,4,3,0,8
2020,51015,Chiusi della Verna,AR,46,5,9,2,0,16,2,10,0,1,13
2020,51015,Chiusi della Verna,AR,47,5,5,0,0,10,1,8,3,0,12
2020,51015,Chiusi della Verna,AR,48,5,11,0,0,16,1,4,1,0,6
2020,51015,Chiusi della Verna,AR,49,7,7,1,0,15,4,9,2,1,16
2020,51015,Chiusi della Verna,AR,50,3,8,0,0,11,1,9,1,0,11
2020,51015,Chiusi della Verna,AR,51,2,8,0,0,10,0,10,0,0,10
2020,51015,Chiusi della Verna,AR,52,8,7,2,0,17,7,11,2,1,21
2020,51015,Chiusi della Verna,AR,53,4,11,0,0,15,2,14,0,0,16
2020,51015,Chiusi della Verna,AR,54,4,13,2,1,20,2,17,3,0,22
2020,51015,Chiusi della Verna,AR,55,3,17,0,0,20,2,8,2,0,12
2020,51015,Chiusi della Verna,AR,56,2,14,2,0,18,1,20,1,0,22
2020,51015,Chiusi della Verna,AR,57,3,14,0,0,17,0,6,1,1,8
2020,51015,Chiusi della Verna,AR,58,2,11,0,0,13,0,14,0,1,15
2020,51015,Chiusi della Verna,AR,59,4,12,0,0,16,2,16,0,1,19
2020,51015,Chiusi della Verna,AR,60,4,14,1,0,19,4,14,0,0,18
2020,51015,Chiusi della Verna,AR,61,2,16,1,0,19,1,10,3,2,16
2020,51015,Chiusi della Verna,AR,62,1,10,1,0,12,1,13,0,1,15
2020,51015,Chiusi della Verna,AR,63,1,7,2,0,10,1,6,0,2,9
2020,51015,Chiusi della Verna,AR,64,2,13,3,1,19,1,9,2,1,13
2020,51015,Chiusi della Verna,AR,65,3,11,0,1,15,2,12,1,0,15
2020,51015,Chiusi della Verna,AR,66,0,14,0,1,15,1,9,2,3,15
2020,51015,Chiusi della Verna,AR,67,3,10,1,1,15,1,10,0,0,11
2020,51015,Chiusi della Verna,AR,68,4,8,1,0,13,0,11,0,3,14
2020,51015,Chiusi della Verna,AR,69,3,14,0,0,17,1,7,0,5,13
2020,51015,Chiusi della Verna,AR,70,0,10,1,0,11,2,10,0,4,16
2020,51015,Chiusi della Verna,AR,71,2,6,0,1,9,0,10,0,2,12
2020,51015,Chiusi della Verna,AR,72,1,11,0,1,13,1,9,1,6,17
2020,51015,Chiusi della Verna,AR,73,2,8,2,1,13,2,7,2,6,17
2020,51015,Chiusi della Verna,AR,74,0,11,1,1,13,1,6,1,4,12
2020,51015,Chiusi della Verna,AR,75,0,2,1,1,4,0,7,0,3,10
2020,51015,Chiusi della Verna,AR,76,1,6,0,1,8,0,8,1,2,11
2020,51015,Chiusi della Verna,AR,77,1,4,0,2,7,0,4,0,5,9
2020,51015,Chiusi della Verna,AR,78,0,10,0,0,10,1,5,0,3,9
2020,51015,Chiusi della Verna,AR,79,2,6,0,2,10,1,3,0,4,8
2020,51015,Chiusi della Verna,AR,80,0,6,1,2,9,1,7,0,11,19
2020,51015,Chiusi della Verna,AR,81,0,5,0,2,7,0,4,0,1,5
2020,51015,Chiusi della Verna,AR,82,0,8,0,0,8,0,4,0,5,9
2020,51015,Chiusi della Verna,AR,83,0,7,0,3,10,0,3,0,10,13
2020,51015,Chiusi della Verna,AR,84,0,8,0,1,9,0,3,0,7,10
2020,51015,Chiusi della Verna,AR,85,2,5,0,0,7,0,3,0,6,9
2020,51015,Chiusi della Verna,AR,86,1,1,0,1,3,0,4,0,5,9
2020,51015,Chiusi della Verna,AR,87,0,5,0,2,7,0,1,0,11,12
2020,51015,Chiusi della Verna,AR,88,1,5,0,1,7,0,5,0,6,11
2020,51015,Chiusi della Verna,AR,89,2,2,0,2,6,0,0,0,3,3
2020,51015,Chiusi della Verna,AR,90,0,3,0,1,4,0,0,0,7,7
2020,51015,Chiusi della Verna,AR,91,0,1,0,0,1,0,0,0,4,4
2020,51015,Chiusi della Verna,AR,92,0,1,0,2,3,0,0,0,4,4
2020,51015,Chiusi della Verna,AR,93,0,1,0,0,1,0,0,0,6,6
2020,51015,Chiusi della Verna,AR,94,0,0,0,2,2,0,0,0,3,3
2020,51015,Chiusi della Verna,AR,95,0,0,0,1,1,0,0,0,3,3
2020,51015,Chiusi della Verna,AR,96,0,0,0,1,1,0,0,0,1,1
2020,51015,Chiusi della Verna,AR,97,0,0,0,1,1,0,0,0,2,2
2020,51015,Chiusi della Verna,AR,98,0,0,0,0,0,0,0,0,1,1
2020,51015,Chiusi della Verna,AR,99,1,0,0,0,1,0,0,0,0,0
2020,51015,Chiusi della Verna,AR,100 e più,0,0,0,0,0,0,0,0,0,0
2020,51016,Civitella in Val di Chiana,AR,0,29,0,0,0,29,29,0,0,0,29
2020,51016,Civitella in Val di Chiana,AR,1,28,0,0,0,28,33,0,0,0,33
2020,51016,Civitella in Val di Chiana,AR,2,32,0,0,0,32,37,0,0,0,37
2020,51016,Civitella in Val di Chiana,AR,3,29,0,0,0,29,35,0,0,0,35
2020,51016,Civitella in Val di Chiana,AR,4,39,0,0,0,39,30,0,0,0,30
2020,51016,Civitella in Val di Chiana,AR,5,39,0,0,0,39,28,0,0,0,28
2020,51016,Civitella in Val di Chiana,AR,6,29,0,0,0,29,39,0,0,0,39
2020,51016,Civitella in Val di Chiana,AR,7,38,0,0,0,38,35,0,0,0,35
2020,51016,Civitella in Val di Chiana,AR,8,34,0,0,0,34,47,0,0,0,47
2020,51016,Civitella in Val di Chiana,AR,9,46,0,0,0,46,34,0,0,0,34
2020,51016,Civitella in Val di Chiana,AR,10,33,0,0,0,33,22,0,0,0,22
2020,51016,Civitella in Val di Chiana,AR,11,41,0,0,0,41,36,0,0,0,36
2020,51016,Civitella in Val di Chiana,AR,12,36,0,0,0,36,36,0,0,0,36
2020,51016,Civitella in Val di Chiana,AR,13,41,0,0,0,41,38,0,0,0,38
2020,51016,Civitella in Val di Chiana,AR,14,42,0,0,0,42,43,0,0,0,43
2020,51016,Civitella in Val di Chiana,AR,15,48,0,0,0,48,38,0,0,0,38
2020,51016,Civitella in Val di Chiana,AR,16,47,0,0,0,47,34,0,0,0,34
2020,51016,Civitella in Val di Chiana,AR,17,50,0,0,0,50,32,0,0,0,32
2020,51016,Civitella in Val di Chiana,AR,18,56,0,0,0,56,35,0,0,0,35
2020,51016,Civitella in Val di Chiana,AR,19,29,0,0,0,29,37,1,0,0,38
2020,51016,Civitella in Val di Chiana,AR,20,47,0,0,0,47,41,1,0,0,42
2020,51016,Civitella in Val di Chiana,AR,21,50,0,0,0,50,39,0,0,0,39
2020,51016,Civitella in Val di Chiana,AR,22,49,0,0,0,49,35,1,0,0,36
2020,51016,Civitella in Val di Chiana,AR,23,48,0,0,0,48,40,2,0,0,42
2020,51016,Civitella in Val di Chiana,AR,24,53,0,0,0,53,48,1,0,0,49
2020,51016,Civitella in Val di Chiana,AR,25,38,2,0,0,40,33,1,0,0,34
2020,51016,Civitella in Val di Chiana,AR,26,58,1,0,0,59,24,4,0,0,28
2020,51016,Civitella in Val di Chiana,AR,27,36,1,0,0,37,32,10,0,0,42
2020,51016,Civitella in Val di Chiana,AR,28,39,2,0,0,41,43,7,0,0,50
2020,51016,Civitella in Val di Chiana,AR,29,46,6,0,0,52,22,10,1,0,33
2020,51016,Civitella in Val di Chiana,AR,30,37,11,0,0,48,37,12,0,0,49
2020,51016,Civitella in Val di Chiana,AR,31,24,6,0,0,30,29,12,0,0,41
2020,51016,Civitella in Val di Chiana,AR,32,34,3,0,0,37,29,12,1,0,42
2020,51016,Civitella in Val di Chiana,AR,33,34,8,0,0,42,20,25,0,0,45
2020,51016,Civitella in Val di Chiana,AR,34,30,12,1,0,43,18,21,1,0,40
2020,51016,Civitella in Val di Chiana,AR,35,28,19,0,0,47,27,22,0,0,49
2020,51016,Civitella in Val di Chiana,AR,36,24,19,0,0,43,20,29,0,0,49
2020,51016,Civitella in Val di Chiana,AR,37,23,22,0,0,45,13,19,2,0,34
2020,51016,Civitella in Val di Chiana,AR,38,21,19,1,0,41,23,27,3,0,53
2020,51016,Civitella in Val di Chiana,AR,39,23,22,5,0,50,18,33,0,0,51
2020,51016,Civitella in Val di Chiana,AR,40,17,30,1,0,48,20,35,6,0,61
2020,51016,Civitella in Val di Chiana,AR,41,29,37,1,0,67,10,43,4,0,57
2020,51016,Civitella in Val di Chiana,AR,42,21,43,3,0,67,11,44,1,0,56
2020,51016,Civitella in Val di Chiana,AR,43,25,19,2,0,46,20,38,9,0,67
2020,51016,Civitella in Val di Chiana,AR,44,27,41,3,0,71,16,31,5,0,52
2020,51016,Civitella in Val di Chiana,AR,45,18,33,8,0,59,16,66,5,0,87
2020,51016,Civitella in Val di Chiana,AR,46,23,45,7,0,75,17,45,6,2,70
2020,51016,Civitella in Val di Chiana,AR,47,20,54,3,1,78,12,69,7,0,88
2020,51016,Civitella in Val di Chiana,AR,48,15,53,7,0,75,17,59,4,1,81
2020,51016,Civitella in Val di Chiana,AR,49,17,51,2,0,70,11,54,7,3,75
2020,51016,Civitella in Val di Chiana,AR,50,15,44,2,0,61,13,48,5,1,67
2020,51016,Civitella in Val di Chiana,AR,51,14,57,3,1,75,8,72,3,2,85
2020,51016,Civitella in Val di Chiana,AR,52,20,48,5,0,73,8,72,6,2,88
2020,51016,Civitella in Val di Chiana,AR,53,14,56,8,2,80,7,60,9,2,78
2020,51016,Civitella in Val di Chiana,AR,54,8,59,6,0,73,7,48,4,3,62
2020,51016,Civitella in Val di Chiana,AR,55,15,60,7,0,82,14,66,1,4,85
2020,51016,Civitella in Val di Chiana,AR,56,11,57,4,1,73,6,46,4,3,59
2020,51016,Civitella in Val di Chiana,AR,57,6,48,4,2,60,8,58,4,2,72
2020,51016,Civitella in Val di Chiana,AR,58,5,55,4,2,66,4,65,5,2,76
2020,51016,Civitella in Val di Chiana,AR,59,9,58,4,4,75,1,54,7,5,67
2020,51016,Civitella in Val di Chiana,AR,60,5,47,4,1,57,3,33,3,6,45
2020,51016,Civitella in Val di Chiana,AR,61,7,44,4,4,59,1,58,4,4,67
2020,51016,Civitella in Val di Chiana,AR,62,7,51,3,0,61,6,45,5,11,67
2020,51016,Civitella in Val di Chiana,AR,63,3,47,3,1,54,4,39,3,8,54
2020,51016,Civitella in Val di Chiana,AR,64,9,49,3,1,62,2,50,1,4,57
2020,51016,Civitella in Val di Chiana,AR,65,8,51,0,2,61,4,59,2,7,72
2020,51016,Civitella in Val di Chiana,AR,66,5,44,2,3,54,1,44,4,7,56
2020,51016,Civitella in Val di Chiana,AR,67,5,40,2,1,48,3,38,2,11,54
2020,51016,Civitella in Val di Chiana,AR,68,1,42,1,1,45,4,31,1,4,40
2020,51016,Civitella in Val di Chiana,AR,69,1,26,1,3,31,1,53,0,8,62
2020,51016,Civitella in Val di Chiana,AR,70,4,48,3,3,58,1,46,1,5,53
2020,51016,Civitella in Val di Chiana,AR,71,10,41,1,1,53,1,49,2,11,63
2020,51016,Civitella in Val di Chiana,AR,72,5,58,3,4,70,2,41,0,13,56
2020,51016,Civitella in Val di Chiana,AR,73,7,59,1,1,68,1,47,2,10,60
2020,51016,Civitella in Val di Chiana,AR,74,3,42,0,3,48,0,26,1,8,35
2020,51016,Civitella in Val di Chiana,AR,75,0,37,0,5,42,0,32,2,13,47
2020,51016,Civitella in Val di Chiana,AR,76,3,27,1,5,36,0,20,1,12,33
2020,51016,Civitella in Val di Chiana,AR,77,3,37,0,3,43,0,38,1,9,48
2020,51016,Civitella in Val di Chiana,AR,78,2,34,3,6,45,2,20,0,13,35
2020,51016,Civitella in Val di Chiana,AR,79,4,24,0,3,31,0,24,0,10,34
2020,51016,Civitella in Val di Chiana,AR,80,2,29,1,7,39,4,25,1,21,51
2020,51016,Civitella in Val di Chiana,AR,81,1,34,0,8,43,2,12,0,27,41
2020,51016,Civitella in Val di Chiana,AR,82,3,22,0,3,28,1,16,0,26,43
2020,51016,Civitella in Val di Chiana,AR,83,3,23,0,5,31,3,15,0,19,37
2020,51016,Civitella in Val di Chiana,AR,84,3,16,0,6,25,2,8,0,22,32
2020,51016,Civitella in Val di Chiana,AR,85,1,19,0,6,26,1,8,0,24,33
2020,51016,Civitella in Val di Chiana,AR,86,2,13,0,5,20,1,11,0,27,39
2020,51016,Civitella in Val di Chiana,AR,87,0,11,1,6,18,0,3,0,16,19
2020,51016,Civitella in Val di Chiana,AR,88,0,9,0,3,12,1,5,0,15,21
2020,51016,Civitella in Val di Chiana,AR,89,2,10,0,7,19,0,3,0,18,21
2020,51016,Civitella in Val di Chiana,AR,90,2,8,0,0,10,1,2,0,14,17
2020,51016,Civitella in Val di Chiana,AR,91,1,3,0,4,8,1,0,0,11,12
2020,51016,Civitella in Val di Chiana,AR,92,0,2,0,1,3,1,0,0,9,10
2020,51016,Civitella in Val di Chiana,AR,93,0,1,0,3,4,0,0,0,12,12
2020,51016,Civitella in Val di Chiana,AR,94,0,3,0,2,5,0,1,0,12,13
2020,51016,Civitella in Val di Chiana,AR,95,0,3,0,1,4,0,0,0,9,9
2020,51016,Civitella in Val di Chiana,AR,96,0,0,0,0,0,0,0,0,4,4
2020,51016,Civitella in Val di Chiana,AR,97,0,0,0,0,0,0,1,0,4,5
2020,51016,Civitella in Val di Chiana,AR,98,0,0,0,1,1,0,0,0,1,1
2020,51016,Civitella in Val di Chiana,AR,99,0,0,0,1,1,0,0,0,1,1
2020,51016,Civitella in Val di Chiana,AR,100 e più,0,0,0,1,1,0,0,0,3,3
2020,51017,Cortona,AR,0,74,0,0,0,74,64,0,0,0,64
2020,51017,Cortona,AR,1,66,0,0,0,66,70,0,0,0,70
2020,51017,Cortona,AR,2,62,0,0,0,62,74,0,0,0,74
2020,51017,Cortona,AR,3,85,0,0,0,85,61,0,0,0,61
2020,51017,Cortona,AR,4,73,0,0,0,73,87,0,0,0,87
2020,51017,Cortona,AR,5,84,0,0,0,84,78,0,0,0,78
2020,51017,Cortona,AR,6,80,0,0,0,80,65,0,0,0,65
2020,51017,Cortona,AR,7,83,0,0,0,83,80,0,0,0,80
2020,51017,Cortona,AR,8,80,0,0,0,80,77,0,0,0,77
2020,51017,Cortona,AR,9,83,0,0,0,83,77,0,0,0,77
2020,51017,Cortona,AR,10,87,0,0,0,87,84,0,0,0,84
2020,51017,Cortona,AR,11,86,0,0,0,86,94,0,0,0,94
2020,51017,Cortona,AR,12,85,0,0,0,85,78,0,0,0,78
2020,51017,Cortona,AR,13,109,0,0,0,109,85,0,0,0,85
2020,51017,Cortona,AR,14,85,0,0,0,85,79,0,0,0,79
2020,51017,Cortona,AR,15,72,0,0,0,72,78,0,0,0,78
2020,51017,Cortona,AR,16,102,0,0,0,102,87,0,0,0,87
2020,51017,Cortona,AR,17,73,0,0,0,73,86,0,0,0,86
2020,51017,Cortona,AR,18,80,0,0,0,80,94,0,0,0,94
2020,51017,Cortona,AR,19,85,0,0,0,85,81,0,0,0,81
2020,51017,Cortona,AR,20,78,0,0,0,78,80,2,0,0,82
2020,51017,Cortona,AR,21,101,0,0,0,101,72,2,0,0,74
2020,51017,Cortona,AR,22,103,1,0,0,104,96,3,0,0,99
2020,51017,Cortona,AR,23,89,2,0,0,91,107,6,0,0,113
2020,51017,Cortona,AR,24,117,0,0,0,117,82,8,0,0,90
2020,51017,Cortona,AR,25,87,3,0,0,90,86,4,0,0,90
2020,51017,Cortona,AR,26,97,0,0,0,97,83,9,0,0,92
2020,51017,Cortona,AR,27,89,4,0,0,93,91,10,0,0,101
2020,51017,Cortona,AR,28,102,5,0,0,107,81,17,1,0,99
2020,51017,Cortona,AR,29,94,9,0,0,103,77,29,0,0,106
2020,51017,Cortona,AR,30,99,13,0,0,112,67,28,1,0,96
2020,51017,Cortona,AR,31,88,21,0,0,109,75,31,2,0,108
2020,51017,Cortona,AR,32,83,18,0,0,102,78,38,0,0,116
2020,51017,Cortona,AR,33,93,23,0,0,116,70,33,1,0,104
2020,51017,Cortona,AR,34,77,23,0,0,100,43,49,1,0,93
2020,51017,Cortona,AR,35,70,27,0,0,97,64,35,3,0,102
2020,51017,Cortona,AR,36,74,29,0,1,104,54,56,5,1,116
2020,51017,Cortona,AR,37,64,47,1,0,112,54,47,4,1,106
2020,51017,Cortona,AR,38,80,57,0,0,137,51,73,5,0,129
2020,51017,Cortona,AR,39,86,54,3,0,144,56,65,4,0,125
2020,51017,Cortona,AR,40,68,67,3,0,138,37,67,9,0,113
2020,51017,Cortona,AR,41,55,57,3,0,115,48,97,6,2,153
2020,51017,Cortona,AR,42,61,79,0,0,140,37,97,8,2,144
2020,51017,Cortona,AR,43,52,63,6,0,121,52,90,8,0,150
2020,51017,Cortona,AR,44,69,87,3,0,159,39,91,8,1,139
2020,51017,Cortona,AR,45,52,88,4,1,145,46,123,16,1,186
2020,51017,Cortona,AR,46,58,99,7,0,164,36,106,8,4,154
2020,51017,Cortona,AR,47,41,97,10,0,148,31,112,18,1,162
2020,51017,Cortona,AR,48,43,108,11,1,163,30,134,7,3,174
2020,51017,Cortona,AR,49,37,112,5,0,154,27,103,16,3,149
2020,51017,Cortona,AR,50,40,123,15,4,182,25,113,9,2,149
2020,51017,Cortona,AR,51,30,112,12,0,154,34,126,13,1,174
2020,51017,Cortona,AR,52,32,111,10,3,156,25,146,23,0,194
2020,51017,Cortona,AR,53,45,121,12,2,180,27,129,13,6,175
2020,51017,Cortona,AR,54,35,136,13,0,184,36,140,12,5,193
2020,51017,Cortona,AR,55,35,121,14,0,170,18,161,14,10,203
2020,51017,Cortona,AR,56,31,113,13,5,162,22,123,13,3,161
2020,51017,Cortona,AR,57,25,111,15,0,151,12,131,11,8,162
2020,51017,Cortona,AR,58,16,131,6,2,155,14,134,7,11,166
2020,51017,Cortona,AR,59,21,128,14,2,165,11,143,9,9,172
2020,51017,Cortona,AR,60,26,122,12,3,163,14,122,16,11,163
2020,51017,Cortona,AR,61,16,132,13,3,165,15,132,9,17,173
2020,51017,Cortona,AR,62,17,127,8,2,154,9,114,14,15,152
2020,51017,Cortona,AR,63,16,117,9,5,147,11,129,7,15,162
2020,51017,Cortona,AR,64,17,121,11,8,157,8,128,9,27,172
2020,51017,Cortona,AR,65,13,107,7,2,129,5,113,5,18,141
2020,51017,Cortona,AR,66,12,116,10,4,143,10,131,12,25,178
2020,51017,Cortona,AR,67,5,105,7,6,123,4,149,5,16,174
2020,51017,Cortona,AR,68,10,98,7,5,120,6,114,7,20,147
2020,51017,Cortona,AR,69,16,149,9,4,179,5,126,8,24,163
2020,51017,Cortona,AR,70,9,110,4,10,134,9,113,8,53,183
2020,51017,Cortona,AR,71,8,120,3,5,136,6,91,7,35,139
2020,51017,Cortona,AR,72,16,126,2,12,156,10,109,5,44,168
2020,51017,Cortona,AR,73,7,131,3,6,147,7,94,3,39,143
2020,51017,Cortona,AR,74,7,119,2,6,134,6,98,3,32,139
2020,51017,Cortona,AR,75,6,93,5,8,112,2,78,3,38,121
2020,51017,Cortona,AR,76,4,80,0,4,88,5,61,3,43,112
2020,51017,Cortona,AR,77,8,84,4,6,102,4,56,3,46,109
2020,51017,Cortona,AR,78,7,74,1,5,87,6,46,1,39,92
2020,51017,Cortona,AR,79,5,76,2,9,92,8,55,5,49,117
2020,51017,Cortona,AR,80,11,84,2,8,105,6,47,4,80,137
2020,51017,Cortona,AR,81,5,66,1,9,81,1,53,0,61,115
2020,51017,Cortona,AR,82,6,71,2,14,93,5,43,1,67,116
2020,51017,Cortona,AR,83,9,52,0,11,72,4,42,0,56,102
2020,51017,Cortona,AR,84,9,47,0,11,67,3,20,1,53,77
2020,51017,Cortona,AR,85,8,45,0,18,71,6,29,0,52,87
2020,51017,Cortona,AR,86,2,44,0,14,60,9,20,0,69,98
2020,51017,Cortona,AR,87,1,33,0,20,54,4,20,2,65,91
2020,51017,Cortona,AR,88,2,23,0,12,37,1,10,1,50,62
2020,51017,Cortona,AR,89,1,22,0,5,28,7,8,0,54,69
2020,51017,Cortona,AR,90,2,23,0,10,35,2,6,0,72,80
2020,51017,Cortona,AR,91,0,10,0,7,17,2,6,0,43,51
2020,51017,Cortona,AR,92,1,15,0,8,24,4,2,2,38,46
2020,51017,Cortona,AR,93,1,7,0,10,18,0,5,1,24,30
2020,51017,Cortona,AR,94,2,8,0,4,14,0,1,0,27,28
2020,51017,Cortona,AR,95,0,1,0,1,2,1,0,0,24,25
2020,51017,Cortona,AR,96,0,2,0,1,3,0,1,0,14,15
2020,51017,Cortona,AR,97,0,2,0,3,5,0,0,0,8,8
2020,51017,Cortona,AR,98,0,0,0,2,2,0,0,0,8,8
2020,51017,Cortona,AR,99,1,1,0,1,3,0,0,0,3,3
2020,51017,Cortona,AR,100 e più,0,0,0,2,2,1,0,0,8,9
2020,51018,Foiano della Chiana,AR,0,34,0,0,0,34,29,0,0,0,29
2020,51018,Foiano della Chiana,AR,1,33,0,0,0,33,33,0,0,0,33
2020,51018,Foiano della Chiana,AR,2,33,0,0,0,33,30,0,0,0,30
2020,51018,Foiano della Chiana,AR,3,43,0,0,0,43,40,0,0,0,40
2020,51018,Foiano della Chiana,AR,4,37,0,0,0,37,52,0,0,0,52
2020,51018,Foiano della Chiana,AR,5,27,0,0,0,27,50,0,0,0,50
2020,51018,Foiano della Chiana,AR,6,45,0,0,0,45,46,0,0,0,46
2020,51018,Foiano della Chiana,AR,7,51,0,0,0,51,43,0,0,0,43
2020,51018,Foiano della Chiana,AR,8,52,0,0,0,52,49,0,0,0,49
2020,51018,Foiano della Chiana,AR,9,34,0,0,0,34,54,0,0,0,54
2020,51018,Foiano della Chiana,AR,10,48,0,0,0,48,39,0,0,0,39
2020,51018,Foiano della Chiana,AR,11,55,0,0,0,55,37,0,0,0,37
2020,51018,Foiano della Chiana,AR,12,38,0,0,0,38,49,0,0,0,49
2020,51018,Foiano della Chiana,AR,13,37,0,0,0,37,43,0,0,0,43
2020,51018,Foiano della Chiana,AR,14,50,0,0,0,50,35,0,0,0,35
2020,51018,Foiano della Chiana,AR,15,42,0,0,0,42,37,0,0,0,37
2020,51018,Foiano della Chiana,AR,16,43,0,0,0,43,44,0,0,0,44
2020,51018,Foiano della Chiana,AR,17,36,0,0,0,36,47,0,0,0,47
2020,51018,Foiano della Chiana,AR,18,37,0,0,0,37,42,0,0,0,42
2020,51018,Foiano della Chiana,AR,19,49,0,0,0,49,42,1,0,0,43
2020,51018,Foiano della Chiana,AR,20,47,0,0,0,47,46,0,0,0,46
2020,51018,Foiano della Chiana,AR,21,57,0,0,0,57,41,2,0,0,43
2020,51018,Foiano della Chiana,AR,22,49,0,0,0,49,27,1,0,0,28
2020,51018,Foiano della Chiana,AR,23,42,0,0,0,42,36,3,0,0,39
2020,51018,Foiano della Chiana,AR,24,45,0,0,0,45,50,1,0,0,51
2020,51018,Foiano della Chiana,AR,25,29,0,0,0,29,34,8,0,0,42
2020,51018,Foiano della Chiana,AR,26,35,1,0,0,36,52,4,0,0,56
2020,51018,Foiano della Chiana,AR,27,39,6,0,0,45,31,11,0,0,42
2020,51018,Foiano della Chiana,AR,28,57,5,0,0,62,33,7,0,0,40
2020,51018,Foiano della Chiana,AR,29,38,4,0,0,42,40,15,0,0,55
2020,51018,Foiano della Chiana,AR,30,40,9,0,0,49,32,20,0,0,52
2020,51018,Foiano della Chiana,AR,31,39,11,0,0,50,33,17,0,0,50
2020,51018,Foiano della Chiana,AR,32,50,12,0,0,62,26,26,0,3,55
2020,51018,Foiano della Chiana,AR,33,25,16,0,0,41,30,32,1,0,63
2020,51018,Foiano della Chiana,AR,34,29,22,1,0,52,14,24,1,0,39
2020,51018,Foiano della Chiana,AR,35,39,17,1,0,57,23,26,1,0,50
2020,51018,Foiano della Chiana,AR,36,26,25,0,0,51,18,26,1,0,45
2020,51018,Foiano della Chiana,AR,37,35,24,0,0,59,32,24,2,0,58
2020,51018,Foiano della Chiana,AR,38,19,26,1,0,46,33,46,1,1,81
2020,51018,Foiano della Chiana,AR,39,35,37,3,0,75,17,51,2,0,70
2020,51018,Foiano della Chiana,AR,40,23,43,3,0,69,18,39,3,0,60
2020,51018,Foiano della Chiana,AR,41,23,40,4,0,67,15,55,1,1,72
2020,51018,Foiano della Chiana,AR,42,34,50,2,0,86,23,58,2,0,83
2020,51018,Foiano della Chiana,AR,43,20,33,6,0,59,21,58,1,0,80
2020,51018,Foiano della Chiana,AR,44,20,53,3,0,76,11,59,4,1,75
2020,51018,Foiano della Chiana,AR,45,13,44,1,0,58,8,54,7,1,70
2020,51018,Foiano della Chiana,AR,46,24,54,2,0,80,14,62,5,1,82
2020,51018,Foiano della Chiana,AR,47,24,48,7,0,79,13,52,5,2,72
2020,51018,Foiano della Chiana,AR,48,25,62,1,0,88,11,46,10,0,67
2020,51018,Foiano della Chiana,AR,49,17,63,4,0,84,5,60,2,0,67
2020,51018,Foiano della Chiana,AR,50,18,51,6,0,75,12,61,6,4,83
2020,51018,Foiano della Chiana,AR,51,10,59,3,1,73,8,55,6,4,73
2020,51018,Foiano della Chiana,AR,52,15,66,7,2,90,9,53,8,0,70
2020,51018,Foiano della Chiana,AR,53,5,56,2,0,63,11,60,6,2,79
2020,51018,Foiano della Chiana,AR,54,8,56,3,1,68,7,46,7,2,62
2020,51018,Foiano della Chiana,AR,55,8,52,7,0,67,10,48,2,5,65
2020,51018,Foiano della Chiana,AR,56,12,51,5,2,70,3,62,5,2,72
2020,51018,Foiano della Chiana,AR,57,9,53,5,0,67,7,44,6,9,66
2020,51018,Foiano della Chiana,AR,58,11,37,3,1,52,2,49,6,3,60
2020,51018,Foiano della Chiana,AR,59,9,55,2,0,66,4,44,4,4,56
2020,51018,Foiano della Chiana,AR,60,2,50,5,0,57,3,39,3,2,47
2020,51018,Foiano della Chiana,AR,61,7,44,9,1,61,2,50,4,7,63
2020,51018,Foiano della Chiana,AR,62,2,48,5,0,55,4,53,2,5,64
2020,51018,Foiano della Chiana,AR,63,4,40,5,2,51,3,62,4,3,72
2020,51018,Foiano della Chiana,AR,64,2,38,1,2,43,1,35,5,7,48
2020,51018,Foiano della Chiana,AR,65,6,45,3,2,56,5,33,3,8,49
2020,51018,Foiano della Chiana,AR,66,4,49,1,1,55,5,62,4,7,78
2020,51018,Foiano della Chiana,AR,67,8,31,1,2,42,2,43,1,10,56
2020,51018,Foiano della Chiana,AR,68,3,49,0,4,56,2,43,1,10,56
2020,51018,Foiano della Chiana,AR,69,3,53,3,5,64,3,34,2,12,51
2020,51018,Foiano della Chiana,AR,70,3,28,1,1,33,5,48,4,5,62
2020,51018,Foiano della Chiana,AR,71,4,49,2,4,59,3,38,4,9,54
2020,51018,Foiano della Chiana,AR,72,6,53,1,1,61,2,45,1,25,73
2020,51018,Foiano della Chiana,AR,73,1,41,4,4,50,1,31,1,19,52
2020,51018,Foiano della Chiana,AR,74,3,32,2,4,41,3,31,4,11,49
2020,51018,Foiano della Chiana,AR,75,1,38,2,3,44,0,22,0,11,33
2020,51018,Foiano della Chiana,AR,76,1,27,1,2,31,0,17,1,10,28
2020,51018,Foiano della Chiana,AR,77,3,27,1,3,34,1,18,0,20,39
2020,51018,Foiano della Chiana,AR,78,3,20,0,2,25,1,19,0,13,33
2020,51018,Foiano della Chiana,AR,79,0,24,1,0,25,0,19,2,17,38
2020,51018,Foiano della Chiana,AR,80,2,29,2,1,34,2,23,2,22,49
2020,51018,Foiano della Chiana,AR,81,6,19,1,4,30,1,7,0,22,30
2020,51018,Foiano della Chiana,AR,82,1,32,0,3,36,1,22,0,20,43
2020,51018,Foiano della Chiana,AR,83,1,20,0,6,27,1,9,0,18,28
2020,51018,Foiano della Chiana,AR,84,1,21,0,8,30,0,14,0,20,34
2020,51018,Foiano della Chiana,AR,85,1,11,0,6,18,1,16,0,14,31
2020,51018,Foiano della Chiana,AR,86,1,11,0,4,16,1,10,0,18,29
2020,51018,Foiano della Chiana,AR,87,1,16,0,4,21,0,2,0,24,26
2020,51018,Foiano della Chiana,AR,88,4,16,0,2,22,1,6,0,26,33
2020,51018,Foiano della Chiana,AR,89,2,12,0,7,21,1,0,0,22,23
2020,51018,Foiano della Chiana,AR,90,1,4,0,4,9,1,4,3,11,19
2020,51018,Foiano della Chiana,AR,91,1,3,0,4,8,0,1,0,13,14
2020,51018,Foiano della Chiana,AR,92,0,5,1,3,9,0,0,0,11,11
2020,51018,Foiano della Chiana,AR,93,0,3,0,4,7,1,1,0,14,16
2020,51018,Foiano della Chiana,AR,94,0,2,0,0,2,0,0,0,12,12
2020,51018,Foiano della Chiana,AR,95,0,1,0,0,1,0,0,0,7,7
2020,51018,Foiano della Chiana,AR,96,0,1,0,1,2,0,1,0,7,8
2020,51018,Foiano della Chiana,AR,97,0,0,0,0,0,0,0,0,3,3
2020,51018,Foiano della Chiana,AR,98,0,0,0,0,0,0,0,0,4,4
2020,51018,Foiano della Chiana,AR,99,0,0,0,0,0,0,0,0,1,1
2020,51018,Foiano della Chiana,AR,100 e più,0,0,0,1,1,0,0,0,3,3
2020,51020,Loro Ciuffenna,AR,0,23,0,0,0,23,27,0,0,0,27
2020,51020,Loro Ciuffenna,AR,1,27,0,0,0,27,12,0,0,0,12
2020,51020,Loro Ciuffenna,AR,2,14,0,0,0,14,21,0,0,0,21
2020,51020,Loro Ciuffenna,AR,3,22,0,0,0,22,18,0,0,0,18
2020,51020,Loro Ciuffenna,AR,4,28,0,0,0,28,25,0,0,0,25
2020,51020,Loro Ciuffenna,AR,5,19,0,0,0,19,21,0,0,0,21
2020,51020,Loro Ciuffenna,AR,6,23,0,0,0,23,33,0,0,0,33
2020,51020,Loro Ciuffenna,AR,7,28,0,0,0,28,13,0,0,0,13
2020,51020,Loro Ciuffenna,AR,8,27,0,0,0,27,25,0,0,0,25
2020,51020,Loro Ciuffenna,AR,9,18,0,0,0,18,25,0,0,0,25
2020,51020,Loro Ciuffenna,AR,10,26,0,0,0,26,29,0,0,0,29
2020,51020,Loro Ciuffenna,AR,11,26,0,0,0,26,21,0,0,0,21
2020,51020,Loro Ciuffenna,AR,12,24,0,0,0,24,37,0,0,0,37
2020,51020,Loro Ciuffenna,AR,13,28,0,0,0,28,28,0,0,0,28
2020,51020,Loro Ciuffenna,AR,14,32,0,0,0,32,29,0,0,0,29
2020,51020,Loro Ciuffenna,AR,15,20,0,0,0,20,32,0,0,0,32
2020,51020,Loro Ciuffenna,AR,16,33,0,0,0,33,24,0,0,0,24
2020,51020,Loro Ciuffenna,AR,17,36,0,0,0,36,32,0,0,0,32
2020,51020,Loro Ciuffenna,AR,18,23,0,0,0,23,22,0,0,0,22
2020,51020,Loro Ciuffenna,AR,19,27,0,0,0,27,28,0,0,0,28
2020,51020,Loro Ciuffenna,AR,20,29,0,0,0,29,30,0,0,0,30
2020,51020,Loro Ciuffenna,AR,21,19,0,0,0,19,17,0,0,0,17
2020,51020,Loro Ciuffenna,AR,22,25,0,0,0,25,24,0,0,0,24
2020,51020,Loro Ciuffenna,AR,23,33,0,0,0,33,29,0,0,0,29
2020,51020,Loro Ciuffenna,AR,24,32,0,0,0,32,19,0,0,0,19
2020,51020,Loro Ciuffenna,AR,25,28,0,0,0,28,25,1,0,0,26
2020,51020,Loro Ciuffenna,AR,26,27,0,0,0,27,23,1,0,0,24
2020,51020,Loro Ciuffenna,AR,27,22,1,0,0,23,17,2,0,0,19
2020,51020,Loro Ciuffenna,AR,28,30,0,0,0,30,26,4,0,0,30
2020,51020,Loro Ciuffenna,AR,29,31,2,0,0,33,23,4,0,0,27
2020,51020,Loro Ciuffenna,AR,30,22,1,0,0,23,22,7,0,0,29
2020,51020,Loro Ciuffenna,AR,31,24,3,0,0,27,25,5,0,0,30
2020,51020,Loro Ciuffenna,AR,32,21,7,0,0,28,21,5,1,0,27
2020,51020,Loro Ciuffenna,AR,33,25,7,0,0,32,16,7,0,0,23
2020,51020,Loro Ciuffenna,AR,34,16,7,1,0,24,9,17,0,0,26
2020,51020,Loro Ciuffenna,AR,35,28,11,0,0,39,13,22,0,0,35
2020,51020,Loro Ciuffenna,AR,36,23,13,1,0,37,15,19,2,0,36
2020,51020,Loro Ciuffenna,AR,37,23,21,0,0,44,18,23,1,0,42
2020,51020,Loro Ciuffenna,AR,38,19,12,2,0,33,11,19,1,0,31
2020,51020,Loro Ciuffenna,AR,39,11,15,0,0,26,17,23,3,1,44
2020,51020,Loro Ciuffenna,AR,40,13,17,0,0,30,13,22,5,0,40
2020,51020,Loro Ciuffenna,AR,41,17,24,1,0,42,9,25,0,0,34
2020,51020,Loro Ciuffenna,AR,42,16,17,1,0,34,12,27,6,0,45
2020,51020,Loro Ciuffenna,AR,43,21,30,0,0,51,11,25,1,0,37
2020,51020,Loro Ciuffenna,AR,44,25,27,1,0,53,17,28,4,1,50
2020,51020,Loro Ciuffenna,AR,45,19,21,5,0,45,9,33,4,0,46
2020,51020,Loro Ciuffenna,AR,46,16,24,0,0,40,15,35,2,1,53
2020,51020,Loro Ciuffenna,AR,47,18,27,2,0,47,9,33,5,0,47
2020,51020,Loro Ciuffenna,AR,48,12,27,4,0,43,7,42,2,1,52
2020,51020,Loro Ciuffenna,AR,49,16,35,5,0,56,8,45,6,0,59
2020,51020,Loro Ciuffenna,AR,50,17,30,2,0,49,6,33,2,0,41
2020,51020,Loro Ciuffenna,AR,51,11,44,5,0,60,9,25,3,3,40
2020,51020,Loro Ciuffenna,AR,52,9,43,2,1,55,4,33,3,0,40
2020,51020,Loro Ciuffenna,AR,53,11,30,6,1,48,7,27,5,3,42
2020,51020,Loro Ciuffenna,AR,54,9,39,6,0,54,6,42,6,1,55
2020,51020,Loro Ciuffenna,AR,55,12,45,4,1,62,1,45,2,1,49
2020,51020,Loro Ciuffenna,AR,56,4,30,4,0,38,2,43,3,2,50
2020,51020,Loro Ciuffenna,AR,57,4,33,0,0,37,0,41,3,1,45
2020,51020,Loro Ciuffenna,AR,58,5,41,0,0,46,4,28,5,3,40
2020,51020,Loro Ciuffenna,AR,59,7,39,4,2,52,3,36,0,4,43
2020,51020,Loro Ciuffenna,AR,60,5,28,1,0,34,7,40,3,5,55
2020,51020,Loro Ciuffenna,AR,61,4,40,0,2,46,1,28,5,3,37
2020,51020,Loro Ciuffenna,AR,62,2,29,2,0,33,4,24,6,3,37
2020,51020,Loro Ciuffenna,AR,63,3,28,2,1,34,1,28,1,3,33
2020,51020,Loro Ciuffenna,AR,64,4,30,2,0,36,4,30,1,1,36
2020,51020,Loro Ciuffenna,AR,65,5,32,3,0,40,1,26,2,6,35
2020,51020,Loro Ciuffenna,AR,66,1,26,2,1,30,3,28,0,3,34
2020,51020,Loro Ciuffenna,AR,67,4,32,1,2,39,1,29,0,2,32
2020,51020,Loro Ciuffenna,AR,68,3,24,5,1,33,3,35,1,4,43
2020,51020,Loro Ciuffenna,AR,69,4,26,1,1,32,1,28,0,9,38
2020,51020,Loro Ciuffenna,AR,70,3,25,4,6,38,1,31,0,9,41
2020,51020,Loro Ciuffenna,AR,71,1,34,3,3,41,1,33,0,9,43
2020,51020,Loro Ciuffenna,AR,72,3,29,5,4,41,2,26,1,13,42
2020,51020,Loro Ciuffenna,AR,73,0,31,2,3,36,0,27,1,6,34
2020,51020,Loro Ciuffenna,AR,74,4,33,3,0,40,0,18,3,8,29
2020,51020,Loro Ciuffenna,AR,75,2,38,0,0,40,1,16,1,4,22
2020,51020,Loro Ciuffenna,AR,76,3,17,1,3,24,3,12,0,12,27
2020,51020,Loro Ciuffenna,AR,77,0,15,0,2,17,2,14,0,10,26
2020,51020,Loro Ciuffenna,AR,78,2,11,1,2,16,1,17,0,8,26
2020,51020,Loro Ciuffenna,AR,79,5,16,0,4,25,0,10,0,11,21
2020,51020,Loro Ciuffenna,AR,80,3,20,0,2,25,0,18,0,16,34
2020,51020,Loro Ciuffenna,AR,81,2,19,0,4,25,4,18,1,6,29
2020,51020,Loro Ciuffenna,AR,82,0,22,1,6,29,1,6,0,14,21
2020,51020,Loro Ciuffenna,AR,83,1,10,0,1,12,2,3,0,22,27
2020,51020,Loro Ciuffenna,AR,84,1,11,0,5,17,1,6,0,12,19
2020,51020,Loro Ciuffenna,AR,85,1,16,1,7,25,2,6,1,13,22
2020,51020,Loro Ciuffenna,AR,86,1,6,1,5,13,0,4,0,15,19
2020,51020,Loro Ciuffenna,AR,87,2,6,0,3,11,0,2,0,7,9
2020,51020,Loro Ciuffenna,AR,88,1,5,0,2,8,0,6,0,11,17
2020,51020,Loro Ciuffenna,AR,89,0,8,0,2,10,0,1,0,11,12
2020,51020,Loro Ciuffenna,AR,90,1,2,0,1,4,0,0,0,9,9
2020,51020,Loro Ciuffenna,AR,91,1,3,0,1,5,0,1,0,7,8
2020,51020,Loro Ciuffenna,AR,92,0,2,0,0,2,0,0,0,7,7
2020,51020,Loro Ciuffenna,AR,93,0,0,0,3,3,0,1,0,5,6
2020,51020,Loro Ciuffenna,AR,94,0,0,0,4,4,1,0,0,7,8
2020,51020,Loro Ciuffenna,AR,95,0,0,0,2,2,0,0,0,5,5
2020,51020,Loro Ciuffenna,AR,96,0,0,0,1,1,0,0,0,2,2
2020,51020,Loro Ciuffenna,AR,97,0,0,0,0,0,0,0,0,0,0
2020,51020,Loro Ciuffenna,AR,98,0,0,0,1,1,0,0,0,4,4
2020,51020,Loro Ciuffenna,AR,99,0,0,0,0,0,0,0,0,0,0
2020,51020,Loro Ciuffenna,AR,100 e più,0,0,0,0,0,0,0,0,0,0
2020,51021,Lucignano,AR,0,12,0,0,0,12,14,0,0,0,14
2020,51021,Lucignano,AR,1,7,0,0,0,7,13,0,0,0,13
2020,51021,Lucignano,AR,2,9,0,0,0,9,7,0,0,0,7
2020,51021,Lucignano,AR,3,10,0,0,0,10,9,0,0,0,9
2020,51021,Lucignano,AR,4,15,0,0,0,15,15,0,0,0,15
2020,51021,Lucignano,AR,5,12,0,0,0,12,14,0,0,0,14
2020,51021,Lucignano,AR,6,10,0,0,0,10,18,0,0,0,18
2020,51021,Lucignano,AR,7,11,0,0,0,11,15,0,0,0,15
2020,51021,Lucignano,AR,8,13,0,0,0,13,17,0,0,0,17
2020,51021,Lucignano,AR,9,13,0,0,0,13,19,0,0,0,19
2020,51021,Lucignano,AR,10,10,0,0,0,10,20,0,0,0,20
2020,51021,Lucignano,AR,11,11,0,0,0,11,12,0,0,0,12
2020,51021,Lucignano,AR,12,16,0,0,0,16,22,0,0,0,22
2020,51021,Lucignano,AR,13,14,0,0,0,14,16,0,0,0,16
2020,51021,Lucignano,AR,14,16,0,0,0,16,6,0,0,0,6
2020,51021,Lucignano,AR,15,12,0,0,0,12,11,0,0,0,11
2020,51021,Lucignano,AR,16,14,0,0,0,14,16,0,0,0,16
2020,51021,Lucignano,AR,17,18,0,0,0,18,13,0,0,0,13
2020,51021,Lucignano,AR,18,17,0,0,0,17,14,0,0,0,14
2020,51021,Lucignano,AR,19,16,0,0,0,16,9,0,0,0,9
2020,51021,Lucignano,AR,20,14,0,0,0,14,10,0,0,0,10
2020,51021,Lucignano,AR,21,11,0,0,0,11,13,0,0,0,13
2020,51021,Lucignano,AR,22,15,0,0,0,15,10,0,0,0,10
2020,51021,Lucignano,AR,23,15,0,0,0,15,15,0,0,0,15
2020,51021,Lucignano,AR,24,14,0,0,0,14,11,0,0,0,11
2020,51021,Lucignano,AR,25,12,0,0,0,12,12,0,0,0,12
2020,51021,Lucignano,AR,26,26,0,0,0,26,15,0,0,0,15
2020,51021,Lucignano,AR,27,22,0,0,0,22,18,2,0,0,20
2020,51021,Lucignano,AR,28,14,3,0,0,17,15,5,0,0,20
2020,51021,Lucignano,AR,29,13,2,0,0,15,8,2,0,0,10
2020,51021,Lucignano,AR,30,22,0,0,0,22,13,4,0,0,17
2020,51021,Lucignano,AR,31,12,3,0,0,15,14,6,0,0,20
2020,51021,Lucignano,AR,32,12,3,1,0,16,7,7,0,0,14
2020,51021,Lucignano,AR,33,11,2,0,0,13,11,1,0,0,12
2020,51021,Lucignano,AR,34,20,4,0,0,24,13,7,0,0,20
2020,51021,Lucignano,AR,35,13,4,0,0,17,12,6,1,0,19
2020,51021,Lucignano,AR,36,16,4,0,0,20,8,7,0,0,15
2020,51021,Lucignano,AR,37,12,2,1,0,15,11,10,1,0,22
2020,51021,Lucignano,AR,38,21,7,0,0,28,10,9,0,0,19
2020,51021,Lucignano,AR,39,15,6,1,0,22,9,14,1,0,24
2020,51021,Lucignano,AR,40,14,11,2,0,27,9,20,0,0,29
2020,51021,Lucignano,AR,41,10,13,1,0,24,4,18,1,0,23
2020,51021,Lucignano,AR,42,8,16,1,0,25,9,17,5,0,31
2020,51021,Lucignano,AR,43,9,10,2,0,21,9,16,1,0,26
2020,51021,Lucignano,AR,44,8,17,2,0,27,10,22,0,0,32
2020,51021,Lucignano,AR,45,8,10,1,0,19,7,23,5,0,35
2020,51021,Lucignano,AR,46,8,21,0,0,29,2,22,3,0,27
2020,51021,Lucignano,AR,47,12,26,0,0,38,4,21,2,0,27
2020,51021,Lucignano,AR,48,7,23,3,0,33,6,10,0,0,16
2020,51021,Lucignano,AR,49,8,14,1,0,23,4,25,4,0,33
2020,51021,Lucignano,AR,50,0,19,0,0,19,5,28,2,0,35
2020,51021,Lucignano,AR,51,5,25,0,0,30,10,19,1,0,30
2020,51021,Lucignano,AR,52,7,19,2,0,28,5,24,0,1,30
2020,51021,Lucignano,AR,53,7,23,2,0,32,1,11,3,2,17
2020,51021,Lucignano,AR,54,3,14,3,0,20,4,21,2,0,27
2020,51021,Lucignano,AR,55,3,23,0,0,26,2,14,3,0,19
2020,51021,Lucignano,AR,56,3,23,4,0,30,4,16,1,2,23
2020,51021,Lucignano,AR,57,2,23,3,0,28,1,21,1,1,24
2020,51021,Lucignano,AR,58,1,15,0,0,16,1,20,4,1,26
2020,51021,Lucignano,AR,59,7,13,2,1,23,1,23,3,1,28
2020,51021,Lucignano,AR,60,7,20,1,1,29,4,24,1,0,29
2020,51021,Lucignano,AR,61,3,23,0,1,27,2,13,2,2,19
2020,51021,Lucignano,AR,62,2,24,3,1,30,2,20,0,0,22
2020,51021,Lucignano,AR,63,2,11,5,0,18,1,22,0,2,25
2020,51021,Lucignano,AR,64,1,13,0,2,16,0,15,3,6,24
2020,51021,Lucignano,AR,65,0,20,0,2,22,1,14,1,2,18
2020,51021,Lucignano,AR,66,1,28,2,1,32,1,18,0,3,22
2020,51021,Lucignano,AR,67,1,17,2,1,21,2,8,2,4,16
2020,51021,Lucignano,AR,68,1,15,1,0,17,0,20,1,4,25
2020,51021,Lucignano,AR,69,2,14,2,1,19,1,26,2,6,35
2020,51021,Lucignano,AR,70,0,25,0,1,26,1,13,1,5,20
2020,51021,Lucignano,AR,71,0,15,2,0,17,0,13,3,4,20
2020,51021,Lucignano,AR,72,2,16,2,1,21,0,13,1,7,21
2020,51021,Lucignano,AR,73,0,14,0,0,14,1,19,1,4,25
2020,51021,Lucignano,AR,74,2,23,0,1,26,3,20,0,8,31
2020,51021,Lucignano,AR,75,2,20,1,0,23,1,12,1,10,24
2020,51021,Lucignano,AR,76,1,13,0,1,15,1,10,0,4,15
2020,51021,Lucignano,AR,77,0,13,1,2,16,1,7,0,5,13
2020,51021,Lucignano,AR,78,2,12,0,0,14,1,10,1,9,21
2020,51021,Lucignano,AR,79,1,9,0,4,14,0,11,0,11,22
2020,51021,Lucignano,AR,80,1,15,0,2,18,0,7,1,9,17
2020,51021,Lucignano,AR,81,1,13,0,1,15,1,6,1,8,16
2020,51021,Lucignano,AR,82,2,8,0,5,15,1,4,0,8,13
2020,51021,Lucignano,AR,83,2,13,1,1,17,0,4,0,13,17
2020,51021,Lucignano,AR,84,2,6,0,2,10,0,8,0,10,18
2020,51021,Lucignano,AR,85,0,5,0,2,7,1,8,0,6,15
2020,51021,Lucignano,AR,86,0,5,0,7,12,0,3,0,7,10
2020,51021,Lucignano,AR,87,1,8,0,2,11,0,1,0,5,6
2020,51021,Lucignano,AR,88,1,8,1,1,11,1,1,0,11,13
2020,51021,Lucignano,AR,89,1,1,0,2,4,0,0,0,11,11
2020,51021,Lucignano,AR,90,0,4,0,1,5,1,0,0,8,9
2020,51021,Lucignano,AR,91,0,2,0,2,4,0,1,0,10,11
2020,51021,Lucignano,AR,92,0,1,0,1,2,0,1,0,3,4
2020,51021,Lucignano,AR,93,0,2,0,0,2,0,0,0,7,7
2020,51021,Lucignano,AR,94,0,0,0,1,1,1,0,0,5,6
2020,51021,Lucignano,AR,95,0,0,0,0,0,1,1,1,3,6
2020,51021,Lucignano,AR,96,0,0,0,1,1,0,0,1,5,6
2020,51021,Lucignano,AR,97,0,0,0,1,1,0,0,0,4,4
2020,51021,Lucignano,AR,98,0,0,0,0,0,1,0,0,2,3
2020,51021,Lucignano,AR,99,1,1,0,0,2,0,0,0,0,0
2020,51021,Lucignano,AR,100 e più,0,0,0,0,0,1,0,0,0,1
2020,51022,Marciano della Chiana,AR,0,12,0,0,0,12,19,0,0,0,19
2020,51022,Marciano della Chiana,AR,1,10,0,0,0,10,11,0,0,0,11
2020,51022,Marciano della Chiana,AR,2,7,0,0,0,7,14,0,0,0,14
2020,51022,Marciano della Chiana,AR,3,10,0,0,0,10,15,0,0,0,15
2020,51022,Marciano della Chiana,AR,4,15,0,0,0,15,19,0,0,0,19
2020,51022,Marciano della Chiana,AR,5,17,0,0,0,17,9,0,0,0,9
2020,51022,Marciano della Chiana,AR,6,14,0,0,0,14,17,0,0,0,17
2020,51022,Marciano della Chiana,AR,7,20,0,0,0,20,12,0,0,0,12
2020,51022,Marciano della Chiana,AR,8,15,0,0,0,15,12,0,0,0,12
2020,51022,Marciano della Chiana,AR,9,11,0,0,0,11,17,0,0,0,17
2020,51022,Marciano della Chiana,AR,10,23,0,0,0,23,20,0,0,0,20
2020,51022,Marciano della Chiana,AR,11,16,0,0,0,16,14,0,0,0,14
2020,51022,Marciano della Chiana,AR,12,14,0,0,0,14,17,0,0,0,17
2020,51022,Marciano della Chiana,AR,13,21,0,0,0,21,25,0,0,0,25
2020,51022,Marciano della Chiana,AR,14,16,0,0,0,16,20,0,0,0,20
2020,51022,Marciano della Chiana,AR,15,22,0,0,0,22,12,0,0,0,12
2020,51022,Marciano della Chiana,AR,16,12,0,0,0,12,17,0,0,0,17
2020,51022,Marciano della Chiana,AR,17,14,0,0,0,14,21,0,0,0,21
2020,51022,Marciano della Chiana,AR,18,18,0,0,0,18,21,0,0,0,21
2020,51022,Marciano della Chiana,AR,19,19,0,0,0,19,23,1,0,0,24
2020,51022,Marciano della Chiana,AR,20,19,0,0,0,19,20,1,0,0,21
2020,51022,Marciano della Chiana,AR,21,20,1,0,0,21,17,0,0,0,17
2020,51022,Marciano della Chiana,AR,22,24,0,0,0,24,12,0,0,0,12
2020,51022,Marciano della Chiana,AR,23,17,0,0,0,17,13,0,0,0,13
2020,51022,Marciano della Chiana,AR,24,14,1,0,0,15,17,0,0,0,17
2020,51022,Marciano della Chiana,AR,25,16,0,0,0,16,19,2,0,0,21
2020,51022,Marciano della Chiana,AR,26,17,1,0,0,18,15,0,0,0,15
2020,51022,Marciano della Chiana,AR,27,18,1,0,0,19,12,5,0,0,17
2020,51022,Marciano della Chiana,AR,28,18,3,0,0,21,16,2,0,0,18
2020,51022,Marciano della Chiana,AR,29,27,0,0,0,27,13,12,0,0,25
2020,51022,Marciano della Chiana,AR,30,15,2,0,0,17,12,6,1,0,19
2020,51022,Marciano della Chiana,AR,31,13,2,0,0,15,15,5,0,0,20
2020,51022,Marciano della Chiana,AR,32,17,5,0,0,22,19,5,0,0,24
2020,51022,Marciano della Chiana,AR,33,8,3,0,0,11,8,8,0,0,16
2020,51022,Marciano della Chiana,AR,34,14,7,0,0,21,12,9,1,0,22
2020,51022,Marciano della Chiana,AR,35,7,5,0,0,12,9,11,2,0,22
2020,51022,Marciano della Chiana,AR,36,13,7,0,0,20,5,10,3,0,18
2020,51022,Marciano della Chiana,AR,37,14,9,1,0,24,6,9,0,0,15
2020,51022,Marciano della Chiana,AR,38,16,11,0,0,27,10,12,0,0,22
2020,51022,Marciano della Chiana,AR,39,10,15,0,0,25,5,19,1,0,25
2020,51022,Marciano della Chiana,AR,40,10,6,1,0,17,13,19,0,0,32
2020,51022,Marciano della Chiana,AR,41,9,14,0,0,23,3,19,1,0,23
2020,51022,Marciano della Chiana,AR,42,14,13,2,0,29,5,21,0,0,26
2020,51022,Marciano della Chiana,AR,43,7,16,1,0,24,4,14,3,0,21
2020,51022,Marciano della Chiana,AR,44,9,30,0,0,39,6,26,1,0,33
2020,51022,Marciano della Chiana,AR,45,11,21,2,1,35,10,25,1,0,36
2020,51022,Marciano della Chiana,AR,46,7,16,0,0,23,3,21,1,2,27
2020,51022,Marciano della Chiana,AR,47,6,29,1,0,36,3,22,3,0,28
2020,51022,Marciano della Chiana,AR,48,12,22,1,0,35,4,27,2,1,34
2020,51022,Marciano della Chiana,AR,49,2,27,0,0,29,4,17,1,1,23
2020,51022,Marciano della Chiana,AR,50,2,18,2,1,23,5,23,3,0,31
2020,51022,Marciano della Chiana,AR,51,3,27,1,1,32,3,34,1,2,40
2020,51022,Marciano della Chiana,AR,52,5,18,1,1,25,2,26,4,0,32
2020,51022,Marciano della Chiana,AR,53,1,23,0,0,24,4,19,1,2,26
2020,51022,Marciano della Chiana,AR,54,1,24,1,0,26,3,22,0,3,28
2020,51022,Marciano della Chiana,AR,55,0,16,2,1,19,6,12,4,1,23
2020,51022,Marciano della Chiana,AR,56,2,27,0,0,29,3,24,1,2,30
2020,51022,Marciano della Chiana,AR,57,2,17,1,0,20,0,24,1,1,26
2020,51022,Marciano della Chiana,AR,58,1,17,1,1,20,1,19,2,1,23
2020,51022,Marciano della Chiana,AR,59,2,15,2,0,19,2,17,1,0,20
2020,51022,Marciano della Chiana,AR,60,0,15,1,1,17,1,17,1,1,20
2020,51022,Marciano della Chiana,AR,61,4,25,0,1,30,0,20,2,1,23
2020,51022,Marciano della Chiana,AR,62,2,17,1,0,20,3,17,1,0,21
2020,51022,Marciano della Chiana,AR,63,0,18,1,0,19,0,13,3,1,17
2020,51022,Marciano della Chiana,AR,64,3,14,0,1,18,2,16,0,1,19
2020,51022,Marciano della Chiana,AR,65,0,19,1,3,23,0,16,3,4,23
2020,51022,Marciano della Chiana,AR,66,3,21,1,1,26,2,15,0,2,19
2020,51022,Marciano della Chiana,AR,67,3,15,1,0,19,0,14,1,7,22
2020,51022,Marciano della Chiana,AR,68,1,18,0,1,20,0,14,0,3,17
2020,51022,Marciano della Chiana,AR,69,0,16,2,0,18,0,11,1,1,13
2020,51022,Marciano della Chiana,AR,70,2,9,0,1,12,0,19,0,4,23
2020,51022,Marciano della Chiana,AR,71,1,10,0,1,12,0,20,0,7,27
2020,51022,Marciano della Chiana,AR,72,1,19,0,1,21,1,13,0,3,17
2020,51022,Marciano della Chiana,AR,73,1,20,1,1,23,0,19,0,2,21
2020,51022,Marciano della Chiana,AR,74,0,16,0,1,17,0,14,0,4,18
2020,51022,Marciano della Chiana,AR,75,0,11,0,1,12,0,8,0,4,12
2020,51022,Marciano della Chiana,AR,76,2,14,0,1,17,0,5,0,5,10
2020,51022,Marciano della Chiana,AR,77,1,8,0,1,10,0,5,0,4,9
2020,51022,Marciano della Chiana,AR,78,1,9,0,0,10,0,7,0,5,12
2020,51022,Marciano della Chiana,AR,79,0,19,1,2,22,0,5,0,1,6
2020,51022,Marciano della Chiana,AR,80,0,10,0,1,11,3,5,0,4,12
2020,51022,Marciano della Chiana,AR,81,0,7,0,1,8,0,4,0,7,11
2020,51022,Marciano della Chiana,AR,82,1,4,0,0,5,0,7,0,11,18
2020,51022,Marciano della Chiana,AR,83,0,7,0,2,9,0,4,0,9,13
2020,51022,Marciano della Chiana,AR,84,1,0,0,2,3,0,2,0,8,10
2020,51022,Marciano della Chiana,AR,85,0,7,0,2,9,1,6,0,7,14
2020,51022,Marciano della Chiana,AR,86,0,4,0,1,5,0,0,0,9,9
2020,51022,Marciano della Chiana,AR,87,0,6,0,0,6,0,1,0,13,14
2020,51022,Marciano della Chiana,AR,88,0,2,0,1,3,0,1,0,7,8
2020,51022,Marciano della Chiana,AR,89,0,6,0,1,7,0,1,0,7,8
2020,51022,Marciano della Chiana,AR,90,1,0,0,1,2,0,0,0,4,4
2020,51022,Marciano della Chiana,AR,91,0,0,0,1,1,0,0,0,8,8
2020,51022,Marciano della Chiana,AR,92,0,2,0,0,2,0,1,0,7,8
2020,51022,Marciano della Chiana,AR,93,0,1,0,1,2,0,0,0,0,0
2020,51022,Marciano della Chiana,AR,94,0,1,0,0,1,0,0,0,2,2
2020,51022,Marciano della Chiana,AR,95,0,0,0,0,0,0,0,0,2,2
2020,51022,Marciano della Chiana,AR,96,0,0,0,0,0,0,0,0,1,1
2020,51022,Marciano della Chiana,AR,97,0,0,0,0,0,0,0,0,0,0
2020,51022,Marciano della Chiana,AR,98,0,0,0,0,0,0,0,0,0,0
2020,51022,Marciano della Chiana,AR,99,0,0,0,0,0,0,0,0,1,1
2020,51022,Marciano della Chiana,AR,100 e più,0,0,0,0,0,0,0,0,0,0
2020,51023,Montemignaio,AR,0,0,0,0,0,0,2,0,0,0,2
2020,51023,Montemignaio,AR,1,1,0,0,0,1,2,0,0,0,2
2020,51023,Montemignaio,AR,2,1,0,0,0,1,0,0,0,0,0
2020,51023,Montemignaio,AR,3,0,0,0,0,0,0,0,0,0,0
2020,51023,Montemignaio,AR,4,1,0,0,0,1,2,0,0,0,2
2020,51023,Montemignaio,AR,5,2,0,0,0,2,2,0,0,0,2
2020,51023,Montemignaio,AR,6,0,0,0,0,0,0,0,0,0,0
2020,51023,Montemignaio,AR,7,0,0,0,0,0,3,0,0,0,3
2020,51023,Montemignaio,AR,8,2,0,0,0,2,0,0,0,0,0
2020,51023,Montemignaio,AR,9,2,0,0,0,2,5,0,0,0,5
2020,51023,Montemignaio,AR,10,1,0,0,0,1,2,0,0,0,2
2020,51023,Montemignaio,AR,11,0,0,0,0,0,0,0,0,0,0
2020,51023,Montemignaio,AR,12,0,0,0,0,0,2,0,0,0,2
2020,51023,Montemignaio,AR,13,1,0,0,0,1,0,0,0,0,0
2020,51023,Montemignaio,AR,14,0,0,0,0,0,2,0,0,0,2
2020,51023,Montemignaio,AR,15,0,0,0,0,0,2,0,0,0,2
2020,51023,Montemignaio,AR,16,1,0,0,0,1,1,0,0,0,1
2020,51023,Montemignaio,AR,17,1,0,0,0,1,1,0,0,0,1
2020,51023,Montemignaio,AR,18,1,0,0,0,1,2,0,0,0,2
2020,51023,Montemignaio,AR,19,0,0,0,0,0,0,0,0,0,0
2020,51023,Montemignaio,AR,20,3,0,0,0,3,2,0,0,0,2
2020,51023,Montemignaio,AR,21,4,0,0,0,4,0,0,0,0,0
2020,51023,Montemignaio,AR,22,0,0,0,0,0,3,0,0,0,3
2020,51023,Montemignaio,AR,23,3,0,0,0,3,2,0,0,0,2
2020,51023,Montemignaio,AR,24,2,0,0,0,2,1,0,0,0,1
2020,51023,Montemignaio,AR,25,2,0,0,0,2,6,0,0,0,6
2020,51023,Montemignaio,AR,26,0,0,0,0,0,3,0,0,0,3
2020,51023,Montemignaio,AR,27,5,0,0,0,5,0,0,0,0,0
2020,51023,Montemignaio,AR,28,1,0,0,0,1,1,0,0,0,1
2020,51023,Montemignaio,AR,29,3,0,0,0,3,3,0,0,0,3
2020,51023,Montemignaio,AR,30,4,1,0,0,5,2,1,0,0,3
2020,51023,Montemignaio,AR,31,1,0,0,0,1,1,0,0,0,1
2020,51023,Montemignaio,AR,32,5,0,0,0,5,1,0,0,0,1
2020,51023,Montemignaio,AR,33,3,0,0,0,3,0,1,0,0,1
2020,51023,Montemignaio,AR,34,0,0,0,0,0,0,0,0,0,0
2020,51023,Montemignaio,AR,35,1,1,0,0,2,1,0,0,0,1
2020,51023,Montemignaio,AR,36,2,0,0,0,2,1,2,0,0,3
2020,51023,Montemignaio,AR,37,2,0,0,0,2,0,0,0,0,0
2020,51023,Montemignaio,AR,38,1,0,0,0,1,1,2,0,0,3
2020,51023,Montemignaio,AR,39,3,2,0,0,5,0,0,0,0,0
2020,51023,Montemignaio,AR,40,1,0,0,0,1,1,4,0,0,5
2020,51023,Montemignaio,AR,41,1,1,0,0,2,0,2,0,0,2
2020,51023,Montemignaio,AR,42,3,1,0,0,4,0,2,0,0,2
2020,51023,Montemignaio,AR,43,0,2,0,0,2,1,0,0,0,1
2020,51023,Montemignaio,AR,44,0,2,0,0,2,1,1,0,0,2
2020,51023,Montemignaio,AR,45,3,1,0,0,4,1,3,0,0,4
2020,51023,Montemignaio,AR,46,1,3,0,0,4,2,3,0,0,5
2020,51023,Montemignaio,AR,47,3,2,0,0,5,0,2,1,0,3
2020,51023,Montemignaio,AR,48,2,2,0,0,4,1,1,1,0,3
2020,51023,Montemignaio,AR,49,1,1,0,0,2,3,3,0,0,6
2020,51023,Montemignaio,AR,50,3,0,0,0,3,0,4,0,0,4
2020,51023,Montemignaio,AR,51,2,4,1,0,7,0,1,0,0,1
2020,51023,Montemignaio,AR,52,4,1,0,0,5,0,5,0,0,5
2020,51023,Montemignaio,AR,53,0,2,0,0,2,2,3,0,0,5
2020,51023,Montemignaio,AR,54,2,4,0,0,6,1,5,0,0,6
2020,51023,Montemignaio,AR,55,2,3,0,0,5,1,4,0,0,5
2020,51023,Montemignaio,AR,56,5,4,0,0,9,1,8,0,0,9
2020,51023,Montemignaio,AR,57,3,1,0,0,4,0,1,0,2,3
2020,51023,Montemignaio,AR,58,2,2,1,0,5,1,5,0,0,6
2020,51023,Montemignaio,AR,59,2,5,0,0,7,0,5,0,0,5
2020,51023,Montemignaio,AR,60,2,5,0,0,7,0,2,0,1,3
2020,51023,Montemignaio,AR,61,0,3,1,0,4,1,1,0,0,2
2020,51023,Montemignaio,AR,62,0,2,0,0,2,2,3,0,0,5
2020,51023,Montemignaio,AR,63,1,4,0,0,5,0,3,0,0,3
2020,51023,Montemignaio,AR,64,1,5,0,1,7,1,8,0,0,9
2020,51023,Montemignaio,AR,65,1,5,0,0,6,0,2,0,0,2
2020,51023,Montemignaio,AR,66,1,3,0,0,4,0,6,1,0,7
2020,51023,Montemignaio,AR,67,0,3,0,1,4,0,1,0,0,1
2020,51023,Montemignaio,AR,68,2,1,0,0,3,0,1,0,0,1
2020,51023,Montemignaio,AR,69,0,6,0,0,6,1,3,0,1,5
2020,51023,Montemignaio,AR,70,0,7,0,0,7,0,1,2,0,3
2020,51023,Montemignaio,AR,71,2,5,0,0,7,0,2,0,0,2
2020,51023,Montemignaio,AR,72,2,7,0,0,9,0,5,0,1,6
2020,51023,Montemignaio,AR,73,0,3,0,0,3,0,3,0,0,3
2020,51023,Montemignaio,AR,74,1,1,0,1,3,0,3,0,1,4
2020,51023,Montemignaio,AR,75,0,3,0,0,3,0,2,0,1,3
2020,51023,Montemignaio,AR,76,0,6,0,0,6,0,2,0,1,3
2020,51023,Montemignaio,AR,77,0,2,1,0,3,0,0,0,0,0
2020,51023,Montemignaio,AR,78,0,1,0,0,1,0,3,0,3,6
2020,51023,Montemignaio,AR,79,2,4,0,0,6,1,0,0,0,1
2020,51023,Montemignaio,AR,80,0,2,0,0,2,0,1,0,3,4
2020,51023,Montemignaio,AR,81,0,3,0,0,3,0,0,1,3,4
2020,51023,Montemignaio,AR,82,0,1,0,0,1,0,3,0,1,4
2020,51023,Montemignaio,AR,83,0,2,0,1,3,0,0,0,2,2
2020,51023,Montemignaio,AR,84,0,1,0,0,1,0,3,0,2,5
2020,51023,Montemignaio,AR,85,1,1,1,0,3,0,0,0,1,1
2020,51023,Montemignaio,AR,86,0,0,0,0,0,0,1,0,0,1
2020,51023,Montemignaio,AR,87,0,0,0,0,0,0,0,0,2,2
2020,51023,Montemignaio,AR,88,0,1,0,0,1,0,2,0,1,3
2020,51023,Montemignaio,AR,89,0,2,0,0,2,0,0,0,3,3
2020,51023,Montemignaio,AR,90,0,0,0,2,2,0,0,0,2,2
2020,51023,Montemignaio,AR,91,1,0,0,0,1,0,0,0,2,2
2020,51023,Montemignaio,AR,92,1,0,0,0,1,0,0,0,1,1
2020,51023,Montemignaio,AR,93,0,1,0,0,1,0,0,0,2,2
2020,51023,Montemignaio,AR,94,0,0,0,2,2,0,0,0,0,0
2020,51023,Montemignaio,AR,95,0,0,0,1,1,0,0,0,2,2
2020,51023,Montemignaio,AR,96,0,0,0,0,0,2,0,0,0,2
2020,51023,Montemignaio,AR,97,0,0,0,0,0,0,0,0,1,1
2020,51023,Montemignaio,AR,98,0,0,0,0,0,0,0,0,0,0
2020,51023,Montemignaio,AR,99,0,0,0,0,0,0,0,0,0,0
2020,51023,Montemignaio,AR,100 e più,0,0,0,0,0,0,0,0,1,1
2020,51024,Monterchi,AR,0,9,0,0,0,9,9,0,0,0,9
2020,51024,Monterchi,AR,1,2,0,0,0,2,5,0,0,0,5
2020,51024,Monterchi,AR,2,5,0,0,0,5,3,0,0,0,3
2020,51024,Monterchi,AR,3,3,0,0,0,3,10,0,0,0,10
2020,51024,Monterchi,AR,4,3,0,0,0,3,4,0,0,0,4
2020,51024,Monterchi,AR,5,3,0,0,0,3,1,0,0,0,1
2020,51024,Monterchi,AR,6,4,0,0,0,4,4,0,0,0,4
2020,51024,Monterchi,AR,7,9,0,0,0,9,3,0,0,0,3
2020,51024,Monterchi,AR,8,6,0,0,0,6,6,0,0,0,6
2020,51024,Monterchi,AR,9,4,0,0,0,4,7,0,0,0,7
2020,51024,Monterchi,AR,10,11,0,0,0,11,6,0,0,0,6
2020,51024,Monterchi,AR,11,12,0,0,0,12,6,0,0,0,6
2020,51024,Monterchi,AR,12,11,0,0,0,11,5,0,0,0,5
2020,51024,Monterchi,AR,13,10,0,0,0,10,6,0,0,0,6
2020,51024,Monterchi,AR,14,5,0,0,0,5,8,0,0,0,8
2020,51024,Monterchi,AR,15,11,0,0,0,11,7,0,0,0,7
2020,51024,Monterchi,AR,16,8,0,0,0,8,6,0,0,0,6
2020,51024,Monterchi,AR,17,6,0,0,0,6,10,0,0,0,10
2020,51024,Monterchi,AR,18,6,0,0,0,6,6,0,0,0,6
2020,51024,Monterchi,AR,19,4,0,0,0,4,3,0,0,0,3
2020,51024,Monterchi,AR,20,5,0,0,0,5,5,0,0,0,5
2020,51024,Monterchi,AR,21,6,0,0,0,6,7,0,0,0,7
2020,51024,Monterchi,AR,22,7,0,0,0,7,6,0,0,0,6
2020,51024,Monterchi,AR,23,5,0,0,0,5,5,0,0,0,5
2020,51024,Monterchi,AR,24,6,0,0,0,6,2,0,0,0,2
2020,51024,Monterchi,AR,25,13,0,0,0,13,4,0,0,0,4
2020,51024,Monterchi,AR,26,6,0,0,0,6,9,0,0,0,9
2020,51024,Monterchi,AR,27,14,0,0,0,14,7,1,0,0,8
2020,51024,Monterchi,AR,28,4,0,0,0,4,6,2,0,0,8
2020,51024,Monterchi,AR,29,11,0,0,0,11,6,1,0,0,7
2020,51024,Monterchi,AR,30,9,1,0,0,10,6,1,0,0,7
2020,51024,Monterchi,AR,31,11,0,0,0,11,6,3,0,0,9
2020,51024,Monterchi,AR,32,8,3,0,0,11,7,3,1,0,11
2020,51024,Monterchi,AR,33,9,3,0,0,12,8,6,0,0,14
2020,51024,Monterchi,AR,34,2,4,0,0,6,2,5,0,0,7
2020,51024,Monterchi,AR,35,6,4,0,0,10,4,5,1,0,10
2020,51024,Monterchi,AR,36,7,2,0,0,9,1,5,0,0,6
2020,51024,Monterchi,AR,37,2,7,0,0,9,6,4,1,0,11
2020,51024,Monterchi,AR,38,8,7,0,0,15,3,5,0,0,8
2020,51024,Monterchi,AR,39,6,3,0,0,9,4,8,0,0,12
2020,51024,Monterchi,AR,40,6,4,1,0,11,2,5,0,0,7
2020,51024,Monterchi,AR,41,3,9,0,0,12,5,10,1,0,16
2020,51024,Monterchi,AR,42,7,2,0,0,9,1,9,0,0,10
2020,51024,Monterchi,AR,43,5,5,0,0,10,4,3,0,0,7
2020,51024,Monterchi,AR,44,1,8,0,0,9,1,6,1,0,8
2020,51024,Monterchi,AR,45,3,10,2,0,15,3,9,1,1,14
2020,51024,Monterchi,AR,46,1,8,0,0,9,6,11,0,0,17
2020,51024,Monterchi,AR,47,6,12,0,0,18,3,6,0,1,10
2020,51024,Monterchi,AR,48,2,7,0,0,9,2,6,0,0,8
2020,51024,Monterchi,AR,49,4,7,0,0,11,4,5,1,0,10
2020,51024,Monterchi,AR,50,2,7,3,0,12,2,6,2,0,10
2020,51024,Monterchi,AR,51,2,12,0,0,14,5,14,0,1,20
2020,51024,Monterchi,AR,52,2,5,0,0,7,1,5,1,1,8
2020,51024,Monterchi,AR,53,1,6,0,0,7,3,3,1,0,7
2020,51024,Monterchi,AR,54,3,10,3,0,16,2,10,1,1,14
2020,51024,Monterchi,AR,55,2,5,1,0,8,1,14,0,0,15
2020,51024,Monterchi,AR,56,3,9,0,0,12,2,13,0,1,16
2020,51024,Monterchi,AR,57,2,5,0,0,7,2,13,1,0,16
2020,51024,Monterchi,AR,58,1,12,1,0,14,2,12,0,0,14
2020,51024,Monterchi,AR,59,1,12,0,2,15,2,18,0,2,22
2020,51024,Monterchi,AR,60,2,12,0,0,14,0,13,0,3,16
2020,51024,Monterchi,AR,61,1,13,1,1,16,0,9,1,0,10
2020,51024,Monterchi,AR,62,3,16,0,0,19,1,8,0,0,9
2020,51024,Monterchi,AR,63,5,16,1,0,22,3,11,2,3,19
2020,51024,Monterchi,AR,64,3,14,0,0,17,1,9,1,1,12
2020,51024,Monterchi,AR,65,1,8,0,0,9,2,9,0,2,13
2020,51024,Monterchi,AR,66,4,7,0,0,11,0,11,2,1,14
2020,51024,Monterchi,AR,67,2,10,2,1,15,0,11,1,1,13
2020,51024,Monterchi,AR,68,0,10,1,0,11,0,9,0,2,11
2020,51024,Monterchi,AR,69,3,13,0,0,16,1,11,0,4,16
2020,51024,Monterchi,AR,70,1,12,1,0,14,1,9,0,3,13
2020,51024,Monterchi,AR,71,0,11,0,0,11,0,10,1,3,14
2020,51024,Monterchi,AR,72,1,9,0,1,11,1,10,1,2,14
2020,51024,Monterchi,AR,73,1,13,1,1,16,0,8,0,6,14
2020,51024,Monterchi,AR,74,1,13,0,1,15,0,8,0,3,11
2020,51024,Monterchi,AR,75,0,4,0,0,4,1,7,0,3,11
2020,51024,Monterchi,AR,76,0,5,0,0,5,0,4,0,8,12
2020,51024,Monterchi,AR,77,1,4,0,1,6,0,3,0,4,7
2020,51024,Monterchi,AR,78,0,6,0,1,7,1,4,0,3,8
2020,51024,Monterchi,AR,79,1,7,0,1,9,0,4,0,2,6
2020,51024,Monterchi,AR,80,1,7,0,2,10,0,1,0,5,6
2020,51024,Monterchi,AR,81,0,6,0,0,6,1,1,0,9,11
2020,51024,Monterchi,AR,82,0,5,0,1,6,1,4,1,3,9
2020,51024,Monterchi,AR,83,1,2,0,0,3,1,3,0,5,9
2020,51024,Monterchi,AR,84,2,2,0,1,5,0,5,0,6,11
2020,51024,Monterchi,AR,85,1,4,0,2,7,0,5,0,3,8
2020,51024,Monterchi,AR,86,0,4,0,0,4,0,2,0,8,10
2020,51024,Monterchi,AR,87,1,4,0,1,6,0,1,0,1,2
2020,51024,Monterchi,AR,88,0,3,1,0,4,0,0,0,6,6
2020,51024,Monterchi,AR,89,0,3,1,0,4,0,1,0,5,6
2020,51024,Monterchi,AR,90,0,2,0,1,3,0,0,0,8,8
2020,51024,Monterchi,AR,91,0,3,0,1,4,0,0,0,4,4
2020,51024,Monterchi,AR,92,0,1,0,0,1,0,0,0,3,3
2020,51024,Monterchi,AR,93,0,0,0,1,1,0,1,0,2,3
2020,51024,Monterchi,AR,94,0,0,0,0,0,0,0,0,3,3
2020,51024,Monterchi,AR,95,0,0,0,0,0,0,0,0,3,3
2020,51024,Monterchi,AR,96,0,1,0,0,1,0,0,0,0,0
2020,51024,Monterchi,AR,97,0,0,0,0,0,0,0,0,3,3
2020,51024,Monterchi,AR,98,0,0,0,0,0,0,0,0,0,0
2020,51024,Monterchi,AR,99,0,0,0,0,0,0,0,0,0,0
2020,51024,Monterchi,AR,100 e più,0,0,0,0,0,0,0,0,1,1
2020,51025,Monte San Savino,AR,0,26,0,0,0,26,24,0,0,0,24
2020,51025,Monte San Savino,AR,1,28,0,0,0,28,27,0,0,0,27
2020,51025,Monte San Savino,AR,2,30,0,0,0,30,23,0,0,0,23
2020,51025,Monte San Savino,AR,3,26,0,0,0,26,43,0,0,0,43
2020,51025,Monte San Savino,AR,4,37,0,0,0,37,28,0,0,0,28
2020,51025,Monte San Savino,AR,5,38,0,0,0,38,36,0,0,0,36
2020,51025,Monte San Savino,AR,6,31,0,0,0,31,31,0,0,0,31
2020,51025,Monte San Savino,AR,7,32,0,0,0,32,38,0,0,0,38
2020,51025,Monte San Savino,AR,8,50,0,0,0,50,45,0,0,0,45
2020,51025,Monte San Savino,AR,9,45,0,0,0,45,36,0,0,0,36
2020,51025,Monte San Savino,AR,10,37,0,0,0,37,32,0,0,0,32
2020,51025,Monte San Savino,AR,11,40,0,0,0,40,41,0,0,0,41
2020,51025,Monte San Savino,AR,12,38,0,0,0,38,33,0,0,0,33
2020,51025,Monte San Savino,AR,13,39,0,0,0,39,33,0,0,0,33
2020,51025,Monte San Savino,AR,14,33,0,0,0,33,48,0,0,0,48
2020,51025,Monte San Savino,AR,15,37,0,0,0,37,44,0,0,0,44
2020,51025,Monte San Savino,AR,16,38,0,0,0,38,44,0,0,0,44
2020,51025,Monte San Savino,AR,17,42,0,0,0,42,40,0,0,0,40
2020,51025,Monte San Savino,AR,18,31,0,0,0,31,38,0,0,0,38
2020,51025,Monte San Savino,AR,19,31,0,0,0,31,28,0,0,0,28
2020,51025,Monte San Savino,AR,20,42,0,0,0,42,40,1,0,0,41
2020,51025,Monte San Savino,AR,21,32,0,0,0,32,38,0,0,0,38
2020,51025,Monte San Savino,AR,22,53,0,0,0,53,38,0,0,0,38
2020,51025,Monte San Savino,AR,23,37,0,0,0,37,26,1,0,0,27
2020,51025,Monte San Savino,AR,24,46,0,0,0,46,35,1,0,0,36
2020,51025,Monte San Savino,AR,25,29,2,0,0,31,50,4,0,0,54
2020,51025,Monte San Savino,AR,26,38,0,0,0,38,23,6,0,0,29
2020,51025,Monte San Savino,AR,27,45,3,0,0,48,29,4,0,0,33
2020,51025,Monte San Savino,AR,28,42,2,0,0,44,38,6,0,0,44
2020,51025,Monte San Savino,AR,29,36,6,0,0,42,35,8,0,0,43
2020,51025,Monte San Savino,AR,30,37,10,2,0,49,37,10,0,0,47
2020,51025,Monte San Savino,AR,31,20,9,0,0,29,34,12,2,0,48
2020,51025,Monte San Savino,AR,32,64,3,0,0,67,31,10,0,0,41
2020,51025,Monte San Savino,AR,33,32,20,1,0,53,23,19,0,0,42
2020,51025,Monte San Savino,AR,34,37,12,0,0,49,27,32,1,1,61
2020,51025,Monte San Savino,AR,35,32,17,0,0,49,25,30,4,1,60
2020,51025,Monte San Savino,AR,36,27,23,1,0,51,20,17,0,0,37
2020,51025,Monte San Savino,AR,37,37,24,1,0,62,19,25,2,0,46
2020,51025,Monte San Savino,AR,38,25,19,1,0,45,24,24,0,0,48
2020,51025,Monte San Savino,AR,39,23,23,2,0,48,26,22,4,1,53
2020,51025,Monte San Savino,AR,40,23,21,0,0,44,17,35,4,0,56
2020,51025,Monte San Savino,AR,41,21,28,3,0,52,14,49,4,0,67
2020,51025,Monte San Savino,AR,42,26,34,2,0,62,20,51,1,0,72
2020,51025,Monte San Savino,AR,43,23,41,3,0,67,14,42,3,0,59
2020,51025,Monte San Savino,AR,44,15,45,1,0,61,18,62,7,0,87
2020,51025,Monte San Savino,AR,45,18,33,4,0,55,21,43,2,0,66
2020,51025,Monte San Savino,AR,46,22,36,2,1,61,18,45,2,1,66
2020,51025,Monte San Savino,AR,47,22,50,1,0,73,13,55,3,1,72
2020,51025,Monte San Savino,AR,48,16,50,3,0,69,15,46,6,1,68
2020,51025,Monte San Savino,AR,49,13,42,6,0,61,12,46,9,0,67
2020,51025,Monte San Savino,AR,50,18,54,5,0,77,6,70,4,1,81
2020,51025,Monte San Savino,AR,51,19,58,1,1,79,7,57,5,4,73
2020,51025,Monte San Savino,AR,52,20,53,8,0,81,16,47,6,5,74
2020,51025,Monte San Savino,AR,53,13,53,4,1,71,11,49,6,3,69
2020,51025,Monte San Savino,AR,54,12,53,3,1,69,8,57,6,2,73
2020,51025,Monte San Savino,AR,55,10,47,8,1,66,9,53,11,5,78
2020,51025,Monte San Savino,AR,56,12,36,8,1,57,5,44,5,1,55
2020,51025,Monte San Savino,AR,57,10,59,3,0,72,5,62,4,4,75
2020,51025,Monte San Savino,AR,58,5,48,3,1,57,9,56,5,1,71
2020,51025,Monte San Savino,AR,59,3,58,2,1,64,5,57,4,5,71
2020,51025,Monte San Savino,AR,60,3,45,5,0,53,4,50,5,5,64
2020,51025,Monte San Savino,AR,61,11,64,2,2,79,2,33,3,3,41
2020,51025,Monte San Savino,AR,62,7,47,4,1,59,1,38,0,3,42
2020,51025,Monte San Savino,AR,63,2,48,3,0,53,4,50,2,3,59
2020,51025,Monte San Savino,AR,64,3,48,3,2,56,2,45,2,4,53
2020,51025,Monte San Savino,AR,65,5,46,2,1,54,3,52,4,4,63
2020,51025,Monte San Savino,AR,66,3,39,2,3,47,1,44,0,10,55
2020,51025,Monte San Savino,AR,67,3,41,0,3,47,1,31,3,5,40
2020,51025,Monte San Savino,AR,68,2,40,5,1,48,3,38,1,8,50
2020,51025,Monte San Savino,AR,69,3,36,1,1,41,2,39,1,6,48
2020,51025,Monte San Savino,AR,70,3,46,2,1,52,0,40,2,11,53
2020,51025,Monte San Savino,AR,71,3,47,2,0,52,3,37,2,12,54
2020,51025,Monte San Savino,AR,72,3,45,1,5,54,1,57,0,12,70
2020,51025,Monte San Savino,AR,73,3,42,1,2,48,4,47,2,18,71
2020,51025,Monte San Savino,AR,74,2,43,0,2,47,2,36,3,16,57
2020,51025,Monte San Savino,AR,75,4,29,1,2,36,2,19,0,12,33
2020,51025,Monte San Savino,AR,76,1,31,0,2,34,2,21,2,5,30
2020,51025,Monte San Savino,AR,77,4,37,0,3,44,1,27,0,13,41
2020,51025,Monte San Savino,AR,78,2,32,0,3,37,1,22,0,15,38
2020,51025,Monte San Savino,AR,79,3,31,0,1,35,1,22,0,17,40
2020,51025,Monte San Savino,AR,80,4,19,0,6,29,1,23,0,25,49
2020,51025,Monte San Savino,AR,81,4,29,0,3,36,3,13,0,17,33
2020,51025,Monte San Savino,AR,82,1,19,0,6,26,3,11,0,26,40
2020,51025,Monte San Savino,AR,83,2,25,0,3,30,3,14,0,15,32
2020,51025,Monte San Savino,AR,84,2,25,0,5,32,0,9,0,16,25
2020,51025,Monte San Savino,AR,85,0,17,0,4,21,1,11,1,20,33
2020,51025,Monte San Savino,AR,86,4,18,0,1,23,1,10,1,24,36
2020,51025,Monte San Savino,AR,87,0,16,0,4,20,2,8,0,15,25
2020,51025,Monte San Savino,AR,88,0,8,0,7,15,2,3,0,25,30
2020,51025,Monte San Savino,AR,89,3,9,0,4,16,2,3,0,29,34
2020,51025,Monte San Savino,AR,90,1,6,0,3,10,2,2,0,26,30
2020,51025,Monte San Savino,AR,91,1,3,0,4,8,0,0,0,20,20
2020,51025,Monte San Savino,AR,92,4,1,0,7,12,0,0,0,18,18
2020,51025,Monte San Savino,AR,93,0,1,0,3,4,1,0,0,12,13
2020,51025,Monte San Savino,AR,94,0,3,0,2,5,0,0,0,4,4
2020,51025,Monte San Savino,AR,95,1,1,0,3,5,0,0,0,4,4
2020,51025,Monte San Savino,AR,96,0,0,1,2,3,0,0,0,7,7
2020,51025,Monte San Savino,AR,97,0,0,0,1,1,0,0,0,2,2
2020,51025,Monte San Savino,AR,98,1,1,0,2,4,1,0,0,3,4
2020,51025,Monte San Savino,AR,99,0,0,0,0,0,1,0,0,2,3
2020,51025,Monte San Savino,AR,100 e più,0,0,0,1,1,0,0,0,5,5
2020,51026,Montevarchi,AR,0,95,0,0,0,95,85,0,0,0,85
2020,51026,Montevarchi,AR,1,93,0,0,0,93,76,0,0,0,76
2020,51026,Montevarchi,AR,2,108,0,0,0,108,101,0,0,0,101
2020,51026,Montevarchi,AR,3,112,0,0,0,112,96,0,0,0,96
2020,51026,Montevarchi,AR,4,82,0,0,0,82,90,0,0,0,90
2020,51026,Montevarchi,AR,5,107,0,0,0,107,83,0,0,0,83
2020,51026,Montevarchi,AR,6,114,0,0,0,114,95,0,0,0,95
2020,51026,Montevarchi,AR,7,126,0,0,0,126,83,0,0,0,83
2020,51026,Montevarchi,AR,8,121,0,0,0,121,112,0,0,0,112
2020,51026,Montevarchi,AR,9,126,0,0,0,126,104,0,0,0,104
2020,51026,Montevarchi,AR,10,110,0,0,0,110,120,0,0,0,120
2020,51026,Montevarchi,AR,11,132,0,0,0,132,128,0,0,0,128
2020,51026,Montevarchi,AR,12,108,0,0,0,108,116,0,0,0,116
2020,51026,Montevarchi,AR,13,107,0,0,0,107,126,0,0,0,126
2020,51026,Montevarchi,AR,14,110,0,0,0,110,89,0,0,0,89
2020,51026,Montevarchi,AR,15,121,0,0,0,121,115,0,0,0,115
2020,51026,Montevarchi,AR,16,125,0,0,0,125,118,0,0,0,118
2020,51026,Montevarchi,AR,17,94,0,0,0,94,99,0,0,0,99
2020,51026,Montevarchi,AR,18,107,0,0,0,107,94,0,0,0,94
2020,51026,Montevarchi,AR,19,133,0,0,0,133,113,2,0,0,115
2020,51026,Montevarchi,AR,20,111,1,0,0,112,111,1,0,0,112
2020,51026,Montevarchi,AR,21,118,1,0,0,119,92,0,0,0,92
2020,51026,Montevarchi,AR,22,137,0,0,0,137,112,1,0,0,113
2020,51026,Montevarchi,AR,23,126,0,0,0,126,90,7,0,0,97
2020,51026,Montevarchi,AR,24,131,1,0,0,132,106,9,0,0,115
2020,51026,Montevarchi,AR,25,99,2,0,0,102,82,12,0,0,94
2020,51026,Montevarchi,AR,26,145,9,0,0,154,106,17,0,0,123
2020,51026,Montevarchi,AR,27,106,8,0,0,114,91,27,0,0,118
2020,51026,Montevarchi,AR,28,125,11,0,0,136,96,27,0,0,123
2020,51026,Montevarchi,AR,29,94,15,0,0,109,87,35,1,0,123
2020,51026,Montevarchi,AR,30,106,22,1,0,129,95,44,2,1,142
2020,51026,Montevarchi,AR,31,118,27,1,0,146,71,62,4,0,137
2020,51026,Montevarchi,AR,32,101,45,1,0,148,97,60,0,0,157
2020,51026,Montevarchi,AR,33,109,36,3,0,148,61,70,4,0,135
2020,51026,Montevarchi,AR,34,112,55,4,0,171,66,64,1,1,132
2020,51026,Montevarchi,AR,35,80,56,2,0,139,59,75,5,0,139
2020,51026,Montevarchi,AR,36,77,63,0,0,140,59,80,4,0,143
2020,51026,Montevarchi,AR,37,74,85,5,0,166,39,79,4,1,123
2020,51026,Montevarchi,AR,38,64,72,1,0,137,54,91,4,1,150
2020,51026,Montevarchi,AR,39,79,75,1,0,156,51,81,11,2,145
2020,51026,Montevarchi,AR,40,66,101,2,0,169,39,112,8,2,161
2020,51026,Montevarchi,AR,41,68,87,4,0,160,46,99,3,0,148
2020,51026,Montevarchi,AR,42,75,84,4,1,164,43,95,10,0,148
2020,51026,Montevarchi,AR,43,68,87,4,1,160,37,103,7,3,150
2020,51026,Montevarchi,AR,44,68,105,11,0,184,37,124,10,1,172
2020,51026,Montevarchi,AR,45,71,120,9,0,200,32,137,16,1,186
2020,51026,Montevarchi,AR,46,74,100,12,1,187,40,129,18,3,190
2020,51026,Montevarchi,AR,47,52,129,6,0,187,44,127,14,1,186
2020,51026,Montevarchi,AR,48,55,133,6,1,195,40,118,16,4,179
2020,51026,Montevarchi,AR,49,51,114,12,0,177,37,133,19,3,192
2020,51026,Montevarchi,AR,50,55,128,17,0,200,30,132,13,2,177
2020,51026,Montevarchi,AR,51,45,125,8,2,180,24,132,14,3,173
2020,51026,Montevarchi,AR,52,44,145,9,0,198,22,135,19,9,185
2020,51026,Montevarchi,AR,53,33,142,12,0,187,38,151,22,7,218
2020,51026,Montevarchi,AR,54,51,129,7,2,189,25,135,23,8,191
2020,51026,Montevarchi,AR,55,35,133,16,3,188,36,149,16,13,214
2020,51026,Montevarchi,AR,56,40,139,9,0,188,24,122,19,9,174
2020,51026,Montevarchi,AR,57,29,131,15,0,176,16,148,21,12,197
2020,51026,Montevarchi,AR,58,30,125,12,0,167,19,147,18,10,194
2020,51026,Montevarchi,AR,59,24,123,4,0,151,17,134,15,13,180
2020,51026,Montevarchi,AR,60,26,123,13,4,167,18,141,14,13,186
2020,51026,Montevarchi,AR,61,24,130,8,1,165,9,119,12,15,155
2020,51026,Montevarchi,AR,62,18,102,17,4,141,12,144,9,10,175
2020,51026,Montevarchi,AR,63,12,125,6,4,147,3,121,10,12,146
2020,51026,Montevarchi,AR,64,13,124,7,2,146,12,112,11,15,150
2020,51026,Montevarchi,AR,65,5,106,7,1,119,12,124,10,16,162
2020,51026,Montevarchi,AR,66,10,107,6,1,125,7,101,16,15,139
2020,51026,Montevarchi,AR,67,10,100,10,6,126,10,91,6,13,120
2020,51026,Montevarchi,AR,68,9,118,2,6,136,7,88,7,10,112
2020,51026,Montevarchi,AR,69,9,108,6,5,128,4,95,8,21,128
2020,51026,Montevarchi,AR,70,17,94,8,5,124,7,93,8,25,133
2020,51026,Montevarchi,AR,71,4,105,1,12,122,8,128,7,22,165
2020,51026,Montevarchi,AR,72,14,109,6,10,139,6,98,2,40,146
2020,51026,Montevarchi,AR,73,1,102,4,10,117,11,93,7,40,151
2020,51026,Montevarchi,AR,74,11,136,4,12,163,5,113,7,41,166
2020,51026,Montevarchi,AR,75,7,91,2,11,111,1,78,3,39,121
2020,51026,Montevarchi,AR,76,5,94,1,8,108,6,77,2,26,111
2020,51026,Montevarchi,AR,77,8,71,0,10,89,6,83,5,39,133
2020,51026,Montevarchi,AR,78,2,70,3,10,85,10,60,2,46,118
2020,51026,Montevarchi,AR,79,5,77,0,15,97,2,70,2,57,131
2020,51026,Montevarchi,AR,80,3,82,1,15,101,8,59,0,59,126
2020,51026,Montevarchi,AR,81,5,71,0,14,90,12,55,1,62,130
2020,51026,Montevarchi,AR,82,6,75,0,9,90,7,67,3,62,139
2020,51026,Montevarchi,AR,83,3,64,1,13,81,2,37,0,69,108
2020,51026,Montevarchi,AR,84,6,66,0,9,81,8,31,1,57,97
2020,51026,Montevarchi,AR,85,5,54,0,16,75,3,23,2,84,112
2020,51026,Montevarchi,AR,86,1,52,0,14,67,3,19,1,55,78
2020,51026,Montevarchi,AR,87,5,30,0,8,43,3,19,2,51,75
2020,51026,Montevarchi,AR,88,1,20,0,7,28,0,7,0,38,45
2020,51026,Montevarchi,AR,89,3,22,0,7,32,2,11,0,57,70
2020,51026,Montevarchi,AR,90,3,10,0,20,33,1,5,0,57,63
2020,51026,Montevarchi,AR,91,1,11,0,9,21,3,2,0,30,35
2020,51026,Montevarchi,AR,92,1,5,0,3,9,2,1,0,29,32
2020,51026,Montevarchi,AR,93,0,6,0,7,13,5,4,1,33,43
2020,51026,Montevarchi,AR,94,2,4,0,7,13,0,0,0,24,24
2020,51026,Montevarchi,AR,95,0,4,0,2,6,1,1,0,16,18
2020,51026,Montevarchi,AR,96,0,0,0,6,6,1,0,0,15,16
2020,51026,Montevarchi,AR,97,0,0,0,2,2,1,0,0,4,5
2020,51026,Montevarchi,AR,98,0,2,0,0,2,0,0,0,5,5
2020,51026,Montevarchi,AR,99,0,0,0,2,2,0,0,0,7,7
2020,51026,Montevarchi,AR,100 e più,0,0,0,0,0,0,0,0,3,3
2020,51027,Ortignano Raggiolo,AR,0,2,0,0,0,2,3,0,0,0,3
2020,51027,Ortignano Raggiolo,AR,1,2,0,0,0,2,3,0,0,0,3
2020,51027,Ortignano Raggiolo,AR,2,4,0,0,0,4,3,0,0,0,3
2020,51027,Ortignano Raggiolo,AR,3,6,0,0,0,6,0,0,0,0,0
2020,51027,Ortignano Raggiolo,AR,4,0,0,0,0,0,2,0,0,0,2
2020,51027,Ortignano Raggiolo,AR,5,3,0,0,0,3,9,0,0,0,9
2020,51027,Ortignano Raggiolo,AR,6,2,0,0,0,2,4,0,0,0,4
2020,51027,Ortignano Raggiolo,AR,7,4,0,0,0,4,5,0,0,0,5
2020,51027,Ortignano Raggiolo,AR,8,5,0,0,0,5,2,0,0,0,2
2020,51027,Ortignano Raggiolo,AR,9,5,0,0,0,5,2,0,0,0,2
2020,51027,Ortignano Raggiolo,AR,10,5,0,0,0,5,5,0,0,0,5
2020,51027,Ortignano Raggiolo,AR,11,6,0,0,0,6,3,0,0,0,3
2020,51027,Ortignano Raggiolo,AR,12,4,0,0,0,4,3,0,0,0,3
2020,51027,Ortignano Raggiolo,AR,13,1,0,0,0,1,2,0,0,0,2
2020,51027,Ortignano Raggiolo,AR,14,5,0,0,0,5,2,0,0,0,2
2020,51027,Ortignano Raggiolo,AR,15,2,0,0,0,2,5,0,0,0,5
2020,51027,Ortignano Raggiolo,AR,16,4,0,0,0,4,6,0,0,0,6
2020,51027,Ortignano Raggiolo,AR,17,4,0,0,0,4,6,0,0,0,6
2020,51027,Ortignano Raggiolo,AR,18,3,0,0,0,3,2,0,0,0,2
2020,51027,Ortignano Raggiolo,AR,19,3,0,0,0,3,2,0,0,0,2
2020,51027,Ortignano Raggiolo,AR,20,2,0,0,0,2,3,0,0,0,3
2020,51027,Ortignano Raggiolo,AR,21,5,0,0,0,5,1,0,0,0,1
2020,51027,Ortignano Raggiolo,AR,22,0,0,0,0,0,5,0,0,0,5
2020,51027,Ortignano Raggiolo,AR,23,4,0,0,0,4,2,0,0,0,2
2020,51027,Ortignano Raggiolo,AR,24,3,0,0,0,3,1,0,0,0,1
2020,51027,Ortignano Raggiolo,AR,25,1,0,0,0,1,0,0,0,0,0
2020,51027,Ortignano Raggiolo,AR,26,4,0,0,0,4,1,0,0,0,1
2020,51027,Ortignano Raggiolo,AR,27,0,0,0,0,0,0,0,0,0,0
2020,51027,Ortignano Raggiolo,AR,28,2,0,0,0,2,3,0,0,0,3
2020,51027,Ortignano Raggiolo,AR,29,4,0,0,0,4,4,1,0,0,5
2020,51027,Ortignano Raggiolo,AR,30,1,0,0,0,1,2,0,0,0,2
2020,51027,Ortignano Raggiolo,AR,31,4,1,0,0,5,3,1,0,0,4
2020,51027,Ortignano Raggiolo,AR,32,6,1,0,0,7,4,0,0,0,4
2020,51027,Ortignano Raggiolo,AR,33,2,0,0,0,2,2,0,0,0,2
2020,51027,Ortignano Raggiolo,AR,34,5,1,0,0,6,1,1,0,0,2
2020,51027,Ortignano Raggiolo,AR,35,3,0,1,0,4,4,5,0,0,9
2020,51027,Ortignano Raggiolo,AR,36,5,1,0,0,6,5,2,0,0,7
2020,51027,Ortignano Raggiolo,AR,37,1,0,0,0,1,4,3,0,0,7
2020,51027,Ortignano Raggiolo,AR,38,5,0,0,0,5,3,1,0,0,4
2020,51027,Ortignano Raggiolo,AR,39,4,4,0,0,8,2,3,2,0,7
2020,51027,Ortignano Raggiolo,AR,40,0,2,0,0,2,2,4,0,0,6
2020,51027,Ortignano Raggiolo,AR,41,2,4,0,0,6,0,1,0,0,1
2020,51027,Ortignano Raggiolo,AR,42,7,2,0,0,9,1,5,0,0,6
2020,51027,Ortignano Raggiolo,AR,43,2,1,0,0,3,1,4,0,1,6
2020,51027,Ortignano Raggiolo,AR,44,5,2,0,0,7,1,4,0,0,5
2020,51027,Ortignano Raggiolo,AR,45,4,2,2,0,8,2,6,1,0,9
2020,51027,Ortignano Raggiolo,AR,46,1,9,0,0,10,1,10,0,0,11
2020,51027,Ortignano Raggiolo,AR,47,3,4,0,0,7,7,6,0,0,13
2020,51027,Ortignano Raggiolo,AR,48,3,10,0,0,13,0,1,0,0,1
2020,51027,Ortignano Raggiolo,AR,49,2,3,2,0,7,1,3,1,0,5
2020,51027,Ortignano Raggiolo,AR,50,2,5,0,1,8,2,4,0,0,6
2020,51027,Ortignano Raggiolo,AR,51,2,7,0,0,9,1,8,0,0,9
2020,51027,Ortignano Raggiolo,AR,52,2,3,1,0,6,2,7,0,0,9
2020,51027,Ortignano Raggiolo,AR,53,0,6,2,0,8,1,4,0,0,5
2020,51027,Ortignano Raggiolo,AR,54,1,8,0,0,9,0,4,0,0,4
2020,51027,Ortignano Raggiolo,AR,55,1,2,0,0,3,2,6,0,0,8
2020,51027,Ortignano Raggiolo,AR,56,0,4,0,0,4,2,3,0,0,5
2020,51027,Ortignano Raggiolo,AR,57,3,5,0,0,8,0,6,0,0,6
2020,51027,Ortignano Raggiolo,AR,58,3,3,0,0,6,1,5,0,0,6
2020,51027,Ortignano Raggiolo,AR,59,0,5,0,0,5,0,6,1,1,8
2020,51027,Ortignano Raggiolo,AR,60,0,6,0,0,6,1,6,0,1,8
2020,51027,Ortignano Raggiolo,AR,61,1,5,1,0,7,0,8,1,0,9
2020,51027,Ortignano Raggiolo,AR,62,1,4,1,0,6,0,3,2,0,5
2020,51027,Ortignano Raggiolo,AR,63,2,5,0,0,7,0,9,0,1,10
2020,51027,Ortignano Raggiolo,AR,64,1,5,0,0,6,0,5,0,0,5
2020,51027,Ortignano Raggiolo,AR,65,1,4,1,0,6,1,2,0,3,6
2020,51027,Ortignano Raggiolo,AR,66,0,6,0,0,6,0,4,0,1,5
2020,51027,Ortignano Raggiolo,AR,67,1,3,1,0,5,0,7,0,0,7
2020,51027,Ortignano Raggiolo,AR,68,0,5,1,1,7,0,8,0,2,10
2020,51027,Ortignano Raggiolo,AR,69,0,4,0,0,4,2,3,0,2,7
2020,51027,Ortignano Raggiolo,AR,70,0,10,1,1,12,0,3,0,0,3
2020,51027,Ortignano Raggiolo,AR,71,1,3,0,0,4,0,2,2,0,4
2020,51027,Ortignano Raggiolo,AR,72,0,8,1,1,10,1,5,0,1,7
2020,51027,Ortignano Raggiolo,AR,73,1,9,0,1,11,0,7,0,2,9
2020,51027,Ortignano Raggiolo,AR,74,0,4,0,0,4,0,3,0,0,3
2020,51027,Ortignano Raggiolo,AR,75,0,5,0,0,5,2,1,0,0,3
2020,51027,Ortignano Raggiolo,AR,76,0,6,0,2,8,0,6,0,1,7
2020,51027,Ortignano Raggiolo,AR,77,0,5,0,0,5,2,3,1,1,7
2020,51027,Ortignano Raggiolo,AR,78,0,3,0,0,3,0,4,0,0,4
2020,51027,Ortignano Raggiolo,AR,79,2,1,0,0,3,1,1,0,0,2
2020,51027,Ortignano Raggiolo,AR,80,0,6,0,0,6,0,1,0,1,2
2020,51027,Ortignano Raggiolo,AR,81,0,2,0,1,3,1,2,0,2,5
2020,51027,Ortignano Raggiolo,AR,82,0,1,0,0,1,0,1,0,0,1
2020,51027,Ortignano Raggiolo,AR,83,0,2,0,0,2,0,0,0,1,1
2020,51027,Ortignano Raggiolo,AR,84,0,3,0,0,3,0,0,0,3,3
2020,51027,Ortignano Raggiolo,AR,85,0,0,0,0,0,0,1,0,2,3
2020,51027,Ortignano Raggiolo,AR,86,0,3,0,1,4,0,0,0,2,2
2020,51027,Ortignano Raggiolo,AR,87,0,0,0,0,0,1,0,0,1,2
2020,51027,Ortignano Raggiolo,AR,88,0,1,0,0,1,0,0,0,1,1
2020,51027,Ortignano Raggiolo,AR,89,0,1,0,0,1,0,0,0,4,4
2020,51027,Ortignano Raggiolo,AR,90,0,0,0,0,0,0,0,0,0,0
2020,51027,Ortignano Raggiolo,AR,91,0,0,0,0,0,0,0,0,0,0
2020,51027,Ortignano Raggiolo,AR,92,0,0,0,2,2,0,0,0,0,0
2020,51027,Ortignano Raggiolo,AR,93,0,0,0,1,1,0,0,0,3,3
2020,51027,Ortignano Raggiolo,AR,94,0,0,0,1,1,0,0,0,0,0
2020,51027,Ortignano Raggiolo,AR,95,0,0,0,0,0,0,0,0,0,0
2020,51027,Ortignano Raggiolo,AR,96,0,0,0,0,0,0,0,0,1,1
2020,51027,Ortignano Raggiolo,AR,97,0,0,0,1,1,0,0,0,0,0
2020,51027,Ortignano Raggiolo,AR,98,0,0,0,0,0,0,0,0,0,0
2020,51027,Ortignano Raggiolo,AR,99,0,0,0,0,0,0,0,0,0,0
2020,51027,Ortignano Raggiolo,AR,100 e più,0,0,0,0,0,0,0,0,0,0
2020,51030,Pieve Santo Stefano,AR,0,5,0,0,0,5,8,0,0,0,8
2020,51030,Pieve Santo Stefano,AR,1,10,0,0,0,10,7,0,0,0,7
2020,51030,Pieve Santo Stefano,AR,2,7,0,0,0,7,11,0,0,0,11
2020,51030,Pieve Santo Stefano,AR,3,4,0,0,0,4,10,0,0,0,10
2020,51030,Pieve Santo Stefano,AR,4,12,0,0,0,12,13,0,0,0,13
2020,51030,Pieve Santo Stefano,AR,5,11,0,0,0,11,8,0,0,0,8
2020,51030,Pieve Santo Stefano,AR,6,16,0,0,0,16,10,0,0,0,10
2020,51030,Pieve Santo Stefano,AR,7,14,0,0,0,14,9,0,0,0,9
2020,51030,Pieve Santo Stefano,AR,8,11,0,0,0,11,11,0,0,0,11
2020,51030,Pieve Santo Stefano,AR,9,12,0,0,0,12,11,0,0,0,11
2020,51030,Pieve Santo Stefano,AR,10,12,0,0,0,12,8,0,0,0,8
2020,51030,Pieve Santo Stefano,AR,11,16,0,0,0,16,15,0,0,0,15
2020,51030,Pieve Santo Stefano,AR,12,17,0,0,0,17,13,0,0,0,13
2020,51030,Pieve Santo Stefano,AR,13,9,0,0,0,9,15,0,0,0,15
2020,51030,Pieve Santo Stefano,AR,14,10,0,0,0,10,8,0,0,0,8
2020,51030,Pieve Santo Stefano,AR,15,13,0,0,0,13,19,0,0,0,19
2020,51030,Pieve Santo Stefano,AR,16,16,0,0,0,16,9,0,0,0,9
2020,51030,Pieve Santo Stefano,AR,17,9,0,0,0,9,14,0,0,0,14
2020,51030,Pieve Santo Stefano,AR,18,11,0,0,0,11,12,0,0,0,12
2020,51030,Pieve Santo Stefano,AR,19,16,0,0,0,16,15,0,0,0,15
2020,51030,Pieve Santo Stefano,AR,20,8,0,0,0,8,14,0,0,0,14
2020,51030,Pieve Santo Stefano,AR,21,14,0,0,0,14,15,0,0,0,15
2020,51030,Pieve Santo Stefano,AR,22,13,0,0,0,13,15,2,0,0,17
2020,51030,Pieve Santo Stefano,AR,23,10,0,0,0,10,13,1,0,0,14
2020,51030,Pieve Santo Stefano,AR,24,16,2,0,0,18,8,0,0,0,8
2020,51030,Pieve Santo Stefano,AR,25,20,0,1,0,21,10,2,0,0,12
2020,51030,Pieve Santo Stefano,AR,26,9,3,0,0,12,14,3,0,0,17
2020,51030,Pieve Santo Stefano,AR,27,13,1,0,0,14,9,3,0,0,12
2020,51030,Pieve Santo Stefano,AR,28,9,2,0,0,11,12,4,0,0,16
2020,51030,Pieve Santo Stefano,AR,29,14,1,0,0,15,6,8,0,0,14
2020,51030,Pieve Santo Stefano,AR,30,17,3,0,0,20,9,7,0,0,16
2020,51030,Pieve Santo Stefano,AR,31,23,6,0,0,29,12,5,0,0,17
2020,51030,Pieve Santo Stefano,AR,32,11,5,0,0,16,12,4,1,0,17
2020,51030,Pieve Santo Stefano,AR,33,10,5,0,0,15,5,0,1,0,6
2020,51030,Pieve Santo Stefano,AR,34,14,3,0,0,17,7,7,1,0,15
2020,51030,Pieve Santo Stefano,AR,35,15,5,0,0,20,9,9,0,0,18
2020,51030,Pieve Santo Stefano,AR,36,7,9,0,0,16,5,5,1,0,11
2020,51030,Pieve Santo Stefano,AR,37,6,4,2,0,12,5,5,0,0,10
2020,51030,Pieve Santo Stefano,AR,38,7,8,0,0,15,3,7,1,0,11
2020,51030,Pieve Santo Stefano,AR,39,13,7,0,0,20,14,15,0,0,29
2020,51030,Pieve Santo Stefano,AR,40,18,4,0,1,23,8,6,1,0,15
2020,51030,Pieve Santo Stefano,AR,41,5,10,0,0,15,6,13,0,0,19
2020,51030,Pieve Santo Stefano,AR,42,11,7,1,0,19,3,9,0,0,12
2020,51030,Pieve Santo Stefano,AR,43,4,14,0,0,18,10,10,0,0,20
2020,51030,Pieve Santo Stefano,AR,44,10,9,0,0,19,3,20,0,0,23
2020,51030,Pieve Santo Stefano,AR,45,7,8,1,0,16,5,12,1,0,18
2020,51030,Pieve Santo Stefano,AR,46,7,13,0,0,20,4,12,3,0,19
2020,51030,Pieve Santo Stefano,AR,47,2,9,1,0,12,2,16,1,0,19
2020,51030,Pieve Santo Stefano,AR,48,7,8,0,1,16,3,16,2,0,21
2020,51030,Pieve Santo Stefano,AR,49,8,12,0,0,20,3,11,3,0,17
2020,51030,Pieve Santo Stefano,AR,50,4,14,7,0,25,8,16,1,0,25
2020,51030,Pieve Santo Stefano,AR,51,2,14,1,0,17,4,17,3,0,24
2020,51030,Pieve Santo Stefano,AR,52,6,14,0,0,20,3,20,0,1,24
2020,51030,Pieve Santo Stefano,AR,53,5,17,0,0,22,2,18,4,2,26
2020,51030,Pieve Santo Stefano,AR,54,7,15,5,1,28,4,14,3,0,21
2020,51030,Pieve Santo Stefano,AR,55,3,17,0,0,20,1,14,7,2,24
2020,51030,Pieve Santo Stefano,AR,56,4,21,4,0,29,3,23,1,0,27
2020,51030,Pieve Santo Stefano,AR,57,3,15,1,0,19,5,26,3,1,35
2020,51030,Pieve Santo Stefano,AR,58,2,20,2,1,25,0,20,7,1,28
2020,51030,Pieve Santo Stefano,AR,59,1,23,1,1,26,7,17,1,0,25
2020,51030,Pieve Santo Stefano,AR,60,3,21,3,0,27,1,20,2,4,27
2020,51030,Pieve Santo Stefano,AR,61,1,15,1,0,17,2,26,0,3,31
2020,51030,Pieve Santo Stefano,AR,62,3,21,4,0,28,0,25,1,1,27
2020,51030,Pieve Santo Stefano,AR,63,2,24,1,0,27,1,19,0,2,22
2020,51030,Pieve Santo Stefano,AR,64,5,21,1,0,27,1,22,1,0,24
2020,51030,Pieve Santo Stefano,AR,65,1,14,0,0,15,1,16,0,2,19
2020,51030,Pieve Santo Stefano,AR,66,3,18,1,0,22,0,17,2,2,21
2020,51030,Pieve Santo Stefano,AR,67,1,23,2,0,26,0,16,1,2,19
2020,51030,Pieve Santo Stefano,AR,68,2,14,1,0,17,1,14,2,3,20
2020,51030,Pieve Santo Stefano,AR,69,4,17,2,0,23,1,17,1,6,25
2020,51030,Pieve Santo Stefano,AR,70,3,19,0,0,22,0,19,3,5,27
2020,51030,Pieve Santo Stefano,AR,71,2,20,1,0,23,0,16,0,3,19
2020,51030,Pieve Santo Stefano,AR,72,2,26,1,0,29,3,19,0,0,22
2020,51030,Pieve Santo Stefano,AR,73,3,15,1,1,20,1,12,0,4,17
2020,51030,Pieve Santo Stefano,AR,74,3,18,0,3,24,1,7,1,7,16
2020,51030,Pieve Santo Stefano,AR,75,2,13,0,1,16,0,9,0,4,13
2020,51030,Pieve Santo Stefano,AR,76,1,10,0,1,12,1,8,0,3,12
2020,51030,Pieve Santo Stefano,AR,77,2,6,0,1,9,1,6,0,3,10
2020,51030,Pieve Santo Stefano,AR,78,5,9,0,0,14,0,8,0,6,14
2020,51030,Pieve Santo Stefano,AR,79,0,10,0,0,10,0,4,0,7,11
2020,51030,Pieve Santo Stefano,AR,80,1,10,0,0,11,1,8,0,12,21
2020,51030,Pieve Santo Stefano,AR,81,4,10,0,1,15,0,8,0,16,24
2020,51030,Pieve Santo Stefano,AR,82,1,11,0,3,15,0,9,0,10,19
2020,51030,Pieve Santo Stefano,AR,83,3,4,0,0,7,1,5,0,10,16
2020,51030,Pieve Santo Stefano,AR,84,0,6,0,2,8,0,4,0,8,12
2020,51030,Pieve Santo Stefano,AR,85,2,10,0,3,15,1,3,0,7,11
2020,51030,Pieve Santo Stefano,AR,86,1,3,0,1,5,0,2,0,10,12
2020,51030,Pieve Santo Stefano,AR,87,1,7,0,2,10,2,2,0,12,16
2020,51030,Pieve Santo Stefano,AR,88,0,2,0,1,3,0,2,0,11,13
2020,51030,Pieve Santo Stefano,AR,89,1,5,0,2,8,0,1,0,8,9
2020,51030,Pieve Santo Stefano,AR,90,0,4,0,2,6,1,1,0,8,10
2020,51030,Pieve Santo Stefano,AR,91,0,1,0,1,2,1,0,0,6,7
2020,51030,Pieve Santo Stefano,AR,92,0,1,0,1,2,0,0,0,4,4
2020,51030,Pieve Santo Stefano,AR,93,0,0,0,1,1,0,0,0,4,4
2020,51030,Pieve Santo Stefano,AR,94,0,0,0,1,1,0,0,0,1,1
2020,51030,Pieve Santo Stefano,AR,95,0,0,1,3,4,0,0,0,1,1
2020,51030,Pieve Santo Stefano,AR,96,0,1,0,0,1,0,0,0,1,1
2020,51030,Pieve Santo Stefano,AR,97,0,0,0,1,1,0,0,0,0,0
2020,51030,Pieve Santo Stefano,AR,98,0,0,0,0,0,0,0,0,1,1
2020,51030,Pieve Santo Stefano,AR,99,0,0,0,0,0,0,0,0,1,1
2020,51030,Pieve Santo Stefano,AR,100 e più,0,0,0,0,0,0,0,0,0,0
2020,51031,Poppi,AR,0,16,0,0,0,16,10,0,0,0,10
2020,51031,Poppi,AR,1,16,0,0,0,16,22,0,0,0,22
2020,51031,Poppi,AR,2,20,0,0,0,20,12,0,0,0,12
2020,51031,Poppi,AR,3,26,0,0,0,26,13,0,0,0,13
2020,51031,Poppi,AR,4,21,0,0,0,21,22,0,0,0,22
2020,51031,Poppi,AR,5,24,0,0,0,24,14,0,0,0,14
2020,51031,Poppi,AR,6,34,0,0,0,34,30,0,0,0,30
2020,51031,Poppi,AR,7,30,0,0,0,30,23,0,0,0,23
2020,51031,Poppi,AR,8,29,0,0,0,29,27,0,0,0,27
2020,51031,Poppi,AR,9,31,0,0,0,31,24,0,0,0,24
2020,51031,Poppi,AR,10,32,0,0,0,32,27,0,0,0,27
2020,51031,Poppi,AR,11,33,0,0,0,33,27,0,0,0,27
2020,51031,Poppi,AR,12,32,0,0,0,32,21,0,0,0,21
2020,51031,Poppi,AR,13,29,0,0,0,29,15,0,0,0,15
2020,51031,Poppi,AR,14,25,0,0,0,25,25,0,0,0,25
2020,51031,Poppi,AR,15,25,0,0,0,25,31,0,0,0,31
2020,51031,Poppi,AR,16,24,0,0,0,24,24,0,0,0,24
2020,51031,Poppi,AR,17,28,0,0,0,28,26,0,0,0,26
2020,51031,Poppi,AR,18,33,0,0,0,33,24,0,0,0,24
2020,51031,Poppi,AR,19,21,0,0,0,21,32,0,0,0,32
2020,51031,Poppi,AR,20,33,0,0,0,33,24,0,0,0,24
2020,51031,Poppi,AR,21,21,0,0,0,21,24,1,0,0,25
2020,51031,Poppi,AR,22,26,0,0,0,26,32,0,0,0,32
2020,51031,Poppi,AR,23,26,0,0,0,26,26,2,0,0,28
2020,51031,Poppi,AR,24,22,2,0,0,24,19,4,0,0,23
2020,51031,Poppi,AR,25,25,2,0,0,27,22,0,0,0,22
2020,51031,Poppi,AR,26,31,1,0,0,32,35,4,0,0,39
2020,51031,Poppi,AR,27,26,2,0,0,28,20,4,0,0,24
2020,51031,Poppi,AR,28,25,1,0,0,26,24,10,0,0,34
2020,51031,Poppi,AR,29,30,2,0,0,32,17,5,0,0,22
2020,51031,Poppi,AR,30,30,5,0,0,35,16,9,0,0,25
2020,51031,Poppi,AR,31,21,7,3,0,31,19,6,0,0,25
2020,51031,Poppi,AR,32,13,7,0,0,20,12,5,1,0,18
2020,51031,Poppi,AR,33,22,8,0,0,30,18,20,0,0,38
2020,51031,Poppi,AR,34,28,7,1,0,36,21,12,0,0,33
2020,51031,Poppi,AR,35,16,12,0,0,28,13,18,0,0,31
2020,51031,Poppi,AR,36,23,15,0,0,38,8,13,1,0,22
2020,51031,Poppi,AR,37,19,15,0,0,34,9,14,0,1,24
2020,51031,Poppi,AR,38,12,15,2,0,29,8,18,0,0,26
2020,51031,Poppi,AR,39,20,14,0,0,34,10,26,1,1,38
2020,51031,Poppi,AR,40,16,20,0,0,36,6,27,3,0,36
2020,51031,Poppi,AR,41,11,29,2,0,42,10,29,4,0,43
2020,51031,Poppi,AR,42,17,30,0,0,47,8,30,2,0,40
2020,51031,Poppi,AR,43,12,30,5,0,47,11,32,3,0,46
2020,51031,Poppi,AR,44,9,26,2,0,37,9,40,1,0,50
2020,51031,Poppi,AR,45,9,23,0,1,33,10,32,7,0,49
2020,51031,Poppi,AR,46,14,35,4,0,53,11,40,3,0,54
2020,51031,Poppi,AR,47,14,35,6,1,56,4,29,5,1,39
2020,51031,Poppi,AR,48,20,43,4,0,67,5,33,5,3,46
2020,51031,Poppi,AR,49,8,44,3,0,55,5,30,4,2,41
2020,51031,Poppi,AR,50,16,30,5,1,52,10,31,0,0,41
2020,51031,Poppi,AR,51,13,34,3,0,50,8,43,5,1,57
2020,51031,Poppi,AR,52,11,32,3,0,46,10,34,7,3,54
2020,51031,Poppi,AR,53,10,26,2,1,39,3,37,2,0,42
2020,51031,Poppi,AR,54,15,37,2,0,54,5,33,3,1,42
2020,51031,Poppi,AR,55,9,32,2,1,44,4,35,2,2,43
2020,51031,Poppi,AR,56,4,51,2,0,57,4,32,3,1,40
2020,51031,Poppi,AR,57,8,29,3,0,40,4,43,6,2,55
2020,51031,Poppi,AR,58,9,28,1,0,38,2,41,5,3,51
2020,51031,Poppi,AR,59,7,34,2,0,43,4,40,4,5,53
2020,51031,Poppi,AR,60,3,35,1,3,42,2,32,0,3,37
2020,51031,Poppi,AR,61,4,29,3,0,36,1,30,4,5,40
2020,51031,Poppi,AR,62,4,28,1,1,34,1,23,1,0,25
2020,51031,Poppi,AR,63,6,37,2,1,46,1,39,2,6,48
2020,51031,Poppi,AR,64,10,32,2,2,46,2,26,1,4,33
2020,51031,Poppi,AR,65,4,23,0,1,28,1,31,1,10,43
2020,51031,Poppi,AR,66,1,37,2,0,40,3,27,2,5,37
2020,51031,Poppi,AR,67,5,26,0,0,31,4,32,3,9,48
2020,51031,Poppi,AR,68,9,20,4,0,33,4,24,3,2,33
2020,51031,Poppi,AR,69,4,35,4,2,45,2,23,2,7,34
2020,51031,Poppi,AR,70,6,27,1,3,37,1,29,0,3,33
2020,51031,Poppi,AR,71,3,33,1,2,39,2,38,1,8,49
2020,51031,Poppi,AR,72,5,25,4,4,38,2,39,1,6,48
2020,51031,Poppi,AR,73,2,48,1,6,57,3,30,0,11,44
2020,51031,Poppi,AR,74,2,25,2,2,31,1,13,0,5,19
2020,51031,Poppi,AR,75,2,21,0,1,24,0,17,3,7,27
2020,51031,Poppi,AR,76,3,21,0,2,26,1,18,0,6,25
2020,51031,Poppi,AR,77,5,19,0,1,25,1,25,1,11,38
2020,51031,Poppi,AR,78,1,23,0,2,26,3,17,1,5,26
2020,51031,Poppi,AR,79,5,24,1,2,32,1,16,1,10,28
2020,51031,Poppi,AR,80,3,28,2,2,35,4,11,1,11,27
2020,51031,Poppi,AR,81,1,18,0,5,24,0,12,0,14,26
2020,51031,Poppi,AR,82,4,23,0,3,30,3,6,0,16,25
2020,51031,Poppi,AR,83,1,6,1,3,11,2,11,1,17,31
2020,51031,Poppi,AR,84,3,9,0,2,14,2,10,1,20,33
2020,51031,Poppi,AR,85,2,11,0,5,18,0,6,0,18,24
2020,51031,Poppi,AR,86,1,9,0,4,14,2,3,0,20,25
2020,51031,Poppi,AR,87,3,5,0,6,14,1,4,0,15,20
2020,51031,Poppi,AR,88,0,6,1,3,10,3,4,0,16,23
2020,51031,Poppi,AR,89,2,9,0,2,13,0,2,1,17,20
2020,51031,Poppi,AR,90,1,4,0,3,8,1,2,0,15,18
2020,51031,Poppi,AR,91,0,6,0,3,9,0,1,0,7,8
2020,51031,Poppi,AR,92,2,2,0,2,6,0,0,0,7,7
2020,51031,Poppi,AR,93,2,2,0,2,6,0,1,0,10,11
2020,51031,Poppi,AR,94,0,0,0,0,0,0,0,0,10,10
2020,51031,Poppi,AR,95,2,0,0,1,3,0,0,0,7,7
2020,51031,Poppi,AR,96,0,0,0,1,1,1,0,0,3,4
2020,51031,Poppi,AR,97,0,0,0,2,2,0,0,0,2,2
2020,51031,Poppi,AR,98,0,0,0,0,0,0,2,0,2,4
2020,51031,Poppi,AR,99,0,1,0,0,1,0,0,0,1,1
2020,51031,Poppi,AR,100 e più,0,0,0,0,0,0,0,0,2,2
2020,51033,San Giovanni Valdarno,AR,0,56,0,0,0,56,43,0,0,0,43
2020,51033,San Giovanni Valdarno,AR,1,61,0,0,0,61,49,0,0,0,49
2020,51033,San Giovanni Valdarno,AR,2,50,0,0,0,50,51,0,0,0,51
2020,51033,San Giovanni Valdarno,AR,3,59,0,0,0,59,63,0,0,0,63
2020,51033,San Giovanni Valdarno,AR,4,66,0,0,0,66,63,0,0,0,63
2020,51033,San Giovanni Valdarno,AR,5,65,0,0,0,65,64,0,0,0,64
2020,51033,San Giovanni Valdarno,AR,6,63,0,0,0,63,61,0,0,0,61
2020,51033,San Giovanni Valdarno,AR,7,64,0,0,0,64,59,0,0,0,59
2020,51033,San Giovanni Valdarno,AR,8,66,0,0,0,66,70,0,0,0,70
2020,51033,San Giovanni Valdarno,AR,9,74,0,0,0,74,67,0,0,0,67
2020,51033,San Giovanni Valdarno,AR,10,82,0,0,0,82,69,0,0,0,69
2020,51033,San Giovanni Valdarno,AR,11,72,0,0,0,72,95,0,0,0,95
2020,51033,San Giovanni Valdarno,AR,12,75,0,0,0,75,93,0,0,0,93
2020,51033,San Giovanni Valdarno,AR,13,75,0,0,0,75,67,0,0,0,67
2020,51033,San Giovanni Valdarno,AR,14,69,0,0,0,69,69,0,0,0,69
2020,51033,San Giovanni Valdarno,AR,15,81,0,0,0,81,79,0,0,0,79
2020,51033,San Giovanni Valdarno,AR,16,84,0,0,0,84,67,0,0,0,67
2020,51033,San Giovanni Valdarno,AR,17,84,0,0,0,84,58,0,1,0,59
2020,51033,San Giovanni Valdarno,AR,18,83,0,0,0,83,86,0,0,0,86
2020,51033,San Giovanni Valdarno,AR,19,86,0,0,0,86,81,0,0,0,81
2020,51033,San Giovanni Valdarno,AR,20,94,0,0,0,94,83,2,0,0,85
2020,51033,San Giovanni Valdarno,AR,21,81,0,0,0,81,87,1,0,0,88
2020,51033,San Giovanni Valdarno,AR,22,107,1,0,0,108,78,1,0,0,79
2020,51033,San Giovanni Valdarno,AR,23,93,0,0,0,93,87,4,0,0,91
2020,51033,San Giovanni Valdarno,AR,24,80,4,0,0,84,70,4,0,0,74
2020,51033,San Giovanni Valdarno,AR,25,83,4,0,0,87,56,9,0,0,65
2020,51033,San Giovanni Valdarno,AR,26,82,1,0,0,83,72,12,0,0,84
2020,51033,San Giovanni Valdarno,AR,27,84,5,0,0,89,65,9,0,0,74
2020,51033,San Giovanni Valdarno,AR,28,75,4,0,0,79,80,12,0,0,92
2020,51033,San Giovanni Valdarno,AR,29,78,6,0,0,84,63,18,2,0,83
2020,51033,San Giovanni Valdarno,AR,30,63,15,0,0,78,49,35,3,1,88
2020,51033,San Giovanni Valdarno,AR,31,38,19,0,0,57,46,25,4,0,75
2020,51033,San Giovanni Valdarno,AR,32,74,23,0,0,97,46,31,4,0,81
2020,51033,San Giovanni Valdarno,AR,33,53,34,0,0,87,34,44,1,0,79
2020,51033,San Giovanni Valdarno,AR,34,50,31,0,0,81,32,34,3,1,70
2020,51033,San Giovanni Valdarno,AR,35,46,22,2,0,70,45,45,1,0,91
2020,51033,San Giovanni Valdarno,AR,36,40,29,1,0,70,39,50,1,1,91
2020,51033,San Giovanni Valdarno,AR,37,47,48,1,0,96,36,53,3,0,92
2020,51033,San Giovanni Valdarno,AR,38,41,39,2,0,82,42,45,3,0,90
2020,51033,San Giovanni Valdarno,AR,39,36,34,4,0,74,34,57,3,1,95
2020,51033,San Giovanni Valdarno,AR,40,22,62,1,0,85,46,55,1,1,103
2020,51033,San Giovanni Valdarno,AR,41,40,46,2,0,88,20,57,2,0,79
2020,51033,San Giovanni Valdarno,AR,42,36,46,7,0,89,41,57,2,0,100
2020,51033,San Giovanni Valdarno,AR,43,41,57,1,0,99,29,89,6,1,125
2020,51033,San Giovanni Valdarno,AR,44,30,63,5,1,99,42,71,7,0,120
2020,51033,San Giovanni Valdarno,AR,45,40,63,6,1,110,41,74,21,1,137
2020,51033,San Giovanni Valdarno,AR,46,43,73,6,0,122,35,86,16,1,138
2020,51033,San Giovanni Valdarno,AR,47,29,78,5,0,112,30,90,7,1,128
2020,51033,San Giovanni Valdarno,AR,48,39,71,12,0,122,25,85,11,3,124
2020,51033,San Giovanni Valdarno,AR,49,39,107,6,0,152,33,106,18,1,158
2020,51033,San Giovanni Valdarno,AR,50,30,88,17,2,137,24,105,18,0,147
2020,51033,San Giovanni Valdarno,AR,51,16,97,6,0,119,28,105,12,2,147
2020,51033,San Giovanni Valdarno,AR,52,23,82,6,1,112,24,103,15,3,145
2020,51033,San Giovanni Valdarno,AR,53,29,91,12,0,132,14,100,18,3,135
2020,51033,San Giovanni Valdarno,AR,54,21,89,21,2,133,16,95,15,2,128
2020,51033,San Giovanni Valdarno,AR,55,28,103,8,0,139,17,107,26,9,159
2020,51033,San Giovanni Valdarno,AR,56,17,109,11,1,138,18,105,21,5,149
2020,51033,San Giovanni Valdarno,AR,57,20,89,12,0,121,18,94,19,7,138
2020,51033,San Giovanni Valdarno,AR,58,19,97,11,3,130,14,108,11,3,136
2020,51033,San Giovanni Valdarno,AR,59,15,106,11,1,133,12,95,17,7,131
2020,51033,San Giovanni Valdarno,AR,60,14,76,8,5,103,15,84,10,5,114
2020,51033,San Giovanni Valdarno,AR,61,10,77,8,4,99,12,90,9,9,120
2020,51033,San Giovanni Valdarno,AR,62,10,82,8,3,103,9,87,10,6,112
2020,51033,San Giovanni Valdarno,AR,63,13,71,5,1,90,4,92,4,5,105
2020,51033,San Giovanni Valdarno,AR,64,8,63,6,2,79,8,62,5,8,83
2020,51033,San Giovanni Valdarno,AR,65,3,74,2,2,81,7,82,9,10,108
2020,51033,San Giovanni Valdarno,AR,66,3,77,3,1,84,4,81,15,17,117
2020,51033,San Giovanni Valdarno,AR,67,3,80,2,5,90,6,63,10,15,94
2020,51033,San Giovanni Valdarno,AR,68,7,71,5,1,84,6,68,6,12,92
2020,51033,San Giovanni Valdarno,AR,69,10,83,3,5,101,8,81,5,16,110
2020,51033,San Giovanni Valdarno,AR,70,5,83,7,4,99,6,73,4,20,103
2020,51033,San Giovanni Valdarno,AR,71,5,73,1,4,83,5,76,4,20,105
2020,51033,San Giovanni Valdarno,AR,72,7,86,5,4,102,4,83,7,29,123
2020,51033,San Giovanni Valdarno,AR,73,3,91,3,7,104,4,85,6,28,123
2020,51033,San Giovanni Valdarno,AR,74,6,91,0,4,101,7,86,1,33,127
2020,51033,San Giovanni Valdarno,AR,75,7,87,2,8,104,7,52,1,28,88
2020,51033,San Giovanni Valdarno,AR,76,1,61,3,12,77,4,64,1,34,103
2020,51033,San Giovanni Valdarno,AR,77,5,64,3,7,79,4,67,3,41,115
2020,51033,San Giovanni Valdarno,AR,78,5,61,1,6,73,6,52,2,28,88
2020,51033,San Giovanni Valdarno,AR,79,3,50,2,8,63,5,50,3,40,98
2020,51033,San Giovanni Valdarno,AR,80,6,61,5,14,86,4,56,1,42,103
2020,51033,San Giovanni Valdarno,AR,81,4,52,4,13,73,2,51,5,47,105
2020,51033,San Giovanni Valdarno,AR,82,3,58,1,6,68,1,34,1,50,86
2020,51033,San Giovanni Valdarno,AR,83,5,54,0,7,66,8,36,2,38,84
2020,51033,San Giovanni Valdarno,AR,84,3,39,1,7,50,1,32,1,56,90
2020,51033,San Giovanni Valdarno,AR,85,3,34,1,13,51,2,20,4,52,78
2020,51033,San Giovanni Valdarno,AR,86,2,31,0,9,42,4,24,2,41,71
2020,51033,San Giovanni Valdarno,AR,87,1,29,0,9,39,2,17,1,42,62
2020,51033,San Giovanni Valdarno,AR,88,3,14,1,8,26,3,10,0,50,63
2020,51033,San Giovanni Valdarno,AR,89,0,17,0,9,26,0,8,1,31,40
2020,51033,San Giovanni Valdarno,AR,90,0,13,0,8,21,2,8,1,30,41
2020,51033,San Giovanni Valdarno,AR,91,0,10,0,11,21,1,6,0,27,34
2020,51033,San Giovanni Valdarno,AR,92,0,8,0,5,13,1,4,0,18,23
2020,51033,San Giovanni Valdarno,AR,93,0,5,1,4,10,0,3,0,23,26
2020,51033,San Giovanni Valdarno,AR,94,0,4,0,4,8,1,4,0,16,21
2020,51033,San Giovanni Valdarno,AR,95,0,1,0,6,7,1,1,0,18,20
2020,51033,San Giovanni Valdarno,AR,96,0,3,0,3,6,0,1,0,8,9
2020,51033,San Giovanni Valdarno,AR,97,1,1,0,2,4,0,0,0,7,7
2020,51033,San Giovanni Valdarno,AR,98,0,1,0,1,2,0,3,0,3,6
2020,51033,San Giovanni Valdarno,AR,99,0,1,0,0,1,0,1,0,5,6
2020,51033,San Giovanni Valdarno,AR,100 e più,0,0,0,1,1,0,1,0,3,4
2020,51034,Sansepolcro,AR,0,51,0,0,0,51,46,0,0,0,46
2020,51034,Sansepolcro,AR,1,52,0,0,0,52,54,0,0,0,54
2020,51034,Sansepolcro,AR,2,53,0,0,0,53,52,0,0,0,52
2020,51034,Sansepolcro,AR,3,67,0,0,0,67,52,0,0,0,52
2020,51034,Sansepolcro,AR,4,71,0,0,0,71,50,0,0,0,50
2020,51034,Sansepolcro,AR,5,48,0,0,0,48,50,0,0,0,50
2020,51034,Sansepolcro,AR,6,80,0,0,0,80,53,0,0,0,53
2020,51034,Sansepolcro,AR,7,60,0,0,0,60,43,0,0,0,43
2020,51034,Sansepolcro,AR,8,52,0,0,0,52,58,0,0,0,58
2020,51034,Sansepolcro,AR,9,54,0,0,0,54,58,0,0,0,58
2020,51034,Sansepolcro,AR,10,74,0,0,0,74,64,0,0,0,64
2020,51034,Sansepolcro,AR,11,67,0,0,0,67,63,0,0,0,63
2020,51034,Sansepolcro,AR,12,83,0,0,0,83,56,0,0,0,56
2020,51034,Sansepolcro,AR,13,89,0,0,0,89,55,0,0,0,55
2020,51034,Sansepolcro,AR,14,67,0,0,0,67,72,0,0,0,72
2020,51034,Sansepolcro,AR,15,60,0,0,0,60,65,0,0,0,65
2020,51034,Sansepolcro,AR,16,86,0,0,0,86,56,0,0,0,56
2020,51034,Sansepolcro,AR,17,62,0,0,0,62,68,0,0,0,68
2020,51034,Sansepolcro,AR,18,59,0,0,0,59,78,0,0,0,78
2020,51034,Sansepolcro,AR,19,48,0,0,0,48,69,1,0,0,70
2020,51034,Sansepolcro,AR,20,57,1,0,0,58,62,3,0,0,65
2020,51034,Sansepolcro,AR,21,85,2,0,0,87,61,4,0,0,65
2020,51034,Sansepolcro,AR,22,88,1,0,0,89,65,2,0,0,67
2020,51034,Sansepolcro,AR,23,79,2,0,0,81,61,10,0,0,71
2020,51034,Sansepolcro,AR,24,68,4,0,0,72,66,6,0,0,72
2020,51034,Sansepolcro,AR,25,82,2,0,0,84,51,8,0,0,59
2020,51034,Sansepolcro,AR,26,72,5,0,0,77,62,12,1,0,75
2020,51034,Sansepolcro,AR,27,69,4,0,0,73,69,13,0,0,82
2020,51034,Sansepolcro,AR,28,71,3,0,0,74,45,15,1,0,61
2020,51034,Sansepolcro,AR,29,70,6,0,0,76,40,14,0,0,54
2020,51034,Sansepolcro,AR,30,87,9,0,0,96,54,23,1,0,78
2020,51034,Sansepolcro,AR,31,80,16,1,0,97,57,29,0,0,86
2020,51034,Sansepolcro,AR,32,75,24,0,0,99,53,28,1,0,82
2020,51034,Sansepolcro,AR,33,71,18,1,0,90,46,35,0,0,81
2020,51034,Sansepolcro,AR,34,62,27,0,0,89,43,36,2,0,81
2020,51034,Sansepolcro,AR,35,62,27,1,0,90,52,51,1,0,104
2020,51034,Sansepolcro,AR,36,42,28,1,0,71,40,36,5,0,81
2020,51034,Sansepolcro,AR,37,54,36,0,0,90,38,43,2,1,84
2020,51034,Sansepolcro,AR,38,41,29,4,0,74,25,46,1,0,72
2020,51034,Sansepolcro,AR,39,54,49,1,0,104,26,52,2,0,80
2020,51034,Sansepolcro,AR,40,44,42,3,0,89,32,54,6,0,92
2020,51034,Sansepolcro,AR,41,43,49,1,0,93,37,47,3,0,87
2020,51034,Sansepolcro,AR,42,49,51,4,0,104,19,53,4,1,77
2020,51034,Sansepolcro,AR,43,45,59,3,0,107,24,57,8,0,89
2020,51034,Sansepolcro,AR,44,36,58,6,0,100,25,64,10,1,100
2020,51034,Sansepolcro,AR,45,27,44,5,0,76,32,74,9,0,115
2020,51034,Sansepolcro,AR,46,34,76,3,0,113,20,68,12,4,104
2020,51034,Sansepolcro,AR,47,32,59,6,0,97,18,63,10,3,94
2020,51034,Sansepolcro,AR,48,29,81,7,1,118,25,69,8,3,105
2020,51034,Sansepolcro,AR,49,29,67,4,0,100,17,64,10,3,94
2020,51034,Sansepolcro,AR,50,26,74,5,0,105,16,85,10,3,114
2020,51034,Sansepolcro,AR,51,19,66,6,0,91,21,97,11,3,132
2020,51034,Sansepolcro,AR,52,23,87,5,0,115,20,98,14,3,135
2020,51034,Sansepolcro,AR,53,26,104,9,0,139,19,96,8,4,127
2020,51034,Sansepolcro,AR,54,23,80,6,0,109,19,102,16,6,143
2020,51034,Sansepolcro,AR,55,15,70,8,0,93,19,106,17,2,144
2020,51034,Sansepolcro,AR,56,21,84,16,2,123,23,87,18,6,134
2020,51034,Sansepolcro,AR,57,18,80,14,1,113,20,116,12,3,151
2020,51034,Sansepolcro,AR,58,16,68,8,2,94,12,89,11,5,117
2020,51034,Sansepolcro,AR,59,9,85,6,3,103,9,80,7,8,104
2020,51034,Sansepolcro,AR,60,10,97,5,3,115,11,90,12,6,119
2020,51034,Sansepolcro,AR,61,15,84,12,1,112,11,94,9,6,120
2020,51034,Sansepolcro,AR,62,14,89,8,0,111,14,95,8,18,135
2020,51034,Sansepolcro,AR,63,7,97,12,2,118,3,92,9,6,110
2020,51034,Sansepolcro,AR,64,11,78,7,0,96,8,90,13,13,124
2020,51034,Sansepolcro,AR,65,11,81,5,1,98,6,78,10,8,102
2020,51034,Sansepolcro,AR,66,3,88,7,2,100,13,81,4,15,113
2020,51034,Sansepolcro,AR,67,12,70,3,3,88,7,77,5,13,102
2020,51034,Sansepolcro,AR,68,10,100,3,1,114,5,62,4,18,89
2020,51034,Sansepolcro,AR,69,7,76,5,3,91,10,100,7,8,125
2020,51034,Sansepolcro,AR,70,6,85,6,6,103,6,54,4,20,84
2020,51034,Sansepolcro,AR,71,7,91,4,8,110,3,60,6,26,95
2020,51034,Sansepolcro,AR,72,10,94,0,10,114,8,85,3,25,121
2020,51034,Sansepolcro,AR,73,4,76,2,3,85,2,79,1,26,108
2020,51034,Sansepolcro,AR,74,3,76,1,8,88,7,70,5,36,118
2020,51034,Sansepolcro,AR,75,2,55,4,9,70,1,61,1,19,82
2020,51034,Sansepolcro,AR,76,3,65,2,4,74,4,46,4,27,81
2020,51034,Sansepolcro,AR,77,0,37,0,8,45,7,44,2,25,78
2020,51034,Sansepolcro,AR,78,3,47,2,10,62,4,42,3,30,79
2020,51034,Sansepolcro,AR,79,4,58,3,4,69,1,44,3,29,77
2020,51034,Sansepolcro,AR,80,3,53,2,10,68,6,44,2,52,104
2020,51034,Sansepolcro,AR,81,7,51,0,7,65,1,27,4,46,78
2020,51034,Sansepolcro,AR,82,8,54,1,15,78,3,44,3,47,97
2020,51034,Sansepolcro,AR,83,3,32,1,9,45,5,29,1,51,86
2020,51034,Sansepolcro,AR,84,2,32,0,6,40,3,24,0,48,75
2020,51034,Sansepolcro,AR,85,2,40,2,14,58,5,15,1,47,68
2020,51034,Sansepolcro,AR,86,5,29,0,11,45,0,13,1,56,70
2020,51034,Sansepolcro,AR,87,8,30,0,10,48,3,9,1,49,62
2020,51034,Sansepolcro,AR,88,4,22,0,5,31,1,8,0,44,53
2020,51034,Sansepolcro,AR,89,1,11,0,11,23,4,10,1,45,60
2020,51034,Sansepolcro,AR,90,1,6,0,10,17,3,8,1,39,51
2020,51034,Sansepolcro,AR,91,2,5,0,7,14,0,3,0,35,38
2020,51034,Sansepolcro,AR,92,1,13,0,6,20,1,1,0,23,25
2020,51034,Sansepolcro,AR,93,0,9,0,7,16,1,0,0,29,30
2020,51034,Sansepolcro,AR,94,0,4,0,4,8,1,2,0,22,25
2020,51034,Sansepolcro,AR,95,1,4,0,2,7,0,0,0,13,13
2020,51034,Sansepolcro,AR,96,0,1,0,1,2,0,0,0,9,9
2020,51034,Sansepolcro,AR,97,0,0,0,3,3,0,0,0,13,13
2020,51034,Sansepolcro,AR,98,0,0,0,1,1,0,0,0,5,5
2020,51034,Sansepolcro,AR,99,0,0,0,2,2,1,0,0,4,5
2020,51034,Sansepolcro,AR,100 e più,0,0,0,0,0,0,0,0,4,4
2020,51035,Sestino,AR,0,5,0,0,0,5,1,0,0,0,1
2020,51035,Sestino,AR,1,4,0,0,0,4,0,0,0,0,0
2020,51035,Sestino,AR,2,3,0,0,0,3,7,0,0,0,7
2020,51035,Sestino,AR,3,3,0,0,0,3,7,0,0,0,7
2020,51035,Sestino,AR,4,8,0,0,0,8,2,0,0,0,2
2020,51035,Sestino,AR,5,3,0,0,0,3,4,0,0,0,4
2020,51035,Sestino,AR,6,7,0,0,0,7,4,0,0,0,4
2020,51035,Sestino,AR,7,3,0,0,0,3,3,0,0,0,3
2020,51035,Sestino,AR,8,4,0,0,0,4,6,0,0,0,6
2020,51035,Sestino,AR,9,4,0,0,0,4,0,0,0,0,0
2020,51035,Sestino,AR,10,1,0,0,0,1,4,0,0,0,4
2020,51035,Sestino,AR,11,6,0,0,0,6,3,0,0,0,3
2020,51035,Sestino,AR,12,8,0,0,0,8,7,0,0,0,7
2020,51035,Sestino,AR,13,5,0,0,0,5,10,0,0,0,10
2020,51035,Sestino,AR,14,7,0,0,0,7,4,0,0,0,4
2020,51035,Sestino,AR,15,8,0,0,0,8,8,0,0,0,8
2020,51035,Sestino,AR,16,2,0,0,0,2,10,0,0,0,10
2020,51035,Sestino,AR,17,2,0,0,0,2,5,0,0,0,5
2020,51035,Sestino,AR,18,4,0,0,0,4,4,1,0,0,5
2020,51035,Sestino,AR,19,7,0,0,0,7,7,0,0,0,7
2020,51035,Sestino,AR,20,3,0,0,0,3,2,0,0,0,2
2020,51035,Sestino,AR,21,7,0,0,0,7,3,0,0,0,3
2020,51035,Sestino,AR,22,10,0,0,0,10,6,1,0,0,7
2020,51035,Sestino,AR,23,4,0,0,0,4,1,0,0,0,1
2020,51035,Sestino,AR,24,5,1,0,0,6,3,0,0,0,3
2020,51035,Sestino,AR,25,3,2,0,0,5,4,0,0,0,4
2020,51035,Sestino,AR,26,10,1,0,0,11,6,1,0,0,7
2020,51035,Sestino,AR,27,9,0,0,0,9,2,2,0,0,4
2020,51035,Sestino,AR,28,8,0,0,0,8,5,1,0,0,6
2020,51035,Sestino,AR,29,5,1,0,0,6,2,2,0,0,4
2020,51035,Sestino,AR,30,2,0,0,0,2,4,2,0,0,6
2020,51035,Sestino,AR,31,4,2,0,0,6,6,4,0,0,10
2020,51035,Sestino,AR,32,6,1,0,0,7,1,2,0,0,3
2020,51035,Sestino,AR,33,8,0,0,0,8,4,3,0,0,7
2020,51035,Sestino,AR,34,6,2,0,0,8,3,1,0,0,4
2020,51035,Sestino,AR,35,3,1,0,0,4,4,4,0,0,8
2020,51035,Sestino,AR,36,2,3,0,0,5,5,3,0,0,8
2020,51035,Sestino,AR,37,6,1,0,0,7,1,6,0,0,7
2020,51035,Sestino,AR,38,3,2,0,0,5,1,5,0,0,6
2020,51035,Sestino,AR,39,3,3,0,0,6,3,3,0,0,6
2020,51035,Sestino,AR,40,5,2,0,0,7,3,6,0,0,9
2020,51035,Sestino,AR,41,3,3,1,0,7,4,4,0,0,8
2020,51035,Sestino,AR,42,6,5,0,0,11,1,5,0,0,6
2020,51035,Sestino,AR,43,3,5,0,0,8,1,5,0,0,6
2020,51035,Sestino,AR,44,1,6,0,0,7,0,4,0,0,4
2020,51035,Sestino,AR,45,3,6,1,0,10,3,2,0,0,5
2020,51035,Sestino,AR,46,3,6,0,0,9,0,9,0,0,9
2020,51035,Sestino,AR,47,1,4,1,0,6,3,3,3,0,9
2020,51035,Sestino,AR,48,5,9,0,0,14,6,6,0,0,12
2020,51035,Sestino,AR,49,3,5,0,0,8,0,9,0,1,10
2020,51035,Sestino,AR,50,2,9,1,0,12,2,1,0,1,4
2020,51035,Sestino,AR,51,2,3,1,0,6,2,10,1,0,13
2020,51035,Sestino,AR,52,3,8,0,0,11,1,6,0,0,7
2020,51035,Sestino,AR,53,2,7,1,0,10,0,8,1,0,9
2020,51035,Sestino,AR,54,4,6,1,1,12,0,11,1,0,12
2020,51035,Sestino,AR,55,2,7,0,0,9,1,7,0,0,8
2020,51035,Sestino,AR,56,2,7,0,0,9,1,7,0,1,9
2020,51035,Sestino,AR,57,1,5,0,0,6,0,8,0,0,8
2020,51035,Sestino,AR,58,4,10,0,0,14,1,9,2,0,12
2020,51035,Sestino,AR,59,2,7,0,0,9,2,2,1,1,6
2020,51035,Sestino,AR,60,1,11,0,0,12,0,9,1,0,10
2020,51035,Sestino,AR,61,2,7,1,0,10,1,6,0,0,7
2020,51035,Sestino,AR,62,1,9,1,0,11,1,8,1,1,11
2020,51035,Sestino,AR,63,1,4,0,0,5,1,6,0,2,9
2020,51035,Sestino,AR,64,2,3,0,0,5,0,13,0,0,13
2020,51035,Sestino,AR,65,2,6,1,0,9,2,4,0,0,6
2020,51035,Sestino,AR,66,0,8,1,1,10,1,7,0,2,10
2020,51035,Sestino,AR,67,2,6,0,0,8,0,7,0,6,13
2020,51035,Sestino,AR,68,1,5,0,1,7,0,3,1,1,5
2020,51035,Sestino,AR,69,2,6,0,0,8,1,6,1,0,8
2020,51035,Sestino,AR,70,0,9,0,0,9,0,6,0,2,8
2020,51035,Sestino,AR,71,1,4,1,0,6,0,2,0,1,3
2020,51035,Sestino,AR,72,1,4,0,0,5,0,5,0,2,7
2020,51035,Sestino,AR,73,2,3,1,0,6,0,4,0,4,8
2020,51035,Sestino,AR,74,1,5,0,1,7,0,5,0,1,6
2020,51035,Sestino,AR,75,2,4,0,0,6,0,4,0,3,7
2020,51035,Sestino,AR,76,2,5,0,2,9,0,6,0,2,8
2020,51035,Sestino,AR,77,1,4,0,0,5,0,3,0,0,3
2020,51035,Sestino,AR,78,0,4,0,0,4,0,8,0,3,11
2020,51035,Sestino,AR,79,0,5,1,1,7,1,2,0,4,7
2020,51035,Sestino,AR,80,0,4,0,0,4,0,3,0,6,9
2020,51035,Sestino,AR,81,1,6,0,1,8,0,3,0,3,6
2020,51035,Sestino,AR,82,0,6,0,0,6,0,3,0,3,6
2020,51035,Sestino,AR,83,1,5,0,2,8,0,0,0,8,8
2020,51035,Sestino,AR,84,0,4,0,0,4,1,2,0,7,10
2020,51035,Sestino,AR,85,0,2,0,0,2,1,1,0,5,7
2020,51035,Sestino,AR,86,1,3,0,1,5,0,0,0,3,3
2020,51035,Sestino,AR,87,0,1,0,0,1,0,1,0,5,6
2020,51035,Sestino,AR,88,0,3,0,0,3,2,0,0,7,9
2020,51035,Sestino,AR,89,1,1,0,1,3,1,0,0,6,7
2020,51035,Sestino,AR,90,0,0,0,2,2,0,0,0,4,4
2020,51035,Sestino,AR,91,0,0,0,0,0,0,1,0,3,4
2020,51035,Sestino,AR,92,0,1,0,1,2,0,0,0,1,1
2020,51035,Sestino,AR,93,0,0,0,2,2,0,0,0,3,3
2020,51035,Sestino,AR,94,0,0,0,1,1,0,0,0,0,0
2020,51035,Sestino,AR,95,0,0,0,0,0,1,0,0,3,4
2020,51035,Sestino,AR,96,0,0,0,0,0,0,0,0,2,2
2020,51035,Sestino,AR,97,0,0,0,0,0,0,0,0,2,2
2020,51035,Sestino,AR,98,0,0,0,0,0,0,0,0,0,0
2020,51035,Sestino,AR,99,0,0,0,0,0,0,0,0,0,0
2020,51035,Sestino,AR,100 e più,0,0,0,0,0,0,0,0,1,1
2020,51037,Subbiano,AR,0,16,0,0,0,16,21,0,0,0,21
2020,51037,Subbiano,AR,1,17,0,0,0,17,12,0,0,0,12
2020,51037,Subbiano,AR,2,25,0,0,0,25,17,0,0,0,17
2020,51037,Subbiano,AR,3,20,0,0,0,20,27,0,0,0,27
2020,51037,Subbiano,AR,4,25,0,0,0,25,23,0,0,0,23
2020,51037,Subbiano,AR,5,19,0,0,0,19,16,0,0,0,16
2020,51037,Subbiano,AR,6,25,0,0,0,25,19,0,0,0,19
2020,51037,Subbiano,AR,7,26,0,0,0,26,29,0,0,0,29
2020,51037,Subbiano,AR,8,22,0,0,0,22,32,0,0,0,32
2020,51037,Subbiano,AR,9,34,0,0,0,34,28,0,0,0,28
2020,51037,Subbiano,AR,10,38,0,0,0,38,34,0,0,0,34
2020,51037,Subbiano,AR,11,31,0,0,0,31,30,0,0,0,30
2020,51037,Subbiano,AR,12,39,0,0,0,39,28,0,0,0,28
2020,51037,Subbiano,AR,13,35,0,0,0,35,30,0,0,0,30
2020,51037,Subbiano,AR,14,35,0,0,0,35,28,0,0,0,28
2020,51037,Subbiano,AR,15,31,0,0,0,31,36,0,0,0,36
2020,51037,Subbiano,AR,16,41,0,0,0,41,37,0,0,0,37
2020,51037,Subbiano,AR,17,24,0,0,0,24,29,0,0,0,29
2020,51037,Subbiano,AR,18,28,0,0,0,28,22,0,0,0,22
2020,51037,Subbiano,AR,19,37,0,0,0,37,28,0,0,0,28
2020,51037,Subbiano,AR,20,35,0,0,0,35,23,0,0,0,23
2020,51037,Subbiano,AR,21,36,0,0,0,36,19,0,0,0,19
2020,51037,Subbiano,AR,22,40,0,0,0,40,25,0,0,0,25
2020,51037,Subbiano,AR,23,30,0,0,0,30,38,0,0,0,38
2020,51037,Subbiano,AR,24,31,0,0,0,31,34,3,0,0,37
2020,51037,Subbiano,AR,25,43,1,0,0,44,18,1,0,0,19
2020,51037,Subbiano,AR,26,29,0,0,0,29,24,1,0,0,25
2020,51037,Subbiano,AR,27,32,2,0,0,34,32,2,0,0,34
2020,51037,Subbiano,AR,28,34,0,0,0,34,26,3,0,0,29
2020,51037,Subbiano,AR,29,28,3,0,0,31,17,6,0,0,23
2020,51037,Subbiano,AR,30,28,6,0,0,34,19,10,0,0,29
2020,51037,Subbiano,AR,31,24,2,0,0,26,19,9,0,0,28
2020,51037,Subbiano,AR,32,20,2,0,0,22,19,16,1,0,36
2020,51037,Subbiano,AR,33,28,9,0,0,37,9,12,0,0,21
2020,51037,Subbiano,AR,34,20,9,0,0,29,22,15,0,0,37
2020,51037,Subbiano,AR,35,11,17,0,0,28,16,17,0,0,33
2020,51037,Subbiano,AR,36,21,8,0,0,29,15,26,0,0,41
2020,51037,Subbiano,AR,37,14,18,1,0,33,13,14,4,0,31
2020,51037,Subbiano,AR,38,14,14,1,0,29,9,18,1,0,28
2020,51037,Subbiano,AR,39,30,9,1,1,41,13,23,0,1,37
2020,51037,Subbiano,AR,40,16,20,1,0,37,12,28,2,0,42
2020,51037,Subbiano,AR,41,18,21,1,0,40,12,25,2,2,41
2020,51037,Subbiano,AR,42,17,30,1,0,48,14,32,4,1,51
2020,51037,Subbiano,AR,43,24,27,0,0,51,10,29,1,2,42
2020,51037,Subbiano,AR,44,21,29,0,0,50,16,42,2,0,60
2020,51037,Subbiano,AR,45,12,41,3,1,57,14,56,6,0,76
2020,51037,Subbiano,AR,46,15,31,1,0,47,7,38,2,0,47
2020,51037,Subbiano,AR,47,10,40,8,0,58,11,32,7,0,50
2020,51037,Subbiano,AR,48,25,35,2,0,62,7,46,7,0,60
2020,51037,Subbiano,AR,49,18,32,4,0,54,9,49,4,1,63
2020,51037,Subbiano,AR,50,19,37,4,1,61,9,24,3,2,38
2020,51037,Subbiano,AR,51,9,30,3,0,42,7,37,2,1,47
2020,51037,Subbiano,AR,52,12,40,6,1,59,6,50,4,3,63
2020,51037,Subbiano,AR,53,16,45,3,1,65,3,59,3,1,66
2020,51037,Subbiano,AR,54,10,45,6,1,62,6,30,5,1,42
2020,51037,Subbiano,AR,55,9,40,7,1,57,5,41,5,0,51
2020,51037,Subbiano,AR,56,5,40,5,0,50,5,41,4,3,53
2020,51037,Subbiano,AR,57,3,40,2,0,45,5,34,3,1,43
2020,51037,Subbiano,AR,58,9,34,2,1,46,7,36,5,2,50
2020,51037,Subbiano,AR,59,6,41,4,1,52,0,31,3,4,38
2020,51037,Subbiano,AR,60,2,33,3,1,39,2,37,5,4,48
2020,51037,Subbiano,AR,61,5,37,2,0,44,2,31,2,4,39
2020,51037,Subbiano,AR,62,2,34,2,0,38,2,27,0,4,33
2020,51037,Subbiano,AR,63,3,35,2,3,43,4,30,6,7,47
2020,51037,Subbiano,AR,64,3,32,3,1,39,3,32,0,3,38
2020,51037,Subbiano,AR,65,3,25,5,0,33,1,28,2,5,36
2020,51037,Subbiano,AR,66,2,22,3,3,30,0,30,3,6,39
2020,51037,Subbiano,AR,67,5,37,1,0,43,0,32,1,3,36
2020,51037,Subbiano,AR,68,4,27,5,2,38,2,24,4,4,34
2020,51037,Subbiano,AR,69,2,23,4,1,30,2,26,3,10,41
2020,51037,Subbiano,AR,70,5,25,3,1,34,0,41,2,6,49
2020,51037,Subbiano,AR,71,1,30,0,1,32,1,35,1,5,42
2020,51037,Subbiano,AR,72,0,34,1,5,40,1,33,2,13,49
2020,51037,Subbiano,AR,73,3,39,0,2,44,0,30,3,11,44
2020,51037,Subbiano,AR,74,1,25,2,1,29,0,25,2,9,36
2020,51037,Subbiano,AR,75,1,35,0,2,38,1,20,2,7,30
2020,51037,Subbiano,AR,76,2,20,0,2,24,0,23,1,9,33
2020,51037,Subbiano,AR,77,0,28,1,0,29,0,15,0,18,33
2020,51037,Subbiano,AR,78,3,23,1,3,30,0,9,1,11,21
2020,51037,Subbiano,AR,79,3,15,1,6,25,1,17,0,5,23
2020,51037,Subbiano,AR,80,0,24,0,1,25,0,12,0,13,25
2020,51037,Subbiano,AR,81,3,21,1,4,29,2,14,0,13,29
2020,51037,Subbiano,AR,82,1,12,2,4,19,0,11,0,17,28
2020,51037,Subbiano,AR,83,1,14,1,4,20,1,7,0,14,22
2020,51037,Subbiano,AR,84,2,13,0,4,19,3,5,0,19,27
2020,51037,Subbiano,AR,85,0,7,0,3,10,2,5,0,12,19
2020,51037,Subbiano,AR,86,2,6,0,4,12,0,6,0,14,20
2020,51037,Subbiano,AR,87,0,10,0,0,10,2,6,0,11,19
2020,51037,Subbiano,AR,88,1,8,0,3,12,0,1,1,10,12
2020,51037,Subbiano,AR,89,1,3,0,3,7,0,1,0,10,11
2020,51037,Subbiano,AR,90,0,3,0,2,5,0,1,0,10,11
2020,51037,Subbiano,AR,91,0,5,0,1,6,0,1,0,5,6
2020,51037,Subbiano,AR,92,0,1,0,0,1,1,2,0,8,11
2020,51037,Subbiano,AR,93,0,1,0,1,2,2,0,0,3,5
2020,51037,Subbiano,AR,94,0,0,0,0,0,0,0,0,2,2
2020,51037,Subbiano,AR,95,0,1,0,0,1,0,0,0,2,2
2020,51037,Subbiano,AR,96,0,0,0,1,1,0,0,0,2,2
2020,51037,Subbiano,AR,97,0,0,0,1,1,0,0,0,3,3
2020,51037,Subbiano,AR,98,0,0,0,0,0,0,0,0,0,0
2020,51037,Subbiano,AR,99,0,1,0,0,1,0,0,0,3,3
2020,51037,Subbiano,AR,100 e più,0,0,0,0,0,0,0,0,1,1
2020,51038,Talla,AR,0,1,0,0,0,1,3,0,0,0,3
2020,51038,Talla,AR,1,3,0,0,0,3,0,0,0,0,0
2020,51038,Talla,AR,2,3,0,0,0,3,2,0,0,0,2
2020,51038,Talla,AR,3,2,0,0,0,2,3,0,0,0,3
2020,51038,Talla,AR,4,3,0,0,0,3,1,0,0,0,1
2020,51038,Talla,AR,5,3,0,0,0,3,2,0,0,0,2
2020,51038,Talla,AR,6,1,0,0,0,1,2,0,0,0,2
2020,51038,Talla,AR,7,7,0,0,0,7,1,0,0,0,1
2020,51038,Talla,AR,8,8,0,0,0,8,5,0,0,0,5
2020,51038,Talla,AR,9,3,0,0,0,3,1,0,0,0,1
2020,51038,Talla,AR,10,0,0,0,0,0,3,0,0,0,3
2020,51038,Talla,AR,11,6,0,0,0,6,3,0,0,0,3
2020,51038,Talla,AR,12,6,0,0,0,6,3,0,0,0,3
2020,51038,Talla,AR,13,4,0,0,0,4,2,0,0,0,2
2020,51038,Talla,AR,14,9,0,0,0,9,4,0,0,0,4
2020,51038,Talla,AR,15,2,0,0,0,2,4,0,0,0,4
2020,51038,Talla,AR,16,4,0,0,0,4,3,0,0,0,3
2020,51038,Talla,AR,17,1,0,0,0,1,1,0,0,0,1
2020,51038,Talla,AR,18,5,0,0,0,5,4,0,0,0,4
2020,51038,Talla,AR,19,3,0,0,0,3,3,0,0,0,3
2020,51038,Talla,AR,20,3,0,0,0,3,1,0,0,0,1
2020,51038,Talla,AR,21,4,0,0,0,4,3,0,0,0,3
2020,51038,Talla,AR,22,1,0,0,0,1,2,0,0,0,2
2020,51038,Talla,AR,23,3,0,0,0,3,0,0,0,0,0
2020,51038,Talla,AR,24,5,0,0,0,5,5,0,0,0,5
2020,51038,Talla,AR,25,3,0,0,0,3,4,0,0,0,4
2020,51038,Talla,AR,26,5,0,0,0,5,3,0,0,0,3
2020,51038,Talla,AR,27,3,0,0,0,3,3,1,0,0,4
2020,51038,Talla,AR,28,1,1,0,0,2,2,1,0,0,3
2020,51038,Talla,AR,29,3,0,0,0,3,3,2,0,0,5
2020,51038,Talla,AR,30,2,1,0,0,3,2,0,0,0,2
2020,51038,Talla,AR,31,4,0,0,0,4,6,3,1,0,10
2020,51038,Talla,AR,32,3,1,0,0,4,0,3,0,0,3
2020,51038,Talla,AR,33,6,3,0,0,9,3,2,0,0,5
2020,51038,Talla,AR,34,3,0,0,0,3,1,4,0,0,5
2020,51038,Talla,AR,35,3,1,0,0,4,2,1,1,0,4
2020,51038,Talla,AR,36,2,2,0,0,4,4,2,0,0,6
2020,51038,Talla,AR,37,1,3,0,0,4,4,4,0,0,8
2020,51038,Talla,AR,38,4,4,0,0,8,0,1,1,0,2
2020,51038,Talla,AR,39,2,4,0,0,6,0,4,0,0,4
2020,51038,Talla,AR,40,3,2,0,0,5,0,2,0,0,2
2020,51038,Talla,AR,41,1,2,0,0,3,1,2,0,0,3
2020,51038,Talla,AR,42,1,4,0,0,5,1,5,0,0,6
2020,51038,Talla,AR,43,4,3,1,0,8,2,4,0,0,6
2020,51038,Talla,AR,44,4,8,0,0,12,2,2,1,0,5
2020,51038,Talla,AR,45,3,0,0,0,3,2,4,0,0,6
2020,51038,Talla,AR,46,4,5,0,0,9,2,5,1,0,8
2020,51038,Talla,AR,47,4,3,1,0,8,0,2,0,1,3
2020,51038,Talla,AR,48,2,6,0,0,8,2,10,1,0,13
2020,51038,Talla,AR,49,0,4,0,0,4,1,4,0,0,5
2020,51038,Talla,AR,50,4,4,0,0,8,2,4,0,0,6
2020,51038,Talla,AR,51,4,7,0,0,11,0,7,1,0,8
2020,51038,Talla,AR,52,2,9,1,0,12,0,3,0,0,3
2020,51038,Talla,AR,53,1,9,0,0,10,0,8,0,0,8
2020,51038,Talla,AR,54,4,4,0,0,8,0,5,0,1,6
2020,51038,Talla,AR,55,3,5,1,0,9,1,5,0,0,6
2020,51038,Talla,AR,56,2,6,1,0,9,1,7,1,0,9
2020,51038,Talla,AR,57,2,7,0,0,9,1,5,2,1,9
2020,51038,Talla,AR,58,2,3,0,0,5,1,5,0,0,6
2020,51038,Talla,AR,59,1,5,0,0,6,1,6,0,0,7
2020,51038,Talla,AR,60,1,5,2,0,8,1,9,0,0,10
2020,51038,Talla,AR,61,5,4,1,0,10,0,6,0,2,8
2020,51038,Talla,AR,62,1,6,0,0,7,1,5,0,2,8
2020,51038,Talla,AR,63,4,3,0,0,7,0,10,0,1,11
2020,51038,Talla,AR,64,1,7,0,1,9,1,9,0,1,11
2020,51038,Talla,AR,65,3,7,0,2,12,0,5,0,1,6
2020,51038,Talla,AR,66,1,8,0,1,10,0,5,0,1,6
2020,51038,Talla,AR,67,0,6,1,1,8,0,6,1,0,7
2020,51038,Talla,AR,68,1,8,0,1,10,0,4,0,1,5
2020,51038,Talla,AR,69,2,12,0,0,14,0,2,0,1,3
2020,51038,Talla,AR,70,3,6,0,1,10,0,5,0,1,6
2020,51038,Talla,AR,71,4,5,0,0,9,2,5,0,3,10
2020,51038,Talla,AR,72,0,4,0,1,5,0,6,0,1,7
2020,51038,Talla,AR,73,2,3,0,0,5,1,5,0,2,8
2020,51038,Talla,AR,74,1,3,0,2,6,0,2,0,6,8
2020,51038,Talla,AR,75,0,4,1,2,7,0,5,0,2,7
2020,51038,Talla,AR,76,0,5,1,0,6,1,5,0,0,6
2020,51038,Talla,AR,77,2,4,1,1,8,1,5,0,1,7
2020,51038,Talla,AR,78,0,4,2,1,7,0,6,0,3,9
2020,51038,Talla,AR,79,0,5,0,1,6,2,2,0,3,7
2020,51038,Talla,AR,80,2,6,0,2,10,1,3,0,3,7
2020,51038,Talla,AR,81,1,3,0,3,7,1,0,0,4,5
2020,51038,Talla,AR,82,0,2,0,1,3,2,2,0,2,6
2020,51038,Talla,AR,83,0,3,0,0,3,0,2,0,2,4
2020,51038,Talla,AR,84,0,4,0,1,5,0,1,0,5,6
2020,51038,Talla,AR,85,0,2,0,1,3,0,2,0,6,8
2020,51038,Talla,AR,86,1,2,0,0,3,0,1,0,1,2
2020,51038,Talla,AR,87,0,3,0,1,4,0,1,0,2,3
2020,51038,Talla,AR,88,0,1,0,0,1,0,2,0,6,8
2020,51038,Talla,AR,89,0,0,0,2,2,0,0,0,0,0
2020,51038,Talla,AR,90,0,1,0,1,2,0,0,1,1,2
2020,51038,Talla,AR,91,1,0,0,0,1,0,0,0,1,1
2020,51038,Talla,AR,92,0,0,0,0,0,0,0,0,2,2
2020,51038,Talla,AR,93,0,0,0,0,0,0,0,0,2,2
2020,51038,Talla,AR,94,0,0,0,0,0,0,0,0,0,0
2020,51038,Talla,AR,95,0,0,0,0,0,0,0,0,1,1
2020,51038,Talla,AR,96,0,1,0,0,1,0,0,0,0,0
2020,51038,Talla,AR,97,0,0,0,0,0,0,0,0,2,2
2020,51038,Talla,AR,98,0,0,0,0,0,0,0,0,1,1
2020,51038,Talla,AR,99,0,0,0,0,0,0,0,0,0,0
2020,51038,Talla,AR,100 e più,0,0,0,0,0,0,0,0,0,0
2020,51039,Terranuova Bracciolini,AR,0,42,0,0,0,42,27,0,0,0,27
2020,51039,Terranuova Bracciolini,AR,1,41,0,0,0,41,43,0,0,0,43
2020,51039,Terranuova Bracciolini,AR,2,47,0,0,0,47,50,0,0,0,50
2020,51039,Terranuova Bracciolini,AR,3,49,0,0,0,49,48,0,0,0,48
2020,51039,Terranuova Bracciolini,AR,4,43,0,0,0,43,44,0,0,0,44
2020,51039,Terranuova Bracciolini,AR,5,49,0,0,0,49,51,0,0,0,51
2020,51039,Terranuova Bracciolini,AR,6,59,0,0,0,59,47,0,0,0,47
2020,51039,Terranuova Bracciolini,AR,7,62,0,0,0,62,39,0,0,0,39
2020,51039,Terranuova Bracciolini,AR,8,50,0,0,0,50,50,0,0,0,50
2020,51039,Terranuova Bracciolini,AR,9,61,0,0,0,61,40,0,0,0,40
2020,51039,Terranuova Bracciolini,AR,10,49,0,0,0,49,55,0,0,0,55
2020,51039,Terranuova Bracciolini,AR,11,53,0,0,0,53,50,0,0,0,50
2020,51039,Terranuova Bracciolini,AR,12,54,0,0,0,54,49,0,0,0,49
2020,51039,Terranuova Bracciolini,AR,13,61,0,0,0,61,70,0,0,0,70
2020,51039,Terranuova Bracciolini,AR,14,48,0,0,0,48,56,0,0,0,56
2020,51039,Terranuova Bracciolini,AR,15,69,0,0,0,69,69,0,0,0,69
2020,51039,Terranuova Bracciolini,AR,16,67,0,0,0,67,58,0,0,0,58
2020,51039,Terranuova Bracciolini,AR,17,72,0,0,0,72,56,0,0,0,56
2020,51039,Terranuova Bracciolini,AR,18,60,0,0,0,60,60,0,0,0,60
2020,51039,Terranuova Bracciolini,AR,19,57,0,0,0,57,56,0,0,0,56
2020,51039,Terranuova Bracciolini,AR,20,64,0,0,0,64,57,0,0,0,57
2020,51039,Terranuova Bracciolini,AR,21,69,0,0,0,69,51,0,0,0,51
2020,51039,Terranuova Bracciolini,AR,22,71,0,0,0,71,53,1,0,0,54
2020,51039,Terranuova Bracciolini,AR,23,58,0,0,0,58,43,2,0,0,45
2020,51039,Terranuova Bracciolini,AR,24,71,1,0,0,72,49,2,0,0,51
2020,51039,Terranuova Bracciolini,AR,25,50,1,0,0,51,48,5,0,0,53
2020,51039,Terranuova Bracciolini,AR,26,47,1,0,0,48,51,8,0,0,59
2020,51039,Terranuova Bracciolini,AR,27,59,2,0,0,61,42,5,1,0,48
2020,51039,Terranuova Bracciolini,AR,28,69,5,0,0,74,37,7,0,0,44
2020,51039,Terranuova Bracciolini,AR,29,52,8,0,0,60,43,16,1,0,60
2020,51039,Terranuova Bracciolini,AR,30,54,10,0,0,64,41,14,0,0,55
2020,51039,Terranuova Bracciolini,AR,31,54,8,0,0,62,47,23,0,0,70
2020,51039,Terranuova Bracciolini,AR,32,41,16,0,0,57,38,23,0,0,61
2020,51039,Terranuova Bracciolini,AR,33,43,19,1,0,63,33,32,1,0,66
2020,51039,Terranuova Bracciolini,AR,34,36,16,0,0,52,26,26,1,0,53
2020,51039,Terranuova Bracciolini,AR,35,38,29,2,0,69,45,28,2,1,76
2020,51039,Terranuova Bracciolini,AR,36,29,22,0,0,51,34,34,2,0,70
2020,51039,Terranuova Bracciolini,AR,37,39,24,0,0,63,38,46,1,0,85
2020,51039,Terranuova Bracciolini,AR,38,32,40,3,0,75,24,35,1,0,60
2020,51039,Terranuova Bracciolini,AR,39,31,29,1,0,61,24,42,1,0,67
2020,51039,Terranuova Bracciolini,AR,40,32,27,4,0,63,21,46,5,0,72
2020,51039,Terranuova Bracciolini,AR,41,35,51,2,0,88,26,44,4,1,75
2020,51039,Terranuova Bracciolini,AR,42,43,43,3,0,89,29,50,5,0,84
2020,51039,Terranuova Bracciolini,AR,43,24,42,2,0,68,31,51,9,0,91
2020,51039,Terranuova Bracciolini,AR,44,39,42,5,0,86,24,80,9,1,114
2020,51039,Terranuova Bracciolini,AR,45,32,57,7,0,96,16,69,8,0,93
2020,51039,Terranuova Bracciolini,AR,46,31,59,9,0,99,27,60,8,2,97
2020,51039,Terranuova Bracciolini,AR,47,28,60,6,0,94,23,89,11,2,125
2020,51039,Terranuova Bracciolini,AR,48,36,76,9,1,122,22,76,12,2,112
2020,51039,Terranuova Bracciolini,AR,49,29,75,9,2,115,17,70,7,2,96
2020,51039,Terranuova Bracciolini,AR,50,32,75,5,1,113,14,71,8,7,100
2020,51039,Terranuova Bracciolini,AR,51,14,84,6,0,104,12,76,5,1,94
2020,51039,Terranuova Bracciolini,AR,52,24,72,12,2,110,16,86,10,2,114
2020,51039,Terranuova Bracciolini,AR,53,19,84,3,0,106,19,64,5,6,94
2020,51039,Terranuova Bracciolini,AR,54,16,87,15,1,119,15,106,8,5,134
2020,51039,Terranuova Bracciolini,AR,55,17,76,4,2,99,6,85,7,3,101
2020,51039,Terranuova Bracciolini,AR,56,17,79,6,0,102,16,71,7,6,100
2020,51039,Terranuova Bracciolini,AR,57,8,72,4,1,85,4,69,9,0,82
2020,51039,Terranuova Bracciolini,AR,58,8,81,7,4,100,8,60,5,0,73
2020,51039,Terranuova Bracciolini,AR,59,4,68,7,1,80,4,73,3,7,87
2020,51039,Terranuova Bracciolini,AR,60,4,64,6,1,75,3,68,10,8,89
2020,51039,Terranuova Bracciolini,AR,61,6,72,4,1,83,7,62,6,3,78
2020,51039,Terranuova Bracciolini,AR,62,6,64,6,5,81,6,70,3,6,85
2020,51039,Terranuova Bracciolini,AR,63,6,59,6,3,74,5,63,3,14,85
2020,51039,Terranuova Bracciolini,AR,64,5,64,2,2,73,4,59,2,11,76
2020,51039,Terranuova Bracciolini,AR,65,3,59,2,2,66,4,55,3,5,67
2020,51039,Terranuova Bracciolini,AR,66,4,52,6,2,64,1,66,2,6,75
2020,51039,Terranuova Bracciolini,AR,67,4,56,4,2,66,1,52,4,11,68
2020,51039,Terranuova Bracciolini,AR,68,6,53,2,7,68,3,47,1,8,59
2020,51039,Terranuova Bracciolini,AR,69,8,50,4,5,67,0,51,2,15,68
2020,51039,Terranuova Bracciolini,AR,70,7,51,2,2,62,3,52,2,11,68
2020,51039,Terranuova Bracciolini,AR,71,6,65,2,3,76,2,50,2,18,72
2020,51039,Terranuova Bracciolini,AR,72,3,57,1,4,65,4,57,4,23,88
2020,51039,Terranuova Bracciolini,AR,73,5,49,4,4,62,4,51,7,22,84
2020,51039,Terranuova Bracciolini,AR,74,4,58,2,6,70,2,47,2,26,77
2020,51039,Terranuova Bracciolini,AR,75,3,57,2,4,66,1,31,4,21,57
2020,51039,Terranuova Bracciolini,AR,76,3,35,1,7,46,5,29,0,20,54
2020,51039,Terranuova Bracciolini,AR,77,3,43,2,12,60,3,47,0,24,74
2020,51039,Terranuova Bracciolini,AR,78,4,34,1,3,42,4,30,1,18,53
2020,51039,Terranuova Bracciolini,AR,79,0,35,3,5,43,0,25,0,26,51
2020,51039,Terranuova Bracciolini,AR,80,3,43,0,8,54,3,30,1,36,70
2020,51039,Terranuova Bracciolini,AR,81,2,49,1,8,60,4,27,0,24,55
2020,51039,Terranuova Bracciolini,AR,82,5,40,0,7,52,1,19,2,37,59
2020,51039,Terranuova Bracciolini,AR,83,2,25,0,7,34,0,17,0,29,46
2020,51039,Terranuova Bracciolini,AR,84,1,24,0,5,30,2,18,0,26,46
2020,51039,Terranuova Bracciolini,AR,85,5,25,0,5,35,1,12,1,31,45
2020,51039,Terranuova Bracciolini,AR,86,3,19,0,4,26,1,11,1,26,39
2020,51039,Terranuova Bracciolini,AR,87,0,14,0,5,19,1,9,0,28,38
2020,51039,Terranuova Bracciolini,AR,88,1,12,0,5,18,0,2,1,20,23
2020,51039,Terranuova Bracciolini,AR,89,3,10,0,4,17,1,4,0,23,28
2020,51039,Terranuova Bracciolini,AR,90,0,10,0,4,14,1,1,0,14,16
2020,51039,Terranuova Bracciolini,AR,91,0,4,0,5,9,0,0,0,14,14
2020,51039,Terranuova Bracciolini,AR,92,0,6,0,1,7,0,0,0,19,19
2020,51039,Terranuova Bracciolini,AR,93,0,2,0,6,8,1,3,0,11,15
2020,51039,Terranuova Bracciolini,AR,94,0,1,0,3,4,0,2,0,12,14
2020,51039,Terranuova Bracciolini,AR,95,1,2,0,2,5,0,0,0,8,8
2020,51039,Terranuova Bracciolini,AR,96,0,2,0,1,3,0,1,0,5,6
2020,51039,Terranuova Bracciolini,AR,97,0,0,0,0,0,0,0,0,2,2
2020,51039,Terranuova Bracciolini,AR,98,0,0,0,1,1,0,0,0,6,6
2020,51039,Terranuova Bracciolini,AR,99,0,1,0,0,1,0,0,0,3,3
2020,51039,Terranuova Bracciolini,AR,100 e più,0,0,0,0,0,1,1,0,0,2
2020,51040,Castelfranco Piandiscò,AR,0,45,0,0,0,45,27,0,0,0,27
2020,51040,Castelfranco Piandiscò,AR,1,44,0,0,0,44,41,0,0,0,41
2020,51040,Castelfranco Piandiscò,AR,2,41,0,0,0,41,38,0,0,0,38
2020,51040,Castelfranco Piandiscò,AR,3,36,0,0,0,36,35,0,0,0,35
2020,51040,Castelfranco Piandiscò,AR,4,51,0,0,0,51,47,0,0,0,47
2020,51040,Castelfranco Piandiscò,AR,5,36,0,0,0,36,32,0,0,0,32
2020,51040,Castelfranco Piandiscò,AR,6,43,0,0,0,43,49,0,0,0,49
2020,51040,Castelfranco Piandiscò,AR,7,38,0,0,0,38,41,0,0,0,41
2020,51040,Castelfranco Piandiscò,AR,8,54,0,0,0,54,39,0,0,0,39
2020,51040,Castelfranco Piandiscò,AR,9,52,0,0,0,52,45,0,0,0,45
2020,51040,Castelfranco Piandiscò,AR,10,36,0,0,0,36,54,0,0,0,54
2020,51040,Castelfranco Piandiscò,AR,11,45,0,0,0,45,59,0,0,0,59
2020,51040,Castelfranco Piandiscò,AR,12,57,0,0,0,57,48,0,0,0,48
2020,51040,Castelfranco Piandiscò,AR,13,53,0,0,0,53,47,0,0,0,47
2020,51040,Castelfranco Piandiscò,AR,14,42,0,0,0,42,40,0,0,0,40
2020,51040,Castelfranco Piandiscò,AR,15,41,0,0,0,41,50,0,0,0,50
2020,51040,Castelfranco Piandiscò,AR,16,40,0,0,0,40,38,0,0,0,38
2020,51040,Castelfranco Piandiscò,AR,17,49,0,0,0,49,50,0,0,0,50
2020,51040,Castelfranco Piandiscò,AR,18,37,0,0,0,37,50,0,0,0,50
2020,51040,Castelfranco Piandiscò,AR,19,55,0,0,0,55,48,0,0,0,48
2020,51040,Castelfranco Piandiscò,AR,20,47,0,0,0,47,41,2,0,0,43
2020,51040,Castelfranco Piandiscò,AR,21,51,0,0,0,51,35,2,0,0,37
2020,51040,Castelfranco Piandiscò,AR,22,39,0,0,0,39,34,0,0,0,34
2020,51040,Castelfranco Piandiscò,AR,23,38,0,0,0,38,32,2,0,0,34
2020,51040,Castelfranco Piandiscò,AR,24,44,1,0,0,45,55,3,0,0,58
2020,51040,Castelfranco Piandiscò,AR,25,43,0,0,0,43,44,3,0,0,47
2020,51040,Castelfranco Piandiscò,AR,26,49,1,0,0,50,41,4,0,0,45
2020,51040,Castelfranco Piandiscò,AR,27,57,4,0,0,61,28,6,0,0,34
2020,51040,Castelfranco Piandiscò,AR,28,41,4,0,0,45,50,4,0,0,54
2020,51040,Castelfranco Piandiscò,AR,29,57,5,0,0,62,40,8,0,0,48
2020,51040,Castelfranco Piandiscò,AR,30,38,5,0,0,43,37,14,0,0,51
2020,51040,Castelfranco Piandiscò,AR,31,46,9,0,0,55,35,16,0,0,51
2020,51040,Castelfranco Piandiscò,AR,32,45,10,0,0,55,42,23,0,0,65
2020,51040,Castelfranco Piandiscò,AR,33,41,14,0,0,55,35,22,0,0,57
2020,51040,Castelfranco Piandiscò,AR,34,32,19,0,0,51,29,27,1,0,57
2020,51040,Castelfranco Piandiscò,AR,35,42,18,0,0,60,30,25,1,0,56
2020,51040,Castelfranco Piandiscò,AR,36,41,20,2,0,63,41,22,1,1,65
2020,51040,Castelfranco Piandiscò,AR,37,36,24,0,0,60,39,31,1,0,71
2020,51040,Castelfranco Piandiscò,AR,38,37,31,1,0,69,21,32,1,1,55
2020,51040,Castelfranco Piandiscò,AR,39,32,28,2,0,62,33,49,5,0,87
2020,51040,Castelfranco Piandiscò,AR,40,21,27,0,0,48,21,36,2,0,59
2020,51040,Castelfranco Piandiscò,AR,41,23,22,0,0,45,18,44,3,0,65
2020,51040,Castelfranco Piandiscò,AR,42,39,33,2,0,74,19,34,2,0,55
2020,51040,Castelfranco Piandiscò,AR,43,29,43,3,0,75,18,43,5,0,66
2020,51040,Castelfranco Piandiscò,AR,44,28,52,4,0,84,23,51,6,0,80
2020,51040,Castelfranco Piandiscò,AR,45,25,48,5,1,79,23,58,2,0,83
2020,51040,Castelfranco Piandiscò,AR,46,28,49,9,0,86,15,53,7,0,75
2020,51040,Castelfranco Piandiscò,AR,47,36,68,3,0,107,13,50,8,2,73
2020,51040,Castelfranco Piandiscò,AR,48,27,45,3,1,76,12,51,8,0,71
2020,51040,Castelfranco Piandiscò,AR,49,22,62,2,0,86,21,47,5,3,76
2020,51040,Castelfranco Piandiscò,AR,50,16,50,3,0,69,13,77,9,0,99
2020,51040,Castelfranco Piandiscò,AR,51,15,52,7,0,74,13,61,4,1,79
2020,51040,Castelfranco Piandiscò,AR,52,17,55,7,1,80,21,62,6,1,90
2020,51040,Castelfranco Piandiscò,AR,53,11,59,1,0,71,11,64,14,1,90
2020,51040,Castelfranco Piandiscò,AR,54,15,52,2,1,70,7,71,4,6,88
2020,51040,Castelfranco Piandiscò,AR,55,15,66,4,0,85,4,56,6,1,67
2020,51040,Castelfranco Piandiscò,AR,56,19,66,4,0,89,9,61,4,2,76
2020,51040,Castelfranco Piandiscò,AR,57,14,52,8,0,74,8,71,7,2,88
2020,51040,Castelfranco Piandiscò,AR,58,7,68,8,2,85,9,74,5,5,93
2020,51040,Castelfranco Piandiscò,AR,59,3,54,3,0,60,8,51,3,5,67
2020,51040,Castelfranco Piandiscò,AR,60,7,55,3,2,67,3,52,5,6,66
2020,51040,Castelfranco Piandiscò,AR,61,9,61,6,3,79,4,56,2,5,67
2020,51040,Castelfranco Piandiscò,AR,62,8,48,7,2,65,8,42,3,3,56
2020,51040,Castelfranco Piandiscò,AR,63,4,55,5,2,66,1,57,4,6,68
2020,51040,Castelfranco Piandiscò,AR,64,3,50,2,2,57,5,48,4,5,62
2020,51040,Castelfranco Piandiscò,AR,65,3,45,7,4,59,3,52,3,4,62
2020,51040,Castelfranco Piandiscò,AR,66,4,40,2,1,47,2,47,4,5,58
2020,51040,Castelfranco Piandiscò,AR,67,8,46,2,2,58,2,38,2,7,49
2020,51040,Castelfranco Piandiscò,AR,68,7,45,1,6,59,4,54,2,8,68
2020,51040,Castelfranco Piandiscò,AR,69,10,47,2,2,61,0,42,3,16,61
2020,51040,Castelfranco Piandiscò,AR,70,3,53,6,6,68,3,45,3,7,58
2020,51040,Castelfranco Piandiscò,AR,71,5,43,1,3,52,0,30,1,14,45
2020,51040,Castelfranco Piandiscò,AR,72,1,47,2,3,53,2,39,2,14,57
2020,51040,Castelfranco Piandiscò,AR,73,4,47,2,5,58,3,39,2,19,63
2020,51040,Castelfranco Piandiscò,AR,74,5,44,0,6,55,1,41,1,18,61
2020,51040,Castelfranco Piandiscò,AR,75,2,36,2,2,42,2,29,0,20,51
2020,51040,Castelfranco Piandiscò,AR,76,4,32,1,1,38,3,26,2,21,52
2020,51040,Castelfranco Piandiscò,AR,77,3,37,0,5,45,0,28,0,25,53
2020,51040,Castelfranco Piandiscò,AR,78,3,20,0,5,28,0,16,0,16,32
2020,51040,Castelfranco Piandiscò,AR,79,2,27,0,1,30,2,17,0,8,27
2020,51040,Castelfranco Piandiscò,AR,80,2,34,0,5,41,1,20,0,21,42
2020,51040,Castelfranco Piandiscò,AR,81,2,33,0,6,41,0,21,0,22,43
2020,51040,Castelfranco Piandiscò,AR,82,1,23,1,4,29,1,14,0,28,43
2020,51040,Castelfranco Piandiscò,AR,83,3,13,0,8,24,1,6,0,26,33
2020,51040,Castelfranco Piandiscò,AR,84,0,13,0,4,17,0,8,0,15,23
2020,51040,Castelfranco Piandiscò,AR,85,2,18,0,8,28,0,7,0,26,33
2020,51040,Castelfranco Piandiscò,AR,86,4,11,0,5,20,1,4,0,15,20
2020,51040,Castelfranco Piandiscò,AR,87,4,8,0,4,16,1,8,0,21,30
2020,51040,Castelfranco Piandiscò,AR,88,1,6,0,2,9,0,4,0,21,25
2020,51040,Castelfranco Piandiscò,AR,89,0,3,0,3,6,1,3,0,16,20
2020,51040,Castelfranco Piandiscò,AR,90,0,8,0,3,11,1,4,0,15,20
2020,51040,Castelfranco Piandiscò,AR,91,0,3,0,2,5,0,2,0,18,20
2020,51040,Castelfranco Piandiscò,AR,92,0,5,0,4,9,1,0,0,13,14
2020,51040,Castelfranco Piandiscò,AR,93,0,0,0,2,2,0,1,0,8,9
2020,51040,Castelfranco Piandiscò,AR,94,0,0,0,1,1,2,1,0,8,11
2020,51040,Castelfranco Piandiscò,AR,95,0,3,0,0,3,0,0,0,6,6
2020,51040,Castelfranco Piandiscò,AR,96,0,0,0,0,0,0,0,0,8,8
2020,51040,Castelfranco Piandiscò,AR,97,0,0,0,0,0,0,0,0,4,4
2020,51040,Castelfranco Piandiscò,AR,98,0,0,0,1,1,0,0,0,5,5
2020,51040,Castelfranco Piandiscò,AR,99,0,0,0,0,0,0,0,0,1,1
2020,51040,Castelfranco Piandiscò,AR,100 e più,0,1,0,0,1,0,0,0,2,2
2020,51041,Pratovecchio Stia,AR,0,11,0,0,0,11,16,0,0,0,16
2020,51041,Pratovecchio Stia,AR,1,17,0,0,0,17,8,0,0,0,8
2020,51041,Pratovecchio Stia,AR,2,17,0,0,0,17,9,0,0,0,9
2020,51041,Pratovecchio Stia,AR,3,16,0,0,0,16,14,0,0,0,14
2020,51041,Pratovecchio Stia,AR,4,16,0,0,0,16,13,0,0,0,13
2020,51041,Pratovecchio Stia,AR,5,19,0,0,0,19,16,0,0,0,16
2020,51041,Pratovecchio Stia,AR,6,16,0,0,0,16,21,0,0,0,21
2020,51041,Pratovecchio Stia,AR,7,15,0,0,0,15,13,0,0,0,13
2020,51041,Pratovecchio Stia,AR,8,23,0,0,0,23,27,0,0,0,27
2020,51041,Pratovecchio Stia,AR,9,18,0,0,0,18,21,0,0,0,21
2020,51041,Pratovecchio Stia,AR,10,19,0,0,0,19,20,0,0,0,20
2020,51041,Pratovecchio Stia,AR,11,25,0,0,0,25,15,0,0,0,15
2020,51041,Pratovecchio Stia,AR,12,19,0,0,0,19,32,0,0,0,32
2020,51041,Pratovecchio Stia,AR,13,24,0,0,0,24,15,0,0,0,15
2020,51041,Pratovecchio Stia,AR,14,24,0,0,0,24,17,0,0,0,17
2020,51041,Pratovecchio Stia,AR,15,21,0,0,0,21,24,0,0,0,24
2020,51041,Pratovecchio Stia,AR,16,22,0,0,0,22,25,0,0,0,25
2020,51041,Pratovecchio Stia,AR,17,20,0,0,0,20,22,0,0,0,22
2020,51041,Pratovecchio Stia,AR,18,23,0,0,0,23,15,0,0,0,15
2020,51041,Pratovecchio Stia,AR,19,27,0,0,0,27,23,0,0,0,23
2020,51041,Pratovecchio Stia,AR,20,23,0,0,0,23,17,0,0,0,17
2020,51041,Pratovecchio Stia,AR,21,27,0,0,0,27,17,0,0,0,17
2020,51041,Pratovecchio Stia,AR,22,31,0,0,0,31,17,1,0,0,18
2020,51041,Pratovecchio Stia,AR,23,27,0,0,0,27,23,1,0,0,24
2020,51041,Pratovecchio Stia,AR,24,27,0,0,0,27,19,0,0,0,19
2020,51041,Pratovecchio Stia,AR,25,24,0,0,0,24,28,0,0,0,28
2020,51041,Pratovecchio Stia,AR,26,25,0,0,0,25,27,1,0,0,28
2020,51041,Pratovecchio Stia,AR,27,35,1,0,0,36,18,2,0,0,20
2020,51041,Pratovecchio Stia,AR,28,27,3,0,0,30,35,6,0,0,41
2020,51041,Pratovecchio Stia,AR,29,19,3,0,0,22,19,4,0,0,23
2020,51041,Pratovecchio Stia,AR,30,23,7,0,0,30,11,11,0,0,22
2020,51041,Pratovecchio Stia,AR,31,24,3,0,0,27,16,8,0,0,24
2020,51041,Pratovecchio Stia,AR,32,20,8,0,0,28,21,9,0,0,30
2020,51041,Pratovecchio Stia,AR,33,17,5,0,0,22,14,11,0,0,25
2020,51041,Pratovecchio Stia,AR,34,19,10,1,0,30,15,14,1,0,30
2020,51041,Pratovecchio Stia,AR,35,19,12,0,0,31,19,10,0,0,29
2020,51041,Pratovecchio Stia,AR,36,15,9,0,0,24,12,13,0,0,25
2020,51041,Pratovecchio Stia,AR,37,18,6,0,0,24,8,13,1,0,22
2020,51041,Pratovecchio Stia,AR,38,12,18,0,0,30,6,20,0,1,27
2020,51041,Pratovecchio Stia,AR,39,19,8,0,0,27,12,11,1,0,24
2020,51041,Pratovecchio Stia,AR,40,11,14,1,0,26,14,18,3,0,35
2020,51041,Pratovecchio Stia,AR,41,13,18,2,0,33,9,18,5,0,32
2020,51041,Pratovecchio Stia,AR,42,13,18,0,0,31,11,25,3,0,39
2020,51041,Pratovecchio Stia,AR,43,14,11,1,0,26,17,28,3,0,48
2020,51041,Pratovecchio Stia,AR,44,21,22,6,0,49,7,19,4,1,31
2020,51041,Pratovecchio Stia,AR,45,9,20,2,0,31,8,25,4,1,38
2020,51041,Pratovecchio Stia,AR,46,12,25,0,0,37,11,23,3,0,37
2020,51041,Pratovecchio Stia,AR,47,13,26,2,1,42,8,34,3,0,45
2020,51041,Pratovecchio Stia,AR,48,18,22,5,0,45,9,33,1,2,45
2020,51041,Pratovecchio Stia,AR,49,13,24,4,0,41,11,28,3,1,43
2020,51041,Pratovecchio Stia,AR,50,12,27,2,0,41,4,31,2,0,37
2020,51041,Pratovecchio Stia,AR,51,9,34,4,0,47,5,37,2,0,44
2020,51041,Pratovecchio Stia,AR,52,10,29,3,0,42,6,32,4,2,44
2020,51041,Pratovecchio Stia,AR,53,10,33,4,0,47,4,32,6,1,43
2020,51041,Pratovecchio Stia,AR,54,7,33,5,0,45,4,33,1,0,38
2020,51041,Pratovecchio Stia,AR,55,4,34,4,0,42,4,43,7,2,56
2020,51041,Pratovecchio Stia,AR,56,9,36,3,0,48,6,31,1,6,44
2020,51041,Pratovecchio Stia,AR,57,8,41,4,1,54,5,27,4,3,39
2020,51041,Pratovecchio Stia,AR,58,5,34,6,0,45,4,33,4,3,44
2020,51041,Pratovecchio Stia,AR,59,5,22,7,1,35,9,29,3,2,43
2020,51041,Pratovecchio Stia,AR,60,4,29,4,0,37,3,36,4,3,46
2020,51041,Pratovecchio Stia,AR,61,3,29,4,0,36,6,33,1,5,45
2020,51041,Pratovecchio Stia,AR,62,4,20,3,0,27,5,37,4,4,50
2020,51041,Pratovecchio Stia,AR,63,4,37,5,1,47,4,32,3,5,44
2020,51041,Pratovecchio Stia,AR,64,4,46,3,0,53,3,33,0,0,36
2020,51041,Pratovecchio Stia,AR,65,5,29,7,5,46,1,24,0,4,29
2020,51041,Pratovecchio Stia,AR,66,4,39,0,1,44,2,31,2,2,37
2020,51041,Pratovecchio Stia,AR,67,1,33,1,1,36,3,25,1,2,31
2020,51041,Pratovecchio Stia,AR,68,4,32,2,4,42,2,29,1,5,37
2020,51041,Pratovecchio Stia,AR,69,1,35,1,1,38,4,37,0,7,48
2020,51041,Pratovecchio Stia,AR,70,2,35,2,2,41,2,25,1,9,37
2020,51041,Pratovecchio Stia,AR,71,3,24,2,4,33,1,28,1,6,36
2020,51041,Pratovecchio Stia,AR,72,5,35,0,3,43,4,30,1,6,41
2020,51041,Pratovecchio Stia,AR,73,5,25,3,4,37,2,31,2,8,43
2020,51041,Pratovecchio Stia,AR,74,4,33,1,2,40,4,18,2,12,36
2020,51041,Pratovecchio Stia,AR,75,2,27,1,5,35,4,19,1,5,29
2020,51041,Pratovecchio Stia,AR,76,4,26,0,2,32,2,17,1,7,27
2020,51041,Pratovecchio Stia,AR,77,2,21,4,2,29,2,13,0,8,23
2020,51041,Pratovecchio Stia,AR,78,1,12,0,3,16,6,18,0,14,38
2020,51041,Pratovecchio Stia,AR,79,3,21,0,3,27,1,15,1,13,30
2020,51041,Pratovecchio Stia,AR,80,2,15,0,2,19,2,10,1,21,34
2020,51041,Pratovecchio Stia,AR,81,3,17,2,6,28,3,16,1,12,32
2020,51041,Pratovecchio Stia,AR,82,2,17,0,4,23,3,10,1,16,30
2020,51041,Pratovecchio Stia,AR,83,2,13,0,3,18,4,12,0,10,26
2020,51041,Pratovecchio Stia,AR,84,0,11,0,1,12,3,6,0,20,29
2020,51041,Pratovecchio Stia,AR,85,1,16,0,2,19,0,2,0,20,22
2020,51041,Pratovecchio Stia,AR,86,2,10,1,3,16,1,5,0,17,23
2020,51041,Pratovecchio Stia,AR,87,3,11,0,6,20,1,3,0,13,17
2020,51041,Pratovecchio Stia,AR,88,0,2,0,2,4,0,4,1,13,18
2020,51041,Pratovecchio Stia,AR,89,5,8,0,4,17,2,3,0,18,23
2020,51041,Pratovecchio Stia,AR,90,0,7,0,2,9,2,1,0,16,19
2020,51041,Pratovecchio Stia,AR,91,0,7,0,0,7,5,2,0,9,16
2020,51041,Pratovecchio Stia,AR,92,2,0,0,7,9,2,2,0,11,15
2020,51041,Pratovecchio Stia,AR,93,0,2,0,3,5,2,1,0,9,12
2020,51041,Pratovecchio Stia,AR,94,0,0,0,1,1,1,0,0,9,10
2020,51041,Pratovecchio Stia,AR,95,0,1,0,2,3,0,0,0,3,3
2020,51041,Pratovecchio Stia,AR,96,0,2,0,0,2,0,0,0,5,5
2020,51041,Pratovecchio Stia,AR,97,0,1,0,1,2,0,0,0,2,2
2020,51041,Pratovecchio Stia,AR,98,0,0,0,0,0,2,0,0,5,7
2020,51041,Pratovecchio Stia,AR,99,0,0,0,0,0,0,0,0,1,1
2020,51041,Pratovecchio Stia,AR,100 e più,0,0,0,0,0,0,0,0,1,1
2020,51042,Laterina Pergine Valdarno,AR,0,23,0,0,0,23,16,0,0,0,16
2020,51042,Laterina Pergine Valdarno,AR,1,13,0,0,0,13,19,0,0,0,19
2020,51042,Laterina Pergine Valdarno,AR,2,32,0,0,0,32,18,0,0,0,18
2020,51042,Laterina Pergine Valdarno,AR,3,25,0,0,0,25,20,0,0,0,20
2020,51042,Laterina Pergine Valdarno,AR,4,30,0,0,0,30,29,0,0,0,29
2020,51042,Laterina Pergine Valdarno,AR,5,28,0,0,0,28,23,0,0,0,23
2020,51042,Laterina Pergine Valdarno,AR,6,33,0,0,0,33,31,0,0,0,31
2020,51042,Laterina Pergine Valdarno,AR,7,27,0,0,0,27,17,0,0,0,17
2020,51042,Laterina Pergine Valdarno,AR,8,30,0,0,0,30,26,0,0,0,26
2020,51042,Laterina Pergine Valdarno,AR,9,28,0,0,0,28,31,0,0,0,31
2020,51042,Laterina Pergine Valdarno,AR,10,27,0,0,0,27,26,0,0,0,26
2020,51042,Laterina Pergine Valdarno,AR,11,31,0,0,0,31,34,0,0,0,34
2020,51042,Laterina Pergine Valdarno,AR,12,27,0,0,0,27,21,0,0,0,21
2020,51042,Laterina Pergine Valdarno,AR,13,26,0,0,0,26,25,0,0,0,25
2020,51042,Laterina Pergine Valdarno,AR,14,36,0,0,0,36,25,0,0,0,25
2020,51042,Laterina Pergine Valdarno,AR,15,28,0,0,0,28,22,0,0,0,22
2020,51042,Laterina Pergine Valdarno,AR,16,32,0,0,0,32,29,0,0,0,29
2020,51042,Laterina Pergine Valdarno,AR,17,39,0,0,0,39,25,0,0,0,25
2020,51042,Laterina Pergine Valdarno,AR,18,25,0,0,0,25,25,0,0,0,25
2020,51042,Laterina Pergine Valdarno,AR,19,29,0,0,0,29,23,0,0,0,23
2020,51042,Laterina Pergine Valdarno,AR,20,36,0,0,0,36,21,0,0,0,21
2020,51042,Laterina Pergine Valdarno,AR,21,30,0,0,0,30,30,0,0,0,30
2020,51042,Laterina Pergine Valdarno,AR,22,24,0,0,0,24,19,0,0,0,19
2020,51042,Laterina Pergine Valdarno,AR,23,26,0,0,0,26,32,0,0,0,32
2020,51042,Laterina Pergine Valdarno,AR,24,39,0,0,0,39,28,0,0,0,28
2020,51042,Laterina Pergine Valdarno,AR,25,30,1,0,0,31,30,2,0,0,32
2020,51042,Laterina Pergine Valdarno,AR,26,23,1,0,0,24,30,3,0,0,33
2020,51042,Laterina Pergine Valdarno,AR,27,28,0,0,0,28,17,4,0,0,21
2020,51042,Laterina Pergine Valdarno,AR,28,30,2,0,0,32,22,6,0,0,28
2020,51042,Laterina Pergine Valdarno,AR,29,20,1,0,0,21,25,4,0,0,29
2020,51042,Laterina Pergine Valdarno,AR,30,30,4,0,0,34,23,9,0,0,32
2020,51042,Laterina Pergine Valdarno,AR,31,29,10,1,0,40,18,6,0,0,24
2020,51042,Laterina Pergine Valdarno,AR,32,33,6,0,0,39,21,13,2,0,36
2020,51042,Laterina Pergine Valdarno,AR,33,24,12,1,0,37,15,14,0,0,29
2020,51042,Laterina Pergine Valdarno,AR,34,18,9,0,0,27,15,11,0,0,26
2020,51042,Laterina Pergine Valdarno,AR,35,26,9,0,0,35,16,20,0,0,36
2020,51042,Laterina Pergine Valdarno,AR,36,19,15,0,0,34,15,20,0,0,35
2020,51042,Laterina Pergine Valdarno,AR,37,18,19,0,0,37,20,26,2,0,48
2020,51042,Laterina Pergine Valdarno,AR,38,17,15,0,0,32,15,31,0,0,46
2020,51042,Laterina Pergine Valdarno,AR,39,13,20,0,0,33,14,28,4,0,46
2020,51042,Laterina Pergine Valdarno,AR,40,15,28,2,0,45,20,23,1,0,44
2020,51042,Laterina Pergine Valdarno,AR,41,20,32,4,0,56,8,36,1,0,45
2020,51042,Laterina Pergine Valdarno,AR,42,28,17,0,0,45,14,30,1,1,46
2020,51042,Laterina Pergine Valdarno,AR,43,23,29,3,0,55,13,31,3,0,47
2020,51042,Laterina Pergine Valdarno,AR,44,19,40,4,0,63,14,29,2,1,46
2020,51042,Laterina Pergine Valdarno,AR,45,29,33,2,0,64,17,46,1,1,65
2020,51042,Laterina Pergine Valdarno,AR,46,15,38,3,0,56,7,38,5,0,50
2020,51042,Laterina Pergine Valdarno,AR,47,21,36,0,0,57,10,37,10,0,57
2020,51042,Laterina Pergine Valdarno,AR,48,9,40,3,0,52,4,39,2,1,46
2020,51042,Laterina Pergine Valdarno,AR,49,11,36,0,0,47,8,34,1,1,44
2020,51042,Laterina Pergine Valdarno,AR,50,18,25,3,0,46,7,32,3,0,42
2020,51042,Laterina Pergine Valdarno,AR,51,14,27,1,2,44,6,34,5,0,45
2020,51042,Laterina Pergine Valdarno,AR,52,9,43,4,0,56,6,48,3,1,58
2020,51042,Laterina Pergine Valdarno,AR,53,9,31,1,0,41,7,42,9,1,59
2020,51042,Laterina Pergine Valdarno,AR,54,13,42,0,1,56,6,29,4,0,39
2020,51042,Laterina Pergine Valdarno,AR,55,15,44,5,1,65,5,35,10,3,53
2020,51042,Laterina Pergine Valdarno,AR,56,10,29,5,1,45,3,45,0,1,49
2020,51042,Laterina Pergine Valdarno,AR,57,7,34,3,0,44,0,46,2,3,51
2020,51042,Laterina Pergine Valdarno,AR,58,6,42,3,1,52,2,32,2,2,38
2020,51042,Laterina Pergine Valdarno,AR,59,6,40,6,1,53,8,36,1,1,46
2020,51042,Laterina Pergine Valdarno,AR,60,2,47,1,0,50,7,40,5,2,54
2020,51042,Laterina Pergine Valdarno,AR,61,6,28,6,4,44,3,30,6,5,44
2020,51042,Laterina Pergine Valdarno,AR,62,2,41,3,0,46,3,37,1,6,47
2020,51042,Laterina Pergine Valdarno,AR,63,3,33,4,1,41,5,41,3,2,51
2020,51042,Laterina Pergine Valdarno,AR,64,4,35,1,1,41,3,27,1,5,36
2020,51042,Laterina Pergine Valdarno,AR,65,0,36,1,1,38,6,28,0,7,41
2020,51042,Laterina Pergine Valdarno,AR,66,3,32,0,1,36,3,39,0,10,52
2020,51042,Laterina Pergine Valdarno,AR,67,0,37,0,0,37,1,39,2,3,45
2020,51042,Laterina Pergine Valdarno,AR,68,1,35,0,0,36,3,32,2,10,47
2020,51042,Laterina Pergine Valdarno,AR,69,1,38,2,4,45,2,29,0,11,42
2020,51042,Laterina Pergine Valdarno,AR,70,1,30,0,2,33,1,38,1,13,53
2020,51042,Laterina Pergine Valdarno,AR,71,6,41,0,8,55,1,36,2,6,45
2020,51042,Laterina Pergine Valdarno,AR,72,2,43,1,1,47,0,35,2,14,51
2020,51042,Laterina Pergine Valdarno,AR,73,0,45,1,2,48,1,39,2,9,51
2020,51042,Laterina Pergine Valdarno,AR,74,1,30,0,3,34,1,26,1,10,38
2020,51042,Laterina Pergine Valdarno,AR,75,0,18,3,1,22,2,24,0,5,31
2020,51042,Laterina Pergine Valdarno,AR,76,4,19,0,2,25,1,15,1,11,28
2020,51042,Laterina Pergine Valdarno,AR,77,5,31,0,3,39,2,18,1,16,37
2020,51042,Laterina Pergine Valdarno,AR,78,1,15,0,3,19,1,14,0,7,22
2020,51042,Laterina Pergine Valdarno,AR,79,1,20,0,5,26,2,14,0,14,30
2020,51042,Laterina Pergine Valdarno,AR,80,2,22,0,5,29,2,11,0,21,34
2020,51042,Laterina Pergine Valdarno,AR,81,2,18,0,5,25,2,15,0,20,37
2020,51042,Laterina Pergine Valdarno,AR,82,2,19,0,1,22,1,15,0,21,37
2020,51042,Laterina Pergine Valdarno,AR,83,3,16,0,4,23,5,11,0,16,32
2020,51042,Laterina Pergine Valdarno,AR,84,3,12,1,5,21,1,14,0,12,27
2020,51042,Laterina Pergine Valdarno,AR,85,1,13,0,4,18,1,5,0,14,20
2020,51042,Laterina Pergine Valdarno,AR,86,2,13,0,2,17,3,6,0,16,25
2020,51042,Laterina Pergine Valdarno,AR,87,3,7,0,3,13,2,2,0,17,21
2020,51042,Laterina Pergine Valdarno,AR,88,1,12,0,1,14,1,4,0,18,23
2020,51042,Laterina Pergine Valdarno,AR,89,1,3,0,3,7,0,2,0,13,15
2020,51042,Laterina Pergine Valdarno,AR,90,1,6,0,0,7,0,0,0,14,14
2020,51042,Laterina Pergine Valdarno,AR,91,0,3,0,0,3,0,1,0,7,8
2020,51042,Laterina Pergine Valdarno,AR,92,0,2,0,1,3,3,0,0,11,14
2020,51042,Laterina Pergine Valdarno,AR,93,0,4,0,1,5,0,0,0,14,14
2020,51042,Laterina Pergine Valdarno,AR,94,0,0,0,1,1,0,0,0,6,6
2020,51042,Laterina Pergine Valdarno,AR,95,0,1,0,2,3,0,1,0,2,3
2020,51042,Laterina Pergine Valdarno,AR,96,0,0,0,0,0,1,0,0,8,9
2020,51042,Laterina Pergine Valdarno,AR,97,0,0,0,0,0,0,0,0,4,4
2020,51042,Laterina Pergine Valdarno,AR,98,0,0,0,2,2,0,0,0,2,2
2020,51042,Laterina Pergine Valdarno,AR,99,0,0,0,0,0,0,0,0,0,0
2020,51042,Laterina Pergine Valdarno,AR,100 e più,0,0,0,0,0,0,0,0,1,1
2020,48001,Bagno a Ripoli,FI,0,76,0,0,0,76,57,0,0,0,57
2020,48001,Bagno a Ripoli,FI,1,75,0,0,0,75,75,0,0,0,75
2020,48001,Bagno a Ripoli,FI,2,85,0,0,0,85,85,0,0,0,85
2020,48001,Bagno a Ripoli,FI,3,86,0,0,0,86,82,0,0,0,82
2020,48001,Bagno a Ripoli,FI,4,83,0,0,0,83,85,0,0,0,85
2020,48001,Bagno a Ripoli,FI,5,100,0,0,0,100,88,0,0,0,88
2020,48001,Bagno a Ripoli,FI,6,99,0,0,0,99,92,0,0,0,92
2020,48001,Bagno a Ripoli,FI,7,97,0,0,0,97,92,0,0,0,92
2020,48001,Bagno a Ripoli,FI,8,93,0,0,0,93,101,0,0,0,101
2020,48001,Bagno a Ripoli,FI,9,120,0,0,0,120,110,0,0,0,110
2020,48001,Bagno a Ripoli,FI,10,114,0,0,0,114,116,0,0,0,116
2020,48001,Bagno a Ripoli,FI,11,127,0,0,0,127,99,0,0,0,99
2020,48001,Bagno a Ripoli,FI,12,135,0,0,0,135,124,0,0,0,124
2020,48001,Bagno a Ripoli,FI,13,138,0,0,0,138,89,0,0,0,89
2020,48001,Bagno a Ripoli,FI,14,113,0,0,0,113,130,0,0,0,130
2020,48001,Bagno a Ripoli,FI,15,128,0,0,0,128,141,0,0,0,141
2020,48001,Bagno a Ripoli,FI,16,121,0,0,0,121,118,0,0,0,118
2020,48001,Bagno a Ripoli,FI,17,125,0,0,0,125,127,0,0,0,127
2020,48001,Bagno a Ripoli,FI,18,144,0,0,0,144,126,0,0,0,126
2020,48001,Bagno a Ripoli,FI,19,112,0,0,0,112,114,0,0,0,114
2020,48001,Bagno a Ripoli,FI,20,129,0,0,0,129,108,2,0,0,110
2020,48001,Bagno a Ripoli,FI,21,128,1,0,0,129,105,2,0,0,107
2020,48001,Bagno a Ripoli,FI,22,103,0,0,0,103,92,3,0,0,95
2020,48001,Bagno a Ripoli,FI,23,103,0,0,0,103,119,2,0,0,121
2020,48001,Bagno a Ripoli,FI,24,99,2,0,0,101,104,2,0,0,106
2020,48001,Bagno a Ripoli,FI,25,113,1,0,0,114,110,9,0,0,120
2020,48001,Bagno a Ripoli,FI,26,96,0,0,0,96,100,2,0,0,102
2020,48001,Bagno a Ripoli,FI,27,108,5,0,0,113,89,8,0,0,98
2020,48001,Bagno a Ripoli,FI,28,99,4,0,0,103,103,18,0,0,121
2020,48001,Bagno a Ripoli,FI,29,87,15,0,0,102,94,11,0,0,105
2020,48001,Bagno a Ripoli,FI,30,96,11,0,0,107,70,31,1,0,102
2020,48001,Bagno a Ripoli,FI,31,90,20,0,0,111,83,24,0,0,107
2020,48001,Bagno a Ripoli,FI,32,109,21,0,0,130,79,41,3,0,124
2020,48001,Bagno a Ripoli,FI,33,76,24,1,0,101,88,42,2,0,132
2020,48001,Bagno a Ripoli,FI,34,74,24,5,0,104,72,46,0,1,120
2020,48001,Bagno a Ripoli,FI,35,61,31,0,0,92,64,50,3,0,117
2020,48001,Bagno a Ripoli,FI,36,87,29,1,0,117,59,52,1,0,112
2020,48001,Bagno a Ripoli,FI,37,73,37,2,0,112,63,69,3,0,135
2020,48001,Bagno a Ripoli,FI,38,81,61,2,0,144,56,57,2,0,116
2020,48001,Bagno a Ripoli,FI,39,70,43,1,0,115,60,67,1,0,128
2020,48001,Bagno a Ripoli,FI,40,68,52,4,0,124,45,65,4,0,114
2020,48001,Bagno a Ripoli,FI,41,67,71,2,0,141,64,76,4,1,145
2020,48001,Bagno a Ripoli,FI,42,49,75,1,1,126,68,94,3,1,167
2020,48001,Bagno a Ripoli,FI,43,81,67,3,0,151,58,94,11,1,165
2020,48001,Bagno a Ripoli,FI,44,68,73,8,0,149,63,96,8,3,170
2020,48001,Bagno a Ripoli,FI,45,73,98,7,0,178,49,114,7,0,170
2020,48001,Bagno a Ripoli,FI,46,66,108,12,0,186,53,120,9,2,184
2020,48001,Bagno a Ripoli,FI,47,68,106,9,0,183,77,145,18,1,241
2020,48001,Bagno a Ripoli,FI,48,71,136,8,2,218,59,117,11,2,189
2020,48001,Bagno a Ripoli,FI,49,51,121,11,0,184,53,152,15,2,222
2020,48001,Bagno a Ripoli,FI,50,64,131,15,1,211,52,140,12,5,209
2020,48001,Bagno a Ripoli,FI,51,62,117,14,2,195,60,151,14,3,229
2020,48001,Bagno a Ripoli,FI,52,45,126,19,1,193,57,126,16,3,202
2020,48001,Bagno a Ripoli,FI,53,47,119,10,0,176,39,154,20,2,215
2020,48001,Bagno a Ripoli,FI,54,53,134,22,1,210,38,152,32,8,230
2020,48001,Bagno a Ripoli,FI,55,41,149,15,1,206,48,135,26,6,215
2020,48001,Bagno a Ripoli,FI,56,48,154,18,2,223,24,153,20,8,205
2020,48001,Bagno a Ripoli,FI,57,37,126,10,2,175,31,134,17,9,191
2020,48001,Bagno a Ripoli,FI,58,31,112,13,0,156,22,142,17,6,187
2020,48001,Bagno a Ripoli,FI,59,32,124,10,4,171,28,127,22,10,187
2020,48001,Bagno a Ripoli,FI,60,17,126,8,0,152,24,131,15,12,182
2020,48001,Bagno a Ripoli,FI,61,22,129,13,1,165,17,133,8,13,171
2020,48001,Bagno a Ripoli,FI,62,20,123,18,1,162,14,147,19,9,189
2020,48001,Bagno a Ripoli,FI,63,20,113,13,4,150,11,121,19,13,164
2020,48001,Bagno a Ripoli,FI,64,13,118,5,6,142,13,128,13,15,169
2020,48001,Bagno a Ripoli,FI,65,8,115,8,2,133,13,127,15,18,173
2020,48001,Bagno a Ripoli,FI,66,14,111,11,6,142,12,134,10,7,163
2020,48001,Bagno a Ripoli,FI,67,19,119,11,7,156,11,135,13,22,181
2020,48001,Bagno a Ripoli,FI,68,9,119,8,4,140,6,113,11,23,153
2020,48001,Bagno a Ripoli,FI,69,14,141,7,7,169,5,122,13,26,166
2020,48001,Bagno a Ripoli,FI,70,11,121,12,16,160,5,123,9,31,168
2020,48001,Bagno a Ripoli,FI,71,12,115,6,9,142,8,143,3,38,192
2020,48001,Bagno a Ripoli,FI,72,9,144,8,13,174,6,153,16,36,211
2020,48001,Bagno a Ripoli,FI,73,6,155,4,7,172,2,161,16,35,214
2020,48001,Bagno a Ripoli,FI,74,8,150,7,10,175,4,134,12,55,205
2020,48001,Bagno a Ripoli,FI,75,6,113,7,8,135,6,108,6,33,153
2020,48001,Bagno a Ripoli,FI,76,8,115,2,13,138,8,103,4,49,164
2020,48001,Bagno a Ripoli,FI,77,6,130,5,23,164,7,95,7,36,145
2020,48001,Bagno a Ripoli,FI,78,5,101,6,11,123,3,78,5,39,125
2020,48001,Bagno a Ripoli,FI,79,7,117,1,22,147,5,89,8,60,162
2020,48001,Bagno a Ripoli,FI,80,3,112,3,18,136,7,94,5,81,187
2020,48001,Bagno a Ripoli,FI,81,6,112,2,18,138,8,85,3,76,172
2020,48001,Bagno a Ripoli,FI,82,3,96,2,15,116,4,84,2,67,157
2020,48001,Bagno a Ripoli,FI,83,4,79,2,20,105,3,59,3,90,155
2020,48001,Bagno a Ripoli,FI,84,1,66,1,16,84,4,43,2,85,134
2020,48001,Bagno a Ripoli,FI,85,4,54,3,12,73,6,38,3,83,130
2020,48001,Bagno a Ripoli,FI,86,5,56,2,13,76,3,29,3,62,97
2020,48001,Bagno a Ripoli,FI,87,3,53,1,23,80,1,19,0,70,90
2020,48001,Bagno a Ripoli,FI,88,2,35,0,12,49,7,14,1,63,85
2020,48001,Bagno a Ripoli,FI,89,2,26,0,15,43,2,11,2,57,72
2020,48001,Bagno a Ripoli,FI,90,0,21,1,19,41,3,4,0,65,72
2020,48001,Bagno a Ripoli,FI,91,1,22,1,13,37,4,3,0,43,50
2020,48001,Bagno a Ripoli,FI,92,1,14,0,10,25,3,6,0,56,65
2020,48001,Bagno a Ripoli,FI,93,2,11,1,6,20,2,4,0,41,47
2020,48001,Bagno a Ripoli,FI,94,0,8,0,6,14,3,3,0,34,40
2020,48001,Bagno a Ripoli,FI,95,0,4,0,9,13,4,3,0,22,29
2020,48001,Bagno a Ripoli,FI,96,1,2,0,2,5,2,2,1,14,19
2020,48001,Bagno a Ripoli,FI,97,0,0,0,3,3,0,1,0,14,15
2020,48001,Bagno a Ripoli,FI,98,0,1,0,1,2,1,0,0,15,16
2020,48001,Bagno a Ripoli,FI,99,0,0,0,1,1,1,0,0,6,7
2020,48001,Bagno a Ripoli,FI,100 e più,0,1,0,0,1,0,0,0,12,12
2020,48002,Barberino di Mugello,FI,0,32,0,0,0,32,32,0,0,0,32
2020,48002,Barberino di Mugello,FI,1,43,0,0,0,43,43,0,0,0,43
2020,48002,Barberino di Mugello,FI,2,43,0,0,0,43,51,0,0,0,51
2020,48002,Barberino di Mugello,FI,3,45,0,0,0,45,33,0,0,0,33
2020,48002,Barberino di Mugello,FI,4,54,0,0,0,54,49,0,0,0,49
2020,48002,Barberino di Mugello,FI,5,39,0,0,0,39,52,0,0,0,52
2020,48002,Barberino di Mugello,FI,6,44,0,0,0,44,55,0,0,0,55
2020,48002,Barberino di Mugello,FI,7,45,0,0,0,45,40,0,0,0,40
2020,48002,Barberino di Mugello,FI,8,50,0,0,0,50,44,0,0,0,44
2020,48002,Barberino di Mugello,FI,9,65,0,0,0,65,55,0,0,0,55
2020,48002,Barberino di Mugello,FI,10,54,0,0,0,54,46,0,0,0,46
2020,48002,Barberino di Mugello,FI,11,56,0,0,0,56,57,0,0,0,57
2020,48002,Barberino di Mugello,FI,12,51,0,0,0,51,67,0,0,0,67
2020,48002,Barberino di Mugello,FI,13,54,0,0,0,54,49,0,0,0,49
2020,48002,Barberino di Mugello,FI,14,54,0,0,0,54,42,0,0,0,42
2020,48002,Barberino di Mugello,FI,15,51,0,0,0,51,56,0,0,0,56
2020,48002,Barberino di Mugello,FI,16,69,0,0,0,69,38,0,0,0,38
2020,48002,Barberino di Mugello,FI,17,40,0,0,0,40,51,0,0,0,51
2020,48002,Barberino di Mugello,FI,18,50,0,0,0,50,47,0,0,0,47
2020,48002,Barberino di Mugello,FI,19,60,0,0,0,60,51,0,0,0,51
2020,48002,Barberino di Mugello,FI,20,47,0,0,0,47,41,1,0,0,42
2020,48002,Barberino di Mugello,FI,21,52,0,0,0,52,51,0,0,0,51
2020,48002,Barberino di Mugello,FI,22,66,0,0,0,66,46,4,0,0,50
2020,48002,Barberino di Mugello,FI,23,56,0,0,0,56,43,1,0,0,44
2020,48002,Barberino di Mugello,FI,24,59,0,0,0,59,58,2,0,0,60
2020,48002,Barberino di Mugello,FI,25,55,1,0,0,56,57,5,0,0,62
2020,48002,Barberino di Mugello,FI,26,53,1,0,0,54,49,9,0,0,58
2020,48002,Barberino di Mugello,FI,27,50,3,0,0,53,39,12,0,0,51
2020,48002,Barberino di Mugello,FI,28,59,4,0,0,63,41,15,0,0,56
2020,48002,Barberino di Mugello,FI,29,42,3,0,0,45,45,13,0,0,58
2020,48002,Barberino di Mugello,FI,30,55,10,0,0,65,38,19,0,0,57
2020,48002,Barberino di Mugello,FI,31,49,10,0,0,59,37,24,1,0,62
2020,48002,Barberino di Mugello,FI,32,55,17,0,0,72,31,24,0,0,55
2020,48002,Barberino di Mugello,FI,33,44,13,0,0,57,27,29,0,0,56
2020,48002,Barberino di Mugello,FI,34,36,24,0,0,60,33,21,0,0,54
2020,48002,Barberino di Mugello,FI,35,37,20,0,0,57,23,26,2,0,51
2020,48002,Barberino di Mugello,FI,36,28,28,0,0,56,21,34,2,0,57
2020,48002,Barberino di Mugello,FI,37,36,13,1,0,50,24,48,2,0,74
2020,48002,Barberino di Mugello,FI,38,31,29,2,0,62,27,33,2,0,62
2020,48002,Barberino di Mugello,FI,39,26,40,2,0,68,28,36,2,0,66
2020,48002,Barberino di Mugello,FI,40,36,24,1,0,61,14,23,1,0,38
2020,48002,Barberino di Mugello,FI,41,36,49,2,0,87,27,42,0,0,69
2020,48002,Barberino di Mugello,FI,42,27,39,2,0,68,36,50,6,1,93
2020,48002,Barberino di Mugello,FI,43,28,43,1,0,72,27,41,3,0,71
2020,48002,Barberino di Mugello,FI,44,34,44,3,2,83,22,36,3,0,61
2020,48002,Barberino di Mugello,FI,45,36,38,3,0,77,29,60,6,3,98
2020,48002,Barberino di Mugello,FI,46,29,51,3,0,83,34,54,5,3,96
2020,48002,Barberino di Mugello,FI,47,25,57,6,1,89,26,63,7,1,97
2020,48002,Barberino di Mugello,FI,48,31,65,6,0,102,25,53,2,2,82
2020,48002,Barberino di Mugello,FI,49,29,47,5,0,81,19,62,9,0,90
2020,48002,Barberino di Mugello,FI,50,36,50,5,0,91,22,62,7,2,93
2020,48002,Barberino di Mugello,FI,51,21,78,7,0,106,19,61,8,0,88
2020,48002,Barberino di Mugello,FI,52,24,69,5,0,98,14,66,10,0,90
2020,48002,Barberino di Mugello,FI,53,17,64,6,1,88,13,67,10,6,96
2020,48002,Barberino di Mugello,FI,54,31,54,7,0,92,8,67,8,4,87
2020,48002,Barberino di Mugello,FI,55,19,63,6,3,91,7,67,5,4,83
2020,48002,Barberino di Mugello,FI,56,14,57,5,0,76,14,74,2,6,96
2020,48002,Barberino di Mugello,FI,57,16,54,5,1,76,14,55,6,4,79
2020,48002,Barberino di Mugello,FI,58,19,62,7,0,88,3,52,6,3,64
2020,48002,Barberino di Mugello,FI,59,8,70,7,2,87,4,68,6,3,81
2020,48002,Barberino di Mugello,FI,60,10,59,7,2,78,10,54,7,3,74
2020,48002,Barberino di Mugello,FI,61,15,52,3,1,71,5,65,5,8,83
2020,48002,Barberino di Mugello,FI,62,7,51,2,1,61,3,50,5,2,60
2020,48002,Barberino di Mugello,FI,63,5,57,4,2,68,6,55,5,7,73
2020,48002,Barberino di Mugello,FI,64,5,60,5,3,73,2,56,2,4,64
2020,48002,Barberino di Mugello,FI,65,8,48,6,3,65,4,58,3,6,71
2020,48002,Barberino di Mugello,FI,66,6,73,3,1,83,0,51,8,9,68
2020,48002,Barberino di Mugello,FI,67,4,49,5,2,60,7,49,0,13,69
2020,48002,Barberino di Mugello,FI,68,7,52,3,1,63,4,43,3,9,59
2020,48002,Barberino di Mugello,FI,69,4,53,3,2,62,2,54,4,8,68
2020,48002,Barberino di Mugello,FI,70,4,49,2,6,61,5,34,3,12,54
2020,48002,Barberino di Mugello,FI,71,6,55,1,2,64,2,46,3,14,65
2020,48002,Barberino di Mugello,FI,72,6,48,5,3,62,1,51,2,24,78
2020,48002,Barberino di Mugello,FI,73,3,56,3,2,64,1,50,4,24,79
2020,48002,Barberino di Mugello,FI,74,2,46,1,2,51,3,48,0,14,65
2020,48002,Barberino di Mugello,FI,75,3,41,0,3,47,2,37,1,17,57
2020,48002,Barberino di Mugello,FI,76,3,33,2,4,42,2,31,1,10,44
2020,48002,Barberino di Mugello,FI,77,4,39,1,9,53,1,34,2,24,61
2020,48002,Barberino di Mugello,FI,78,4,42,1,1,48,0,21,0,20,41
2020,48002,Barberino di Mugello,FI,79,2,29,1,2,34,1,23,0,21,45
2020,48002,Barberino di Mugello,FI,80,2,42,0,11,55,1,29,1,20,51
2020,48002,Barberino di Mugello,FI,81,2,26,1,5,34,2,17,2,31,52
2020,48002,Barberino di Mugello,FI,82,1,26,0,3,30,1,25,2,25,53
2020,48002,Barberino di Mugello,FI,83,0,26,1,9,36,0,19,1,28,48
2020,48002,Barberino di Mugello,FI,84,0,12,0,3,15,0,8,0,24,32
2020,48002,Barberino di Mugello,FI,85,2,16,0,4,22,1,11,0,23,35
2020,48002,Barberino di Mugello,FI,86,0,12,1,6,19,0,9,1,16,26
2020,48002,Barberino di Mugello,FI,87,3,21,0,7,31,1,1,0,17,19
2020,48002,Barberino di Mugello,FI,88,0,13,0,7,20,0,3,0,17,20
2020,48002,Barberino di Mugello,FI,89,1,7,0,4,12,0,1,0,19,20
2020,48002,Barberino di Mugello,FI,90,0,7,0,2,9,1,6,0,16,23
2020,48002,Barberino di Mugello,FI,91,0,4,0,2,6,2,1,0,23,26
2020,48002,Barberino di Mugello,FI,92,0,9,0,4,13,1,3,0,14,18
2020,48002,Barberino di Mugello,FI,93,0,2,0,4,6,2,0,0,7,9
2020,48002,Barberino di Mugello,FI,94,0,4,0,0,4,0,0,0,11,11
2020,48002,Barberino di Mugello,FI,95,1,0,1,3,5,1,0,0,8,9
2020,48002,Barberino di Mugello,FI,96,0,0,0,3,3,0,0,0,8,8
2020,48002,Barberino di Mugello,FI,97,0,0,0,0,0,1,0,0,5,6
2020,48002,Barberino di Mugello,FI,98,0,0,0,2,2,1,0,0,0,1
2020,48002,Barberino di Mugello,FI,99,0,0,0,0,0,0,0,0,3,3
2020,48002,Barberino di Mugello,FI,100 e più,0,0,0,0,0,1,0,0,1,2
2020,48004,Borgo San Lorenzo,FI,0,63,0,0,0,63,62,0,0,0,62
2020,48004,Borgo San Lorenzo,FI,1,55,0,0,0,55,56,0,0,0,56
2020,48004,Borgo San Lorenzo,FI,2,73,0,0,0,73,69,0,0,0,69
2020,48004,Borgo San Lorenzo,FI,3,84,0,0,0,84,57,0,0,0,57
2020,48004,Borgo San Lorenzo,FI,4,81,0,0,0,81,69,0,0,0,69
2020,48004,Borgo San Lorenzo,FI,5,76,0,0,0,76,66,0,0,0,66
2020,48004,Borgo San Lorenzo,FI,6,93,0,0,0,93,81,0,0,0,81
2020,48004,Borgo San Lorenzo,FI,7,80,0,0,0,80,78,0,0,0,78
2020,48004,Borgo San Lorenzo,FI,8,85,0,0,0,85,70,0,0,0,70
2020,48004,Borgo San Lorenzo,FI,9,81,0,0,0,81,82,0,0,0,82
2020,48004,Borgo San Lorenzo,FI,10,95,0,0,0,95,82,0,0,0,82
2020,48004,Borgo San Lorenzo,FI,11,83,0,0,0,83,104,0,0,0,104
2020,48004,Borgo San Lorenzo,FI,12,93,0,0,0,93,94,0,0,0,94
2020,48004,Borgo San Lorenzo,FI,13,97,0,0,0,97,84,0,0,0,84
2020,48004,Borgo San Lorenzo,FI,14,72,0,0,0,72,95,0,0,0,95
2020,48004,Borgo San Lorenzo,FI,15,81,0,0,0,81,74,0,0,0,74
2020,48004,Borgo San Lorenzo,FI,16,88,0,0,0,88,92,0,0,0,92
2020,48004,Borgo San Lorenzo,FI,17,87,0,0,0,87,87,0,0,0,87
2020,48004,Borgo San Lorenzo,FI,18,83,0,0,0,83,93,1,0,0,94
2020,48004,Borgo San Lorenzo,FI,19,81,0,0,0,81,80,0,0,0,80
2020,48004,Borgo San Lorenzo,FI,20,103,0,0,0,103,86,3,0,0,89
2020,48004,Borgo San Lorenzo,FI,21,94,0,0,0,94,87,2,0,0,89
2020,48004,Borgo San Lorenzo,FI,22,93,1,0,0,94,90,2,0,0,92
2020,48004,Borgo San Lorenzo,FI,23,100,1,0,0,101,91,2,0,0,93
2020,48004,Borgo San Lorenzo,FI,24,92,2,0,0,94,77,7,0,0,84
2020,48004,Borgo San Lorenzo,FI,25,115,1,0,0,116,84,4,0,0,88
2020,48004,Borgo San Lorenzo,FI,26,94,4,0,0,98,94,6,0,0,100
2020,48004,Borgo San Lorenzo,FI,27,76,2,0,0,78,71,15,0,0,86
2020,48004,Borgo San Lorenzo,FI,28,84,8,0,0,92,79,14,0,0,93
2020,48004,Borgo San Lorenzo,FI,29,85,13,0,0,98,78,19,0,0,97
2020,48004,Borgo San Lorenzo,FI,30,99,7,0,0,106,62,24,0,0,86
2020,48004,Borgo San Lorenzo,FI,31,90,17,0,0,107,51,27,0,0,78
2020,48004,Borgo San Lorenzo,FI,32,75,19,0,0,94,65,28,0,0,93
2020,48004,Borgo San Lorenzo,FI,33,73,20,0,0,93,62,28,1,0,91
2020,48004,Borgo San Lorenzo,FI,34,51,31,0,0,82,60,37,2,0,99
2020,48004,Borgo San Lorenzo,FI,35,56,25,1,0,82,58,43,1,2,104
2020,48004,Borgo San Lorenzo,FI,36,79,29,2,1,111,54,46,2,0,102
2020,48004,Borgo San Lorenzo,FI,37,49,38,1,0,88,47,49,2,0,98
2020,48004,Borgo San Lorenzo,FI,38,55,54,4,0,113,37,57,3,1,98
2020,48004,Borgo San Lorenzo,FI,39,56,43,2,0,101,40,49,4,0,93
2020,48004,Borgo San Lorenzo,FI,40,33,49,2,0,84,39,66,3,1,109
2020,48004,Borgo San Lorenzo,FI,41,51,49,2,0,102,40,65,5,2,112
2020,48004,Borgo San Lorenzo,FI,42,62,71,0,0,133,40,79,6,1,126
2020,48004,Borgo San Lorenzo,FI,43,47,71,6,1,125,38,71,3,0,112
2020,48004,Borgo San Lorenzo,FI,44,51,55,1,0,107,34,83,8,3,128
2020,48004,Borgo San Lorenzo,FI,45,56,81,9,0,146,46,70,12,0,128
2020,48004,Borgo San Lorenzo,FI,46,66,70,4,0,140,41,101,13,1,156
2020,48004,Borgo San Lorenzo,FI,47,56,83,2,0,141,34,91,12,2,139
2020,48004,Borgo San Lorenzo,FI,48,40,91,5,0,136,30,93,11,0,134
2020,48004,Borgo San Lorenzo,FI,49,50,72,8,1,131,17,91,7,2,117
2020,48004,Borgo San Lorenzo,FI,50,34,73,5,3,115,27,103,13,4,147
2020,48004,Borgo San Lorenzo,FI,51,38,102,9,2,151,25,100,14,4,143
2020,48004,Borgo San Lorenzo,FI,52,29,111,7,0,147,18,92,18,8,136
2020,48004,Borgo San Lorenzo,FI,53,37,101,10,0,148,17,126,19,7,169
2020,48004,Borgo San Lorenzo,FI,54,25,100,12,1,138,22,103,11,5,141
2020,48004,Borgo San Lorenzo,FI,55,27,108,8,2,145,16,128,14,5,163
2020,48004,Borgo San Lorenzo,FI,56,24,101,14,1,140,27,127,14,6,174
2020,48004,Borgo San Lorenzo,FI,57,28,100,9,0,137,11,101,8,11,131
2020,48004,Borgo San Lorenzo,FI,58,18,104,7,4,133,18,91,9,5,123
2020,48004,Borgo San Lorenzo,FI,59,17,98,9,1,125,15,125,14,9,163
2020,48004,Borgo San Lorenzo,FI,60,16,116,12,3,147,17,94,8,3,122
2020,48004,Borgo San Lorenzo,FI,61,13,117,9,1,140,14,107,15,10,146
2020,48004,Borgo San Lorenzo,FI,62,17,89,5,1,112,4,94,12,14,124
2020,48004,Borgo San Lorenzo,FI,63,16,108,8,3,135,5,94,8,11,118
2020,48004,Borgo San Lorenzo,FI,64,9,81,5,1,96,12,97,10,8,127
2020,48004,Borgo San Lorenzo,FI,65,10,98,6,2,116,11,78,10,13,112
2020,48004,Borgo San Lorenzo,FI,66,16,101,3,3,123,3,92,10,12,117
2020,48004,Borgo San Lorenzo,FI,67,12,88,6,5,111,1,95,4,13,113
2020,48004,Borgo San Lorenzo,FI,68,4,91,13,6,114,6,91,5,19,121
2020,48004,Borgo San Lorenzo,FI,69,11,79,3,6,99,6,90,3,16,115
2020,48004,Borgo San Lorenzo,FI,70,14,85,7,5,111,4,83,5,24,116
2020,48004,Borgo San Lorenzo,FI,71,5,86,6,3,100,5,80,6,25,116
2020,48004,Borgo San Lorenzo,FI,72,9,109,3,3,124,5,87,5,25,122
2020,48004,Borgo San Lorenzo,FI,73,6,93,4,6,109,10,71,8,26,115
2020,48004,Borgo San Lorenzo,FI,74,7,80,4,8,99,6,71,6,48,131
2020,48004,Borgo San Lorenzo,FI,75,6,87,1,5,99,4,61,3,34,102
2020,48004,Borgo San Lorenzo,FI,76,4,71,1,5,81,5,46,0,34,85
2020,48004,Borgo San Lorenzo,FI,77,1,64,1,6,72,1,49,1,37,88
2020,48004,Borgo San Lorenzo,FI,78,4,48,2,5,59,5,38,0,36,79
2020,48004,Borgo San Lorenzo,FI,79,6,67,2,8,83,2,41,1,43,87
2020,48004,Borgo San Lorenzo,FI,80,12,53,2,9,76,2,41,2,55,100
2020,48004,Borgo San Lorenzo,FI,81,8,39,1,10,58,1,45,1,47,94
2020,48004,Borgo San Lorenzo,FI,82,5,47,2,14,68,2,22,1,52,77
2020,48004,Borgo San Lorenzo,FI,83,1,33,1,8,43,1,29,1,46,77
2020,48004,Borgo San Lorenzo,FI,84,10,33,0,6,49,2,21,2,32,57
2020,48004,Borgo San Lorenzo,FI,85,4,26,0,12,42,3,17,0,46,66
2020,48004,Borgo San Lorenzo,FI,86,3,21,0,9,33,4,11,1,44,60
2020,48004,Borgo San Lorenzo,FI,87,2,19,0,4,25,3,8,0,47,58
2020,48004,Borgo San Lorenzo,FI,88,2,15,1,12,30,3,8,0,46,57
2020,48004,Borgo San Lorenzo,FI,89,2,17,0,7,26,3,2,2,49,56
2020,48004,Borgo San Lorenzo,FI,90,0,8,0,11,19,1,4,0,46,51
2020,48004,Borgo San Lorenzo,FI,91,0,11,0,5,16,2,4,0,31,37
2020,48004,Borgo San Lorenzo,FI,92,0,9,0,3,12,0,2,0,22,24
2020,48004,Borgo San Lorenzo,FI,93,0,8,0,6,14,2,2,0,22,26
2020,48004,Borgo San Lorenzo,FI,94,0,2,0,3,5,0,2,0,21,23
2020,48004,Borgo San Lorenzo,FI,95,0,2,0,0,2,0,0,0,12,12
2020,48004,Borgo San Lorenzo,FI,96,0,0,0,0,0,0,1,0,17,18
2020,48004,Borgo San Lorenzo,FI,97,0,1,0,1,2,0,0,0,7,7
2020,48004,Borgo San Lorenzo,FI,98,0,1,0,0,1,0,0,0,6,6
2020,48004,Borgo San Lorenzo,FI,99,0,1,0,0,1,0,0,0,4,4
2020,48004,Borgo San Lorenzo,FI,100 e più,0,0,0,0,0,1,1,0,7,9
2020,48005,Calenzano,FI,0,65,0,0,0,65,66,0,0,0,66
2020,48005,Calenzano,FI,1,65,0,0,0,65,65,0,0,0,65
2020,48005,Calenzano,FI,2,86,0,0,0,86,77,0,0,0,77
2020,48005,Calenzano,FI,3,71,0,0,0,71,82,0,0,0,82
2020,48005,Calenzano,FI,4,77,0,0,0,77,74,0,0,0,74
2020,48005,Calenzano,FI,5,90,0,0,0,90,89,0,0,0,89
2020,48005,Calenzano,FI,6,84,0,0,0,84,75,0,0,0,75
2020,48005,Calenzano,FI,7,76,0,0,0,76,88,0,0,0,88
2020,48005,Calenzano,FI,8,89,0,0,0,89,87,0,0,0,87
2020,48005,Calenzano,FI,9,89,0,0,0,89,86,0,0,0,86
2020,48005,Calenzano,FI,10,103,0,0,0,103,66,0,0,0,66
2020,48005,Calenzano,FI,11,84,0,0,0,84,89,0,0,0,89
2020,48005,Calenzano,FI,12,92,0,0,0,92,78,0,0,0,78
2020,48005,Calenzano,FI,13,89,0,0,0,89,99,0,0,0,99
2020,48005,Calenzano,FI,14,92,0,0,0,92,67,0,0,0,67
2020,48005,Calenzano,FI,15,95,0,0,0,95,79,0,0,0,79
2020,48005,Calenzano,FI,16,89,0,0,0,89,90,0,0,0,90
2020,48005,Calenzano,FI,17,79,0,0,0,79,91,0,0,0,91
2020,48005,Calenzano,FI,18,86,0,0,0,86,66,1,0,0,67
2020,48005,Calenzano,FI,19,77,0,0,0,77,60,0,0,0,60
2020,48005,Calenzano,FI,20,64,0,0,0,64,72,0,0,0,72
2020,48005,Calenzano,FI,21,76,0,0,0,76,76,1,0,0,77
2020,48005,Calenzano,FI,22,97,3,0,0,100,66,2,0,0,68
2020,48005,Calenzano,FI,23,84,1,0,0,85,82,5,0,0,87
2020,48005,Calenzano,FI,24,82,0,0,0,82,69,4,0,0,73
2020,48005,Calenzano,FI,25,89,1,0,0,90,64,5,0,0,69
2020,48005,Calenzano,FI,26,81,1,0,0,82,63,3,1,0,67
2020,48005,Calenzano,FI,27,76,1,0,0,77,80,5,0,0,85
2020,48005,Calenzano,FI,28,85,8,0,0,93,81,10,0,0,91
2020,48005,Calenzano,FI,29,108,9,0,0,117,72,20,0,0,92
2020,48005,Calenzano,FI,30,92,10,0,0,102,58,17,1,0,76
2020,48005,Calenzano,FI,31,66,19,0,0,85,62,24,2,0,88
2020,48005,Calenzano,FI,32,76,21,0,0,97,62,37,1,0,100
2020,48005,Calenzano,FI,33,68,20,0,0,88,56,34,0,0,90
2020,48005,Calenzano,FI,34,74,28,0,0,102,54,47,2,0,103
2020,48005,Calenzano,FI,35,79,44,1,0,124,67,47,0,0,114
2020,48005,Calenzano,FI,36,63,42,0,0,105,44,55,3,0,102
2020,48005,Calenzano,FI,37,71,50,0,0,121,57,69,3,0,129
2020,48005,Calenzano,FI,38,59,43,3,1,106,46,57,2,0,105
2020,48005,Calenzano,FI,39,69,62,2,0,133,59,76,6,0,141
2020,48005,Calenzano,FI,40,55,64,8,0,127,45,67,3,0,115
2020,48005,Calenzano,FI,41,58,69,4,0,131,48,60,5,0,113
2020,48005,Calenzano,FI,42,68,63,3,1,135,38,84,5,0,127
2020,48005,Calenzano,FI,43,68,78,4,1,151,43,87,6,0,136
2020,48005,Calenzano,FI,44,58,85,6,0,149,46,82,10,1,139
2020,48005,Calenzano,FI,45,43,83,5,1,132,49,99,8,2,158
2020,48005,Calenzano,FI,46,66,98,5,0,169,52,92,9,1,154
2020,48005,Calenzano,FI,47,74,86,5,1,166,50,118,14,1,183
2020,48005,Calenzano,FI,48,57,112,13,1,183,38,103,11,3,155
2020,48005,Calenzano,FI,49,49,113,14,0,176,31,106,17,0,154
2020,48005,Calenzano,FI,50,38,97,12,1,148,39,84,11,2,136
2020,48005,Calenzano,FI,51,61,98,22,0,181,32,85,15,3,135
2020,48005,Calenzano,FI,52,34,79,9,2,124,36,95,24,2,157
2020,48005,Calenzano,FI,53,35,99,9,0,143,31,97,11,8,147
2020,48005,Calenzano,FI,54,29,89,12,3,133,16,100,7,5,128
2020,48005,Calenzano,FI,55,42,95,13,0,150,12,120,15,7,154
2020,48005,Calenzano,FI,56,27,113,10,3,153,16,100,14,2,132
2020,48005,Calenzano,FI,57,23,100,17,1,141,18,101,10,3,132
2020,48005,Calenzano,FI,58,19,93,5,2,119,6,98,10,6,120
2020,48005,Calenzano,FI,59,12,95,15,1,123,10,90,11,13,124
2020,48005,Calenzano,FI,60,10,109,9,1,129,10,99,9,8,126
2020,48005,Calenzano,FI,61,11,98,10,2,121,8,112,5,16,141
2020,48005,Calenzano,FI,62,15,71,5,1,92,9,94,9,11,123
2020,48005,Calenzano,FI,63,11,96,4,3,114,6,93,6,9,114
2020,48005,Calenzano,FI,64,9,97,10,4,120,6,92,14,11,123
2020,48005,Calenzano,FI,65,0,91,8,2,101,3,87,5,13,108
2020,48005,Calenzano,FI,66,9,66,5,5,85,5,88,8,10,111
2020,48005,Calenzano,FI,67,1,88,3,1,93,2,87,12,13,114
2020,48005,Calenzano,FI,68,7,94,3,1,105,4,85,3,15,107
2020,48005,Calenzano,FI,69,3,82,2,3,90,3,90,6,23,122
2020,48005,Calenzano,FI,70,3,94,4,3,104,6,86,6,17,115
2020,48005,Calenzano,FI,71,4,98,2,6,110,6,82,3,26,117
2020,48005,Calenzano,FI,72,7,82,5,6,100,2,87,5,28,122
2020,48005,Calenzano,FI,73,6,93,3,13,115,1,83,4,25,113
2020,48005,Calenzano,FI,74,7,109,1,12,129,3,78,2,31,114
2020,48005,Calenzano,FI,75,3,70,2,6,81,5,67,2,27,101
2020,48005,Calenzano,FI,76,4,68,3,12,87,1,54,9,26,90
2020,48005,Calenzano,FI,77,1,64,0,6,71,0,48,2,39,89
2020,48005,Calenzano,FI,78,2,63,2,8,75,3,55,1,25,84
2020,48005,Calenzano,FI,79,6,54,2,8,70,3,47,1,24,75
2020,48005,Calenzano,FI,80,5,64,1,5,75,2,62,6,33,103
2020,48005,Calenzano,FI,81,3,61,1,16,81,1,43,5,42,91
2020,48005,Calenzano,FI,82,4,60,0,11,75,1,38,0,54,93
2020,48005,Calenzano,FI,83,4,44,2,11,61,2,35,3,45,85
2020,48005,Calenzano,FI,84,2,33,2,2,39,3,22,1,42,68
2020,48005,Calenzano,FI,85,3,34,0,8,45,1,15,1,38,55
2020,48005,Calenzano,FI,86,2,34,0,11,47,2,11,5,54,72
2020,48005,Calenzano,FI,87,2,27,0,9,38,3,10,1,29,43
2020,48005,Calenzano,FI,88,3,28,0,10,41,1,11,0,36,48
2020,48005,Calenzano,FI,89,0,17,0,6,23,4,7,0,34,45
2020,48005,Calenzano,FI,90,2,15,0,7,24,0,7,0,37,44
2020,48005,Calenzano,FI,91,1,7,0,11,19,2,3,0,22,27
2020,48005,Calenzano,FI,92,0,9,0,6,15,0,6,0,18,24
2020,48005,Calenzano,FI,93,2,5,0,3,10,0,0,0,17,17
2020,48005,Calenzano,FI,94,1,2,0,6,9,1,1,0,11,13
2020,48005,Calenzano,FI,95,0,2,0,2,4,1,0,0,11,12
2020,48005,Calenzano,FI,96,1,0,0,1,2,1,0,0,6,7
2020,48005,Calenzano,FI,97,0,0,0,0,0,0,0,0,6,6
2020,48005,Calenzano,FI,98,0,1,0,0,1,0,0,0,5,5
2020,48005,Calenzano,FI,99,0,0,0,1,1,0,0,0,5,5
2020,48005,Calenzano,FI,100 e più,0,1,0,1,2,0,0,0,0,0
2020,48006,Campi Bisenzio,FI,0,198,0,0,0,198,145,0,0,0,145
2020,48006,Campi Bisenzio,FI,1,183,0,0,0,183,177,0,0,0,177
2020,48006,Campi Bisenzio,FI,2,206,0,0,0,206,187,0,0,0,187
2020,48006,Campi Bisenzio,FI,3,213,0,0,0,213,194,0,0,0,194
2020,48006,Campi Bisenzio,FI,4,238,0,0,0,238,206,0,0,0,206
2020,48006,Campi Bisenzio,FI,5,223,0,0,0,223,185,0,0,0,185
2020,48006,Campi Bisenzio,FI,6,230,0,0,0,230,230,0,0,0,230
2020,48006,Campi Bisenzio,FI,7,237,0,0,0,237,212,0,0,0,212
2020,48006,Campi Bisenzio,FI,8,268,0,0,0,268,266,0,0,0,266
2020,48006,Campi Bisenzio,FI,9,245,0,0,0,245,275,0,0,0,275
2020,48006,Campi Bisenzio,FI,10,248,0,0,0,248,224,0,0,0,224
2020,48006,Campi Bisenzio,FI,11,298,0,0,0,298,205,0,0,0,205
2020,48006,Campi Bisenzio,FI,12,302,0,0,0,302,250,0,0,0,250
2020,48006,Campi Bisenzio,FI,13,253,0,0,0,253,243,0,0,0,243
2020,48006,Campi Bisenzio,FI,14,262,0,0,0,262,222,0,0,0,222
2020,48006,Campi Bisenzio,FI,15,255,0,0,0,255,259,0,0,0,259
2020,48006,Campi Bisenzio,FI,16,280,0,0,0,280,201,0,0,0,201
2020,48006,Campi Bisenzio,FI,17,261,0,0,0,261,255,0,0,0,255
2020,48006,Campi Bisenzio,FI,18,263,0,0,0,263,274,1,0,0,275
2020,48006,Campi Bisenzio,FI,19,247,0,0,0,247,221,0,0,0,221
2020,48006,Campi Bisenzio,FI,20,288,0,0,0,288,238,1,0,0,239
2020,48006,Campi Bisenzio,FI,21,242,2,0,0,244,198,5,0,0,203
2020,48006,Campi Bisenzio,FI,22,254,0,0,0,254,202,7,0,0,209
2020,48006,Campi Bisenzio,FI,23,232,0,0,0,232,221,3,0,0,224
2020,48006,Campi Bisenzio,FI,24,247,4,0,0,251,199,13,0,0,212
2020,48006,Campi Bisenzio,FI,25,216,8,0,0,224,184,28,1,0,213
2020,48006,Campi Bisenzio,FI,26,206,9,0,0,215,200,35,0,0,235
2020,48006,Campi Bisenzio,FI,27,246,7,0,0,253,192,36,1,0,229
2020,48006,Campi Bisenzio,FI,28,247,15,0,0,262,180,49,0,0,229
2020,48006,Campi Bisenzio,FI,29,224,33,0,0,258,174,59,0,1,234
2020,48006,Campi Bisenzio,FI,30,236,42,0,0,278,186,84,1,0,271
2020,48006,Campi Bisenzio,FI,31,216,63,2,2,283,184,107,3,0,294
2020,48006,Campi Bisenzio,FI,32,222,77,2,0,302,168,109,0,0,277
2020,48006,Campi Bisenzio,FI,33,205,96,1,0,302,158,114,5,0,277
2020,48006,Campi Bisenzio,FI,34,163,112,1,0,276,153,128,4,0,286
2020,48006,Campi Bisenzio,FI,35,179,96,5,0,281,121,144,9,0,274
2020,48006,Campi Bisenzio,FI,36,186,132,5,0,323,115,155,8,1,279
2020,48006,Campi Bisenzio,FI,37,176,143,5,0,324,137,190,11,3,341
2020,48006,Campi Bisenzio,FI,38,164,166,4,0,334,131,171,7,1,310
2020,48006,Campi Bisenzio,FI,39,156,161,5,0,322,95,190,15,1,303
2020,48006,Campi Bisenzio,FI,40,145,144,7,0,296,112,192,7,3,314
2020,48006,Campi Bisenzio,FI,41,140,202,14,0,356,101,217,18,2,338
2020,48006,Campi Bisenzio,FI,42,108,207,3,0,319,114,247,26,3,390
2020,48006,Campi Bisenzio,FI,43,175,222,14,0,411,80,249,18,4,351
2020,48006,Campi Bisenzio,FI,44,147,218,14,2,381,112,248,24,2,386
2020,48006,Campi Bisenzio,FI,45,149,226,17,1,394,128,251,24,8,411
2020,48006,Campi Bisenzio,FI,46,166,265,16,2,450,87,325,24,3,439
2020,48006,Campi Bisenzio,FI,47,133,293,8,0,434,109,289,35,3,436
2020,48006,Campi Bisenzio,FI,48,127,324,22,1,474,86,316,28,6,436
2020,48006,Campi Bisenzio,FI,49,119,306,23,2,450,76,314,44,4,439
2020,48006,Campi Bisenzio,FI,50,96,280,32,2,411,89,327,31,6,453
2020,48006,Campi Bisenzio,FI,51,105,328,32,1,466,67,297,31,12,407
2020,48006,Campi Bisenzio,FI,52,102,264,37,1,405,59,275,30,8,372
2020,48006,Campi Bisenzio,FI,53,89,276,26,3,395,51,281,43,10,385
2020,48006,Campi Bisenzio,FI,54,75,326,30,1,432,43,272,35,11,361
2020,48006,Campi Bisenzio,FI,55,75,290,36,5,407,69,259,37,6,371
2020,48006,Campi Bisenzio,FI,56,64,265,27,5,362,49,271,24,12,356
2020,48006,Campi Bisenzio,FI,57,46,256,29,3,334,28,291,39,7,365
2020,48006,Campi Bisenzio,FI,58,37,236,20,4,298,28,259,17,17,321
2020,48006,Campi Bisenzio,FI,59,35,241,19,2,298,33,191,19,21,264
2020,48006,Campi Bisenzio,FI,60,34,224,32,7,297,23,207,22,16,268
2020,48006,Campi Bisenzio,FI,61,22,211,17,3,253,19,205,32,20,276
2020,48006,Campi Bisenzio,FI,62,28,185,16,5,235,19,224,21,17,281
2020,48006,Campi Bisenzio,FI,63,17,201,21,4,244,15,190,24,20,249
2020,48006,Campi Bisenzio,FI,64,20,212,15,10,258,11,194,11,22,238
2020,48006,Campi Bisenzio,FI,65,15,186,14,6,221,16,200,15,22,253
2020,48006,Campi Bisenzio,FI,66,21,198,14,6,239,13,198,13,34,258
2020,48006,Campi Bisenzio,FI,67,7,198,13,7,225,9,183,15,36,243
2020,48006,Campi Bisenzio,FI,68,10,192,9,7,218,11,182,13,38,244
2020,48006,Campi Bisenzio,FI,69,15,189,15,6,225,11,186,7,41,245
2020,48006,Campi Bisenzio,FI,70,13,172,7,8,200,8,196,14,54,272
2020,48006,Campi Bisenzio,FI,71,17,198,9,9,233,7,209,6,45,267
2020,48006,Campi Bisenzio,FI,72,8,205,5,22,240,8,197,14,78,297
2020,48006,Campi Bisenzio,FI,73,19,202,10,7,238,14,198,5,75,292
2020,48006,Campi Bisenzio,FI,74,5,207,13,14,239,5,179,8,70,262
2020,48006,Campi Bisenzio,FI,75,6,173,6,16,201,9,122,11,78,220
2020,48006,Campi Bisenzio,FI,76,8,167,5,20,200,10,109,4,78,201
2020,48006,Campi Bisenzio,FI,77,7,137,2,16,162,4,148,6,74,232
2020,48006,Campi Bisenzio,FI,78,6,147,0,14,167,12,107,5,78,202
2020,48006,Campi Bisenzio,FI,79,11,116,4,17,148,10,98,9,74,191
2020,48006,Campi Bisenzio,FI,80,8,134,2,20,164,5,106,8,111,230
2020,48006,Campi Bisenzio,FI,81,4,121,2,21,148,11,84,4,89,188
2020,48006,Campi Bisenzio,FI,82,7,121,1,31,160,13,81,3,92,189
2020,48006,Campi Bisenzio,FI,83,3,93,1,18,115,10,61,4,97,172
2020,48006,Campi Bisenzio,FI,84,6,81,0,23,110,17,60,0,80,157
2020,48006,Campi Bisenzio,FI,85,4,72,1,20,97,10,43,3,92,148
2020,48006,Campi Bisenzio,FI,86,2,55,1,5,63,10,26,1,86,123
2020,48006,Campi Bisenzio,FI,87,3,53,1,15,72,9,22,0,82,113
2020,48006,Campi Bisenzio,FI,88,3,42,0,17,62,12,9,1,89,111
2020,48006,Campi Bisenzio,FI,89,2,35,1,11,49,3,9,0,69,81
2020,48006,Campi Bisenzio,FI,90,2,20,1,15,38,5,7,1,70,83
2020,48006,Campi Bisenzio,FI,91,0,23,0,11,34,5,9,2,54,70
2020,48006,Campi Bisenzio,FI,92,0,17,0,9,26,6,3,0,52,61
2020,48006,Campi Bisenzio,FI,93,0,12,0,9,21,6,4,1,34,45
2020,48006,Campi Bisenzio,FI,94,0,6,0,1,7,4,0,0,27,31
2020,48006,Campi Bisenzio,FI,95,1,0,0,2,3,4,2,0,18,24
2020,48006,Campi Bisenzio,FI,96,0,2,0,3,5,4,1,0,17,22
2020,48006,Campi Bisenzio,FI,97,1,0,0,1,2,2,0,0,22,24
2020,48006,Campi Bisenzio,FI,98,0,1,0,4,5,1,0,0,10,11
2020,48006,Campi Bisenzio,FI,99,0,1,0,1,2,1,1,0,5,7
2020,48006,Campi Bisenzio,FI,100 e più,0,0,0,1,1,1,0,0,7,8
2020,48008,Capraia e Limite,FI,0,22,0,0,0,22,27,0,0,0,27
2020,48008,Capraia e Limite,FI,1,33,0,0,0,33,28,0,0,0,28
2020,48008,Capraia e Limite,FI,2,29,0,0,0,29,30,0,0,0,30
2020,48008,Capraia e Limite,FI,3,25,0,0,0,25,35,0,0,0,35
2020,48008,Capraia e Limite,FI,4,39,0,0,0,39,32,0,0,0,32
2020,48008,Capraia e Limite,FI,5,32,0,0,0,32,28,0,0,0,28
2020,48008,Capraia e Limite,FI,6,47,0,0,0,47,45,0,0,0,45
2020,48008,Capraia e Limite,FI,7,44,0,0,0,44,41,0,0,0,41
2020,48008,Capraia e Limite,FI,8,40,0,0,0,40,43,0,0,0,43
2020,48008,Capraia e Limite,FI,9,48,0,0,0,48,37,0,0,0,37
2020,48008,Capraia e Limite,FI,10,47,0,0,0,47,41,0,0,0,41
2020,48008,Capraia e Limite,FI,11,49,0,0,0,49,34,0,0,0,34
2020,48008,Capraia e Limite,FI,12,44,0,0,0,44,41,0,0,0,41
2020,48008,Capraia e Limite,FI,13,47,0,0,0,47,33,0,0,0,33
2020,48008,Capraia e Limite,FI,14,36,0,0,0,36,48,0,0,0,48
2020,48008,Capraia e Limite,FI,15,48,0,0,0,48,46,0,0,0,46
2020,48008,Capraia e Limite,FI,16,31,0,0,0,31,29,0,0,0,29
2020,48008,Capraia e Limite,FI,17,41,0,0,0,41,36,0,0,0,36
2020,48008,Capraia e Limite,FI,18,38,0,0,0,38,21,0,0,0,21
2020,48008,Capraia e Limite,FI,19,46,0,0,0,46,36,0,0,0,36
2020,48008,Capraia e Limite,FI,20,37,0,0,0,37,37,1,0,0,38
2020,48008,Capraia e Limite,FI,21,38,0,0,0,38,30,0,0,0,30
2020,48008,Capraia e Limite,FI,22,34,0,0,0,34,31,1,0,0,32
2020,48008,Capraia e Limite,FI,23,41,0,0,0,41,23,3,0,0,26
2020,48008,Capraia e Limite,FI,24,41,0,0,0,41,26,1,0,0,27
2020,48008,Capraia e Limite,FI,25,34,0,0,0,34,29,4,0,0,33
2020,48008,Capraia e Limite,FI,26,38,0,0,0,38,26,1,0,0,27
2020,48008,Capraia e Limite,FI,27,36,2,0,0,38,30,5,1,0,36
2020,48008,Capraia e Limite,FI,28,36,4,0,0,40,35,9,0,0,44
2020,48008,Capraia e Limite,FI,29,38,3,0,0,41,28,7,0,0,35
2020,48008,Capraia e Limite,FI,30,36,9,0,0,45,29,10,0,0,39
2020,48008,Capraia e Limite,FI,31,33,8,0,0,41,31,10,1,0,42
2020,48008,Capraia e Limite,FI,32,32,5,0,0,37,24,22,0,0,46
2020,48008,Capraia e Limite,FI,33,31,16,0,0,47,38,13,1,0,52
2020,48008,Capraia e Limite,FI,34,27,8,0,0,35,18,21,1,0,40
2020,48008,Capraia e Limite,FI,35,23,11,0,0,34,17,31,0,0,48
2020,48008,Capraia e Limite,FI,36,24,19,0,0,43,30,34,0,1,65
2020,48008,Capraia e Limite,FI,37,33,22,1,0,56,15,28,1,0,44
2020,48008,Capraia e Limite,FI,38,24,18,3,0,45,17,18,3,0,38
2020,48008,Capraia e Limite,FI,39,32,35,2,0,69,21,38,0,0,59
2020,48008,Capraia e Limite,FI,40,19,24,1,0,44,18,36,0,0,54
2020,48008,Capraia e Limite,FI,41,29,31,1,0,61,20,38,2,0,60
2020,48008,Capraia e Limite,FI,42,28,34,1,0,63,19,41,4,0,64
2020,48008,Capraia e Limite,FI,43,28,42,1,0,71,24,36,4,0,64
2020,48008,Capraia e Limite,FI,44,25,38,4,1,68,19,33,3,1,56
2020,48008,Capraia e Limite,FI,45,23,42,4,0,69,15,48,5,0,68
2020,48008,Capraia e Limite,FI,46,26,31,3,0,60,12,56,3,0,71
2020,48008,Capraia e Limite,FI,47,28,42,2,1,73,21,57,3,0,81
2020,48008,Capraia e Limite,FI,48,21,41,3,1,66,17,54,4,2,77
2020,48008,Capraia e Limite,FI,49,18,51,3,1,73,16,41,7,2,66
2020,48008,Capraia e Limite,FI,50,19,50,5,0,74,17,41,5,4,67
2020,48008,Capraia e Limite,FI,51,13,47,2,0,62,14,53,4,1,72
2020,48008,Capraia e Limite,FI,52,14,42,5,0,61,9,42,3,0,54
2020,48008,Capraia e Limite,FI,53,11,49,6,0,66,8,53,5,1,67
2020,48008,Capraia e Limite,FI,54,10,44,2,1,57,5,55,4,0,64
2020,48008,Capraia e Limite,FI,55,9,54,6,1,70,5,57,7,2,71
2020,48008,Capraia e Limite,FI,56,12,49,4,0,65,17,57,6,3,83
2020,48008,Capraia e Limite,FI,57,11,52,4,0,67,9,39,7,1,56
2020,48008,Capraia e Limite,FI,58,6,33,3,0,42,3,42,2,6,53
2020,48008,Capraia e Limite,FI,59,7,29,3,3,42,5,46,2,1,54
2020,48008,Capraia e Limite,FI,60,6,49,7,1,63,3,37,4,3,47
2020,48008,Capraia e Limite,FI,61,6,40,4,3,53,6,43,6,3,58
2020,48008,Capraia e Limite,FI,62,1,40,4,0,45,6,32,4,3,45
2020,48008,Capraia e Limite,FI,63,6,38,4,1,49,2,36,1,2,41
2020,48008,Capraia e Limite,FI,64,5,36,2,1,44,7,29,1,7,44
2020,48008,Capraia e Limite,FI,65,3,35,4,1,43,1,41,1,4,47
2020,48008,Capraia e Limite,FI,66,2,35,2,1,40,3,34,1,3,41
2020,48008,Capraia e Limite,FI,67,2,29,3,3,37,0,35,2,5,42
2020,48008,Capraia e Limite,FI,68,2,36,0,0,38,0,38,1,12,51
2020,48008,Capraia e Limite,FI,69,2,31,2,0,35,3,27,4,6,40
2020,48008,Capraia e Limite,FI,70,1,33,1,2,37,2,30,1,8,41
2020,48008,Capraia e Limite,FI,71,2,36,3,1,42,5,33,2,7,47
2020,48008,Capraia e Limite,FI,72,2,48,2,3,55,4,39,3,5,51
2020,48008,Capraia e Limite,FI,73,2,41,0,2,45,2,23,1,9,35
2020,48008,Capraia e Limite,FI,74,0,33,2,2,37,2,26,3,16,47
2020,48008,Capraia e Limite,FI,75,0,21,3,1,25,0,19,2,16,37
2020,48008,Capraia e Limite,FI,76,2,24,2,3,31,1,17,1,6,25
2020,48008,Capraia e Limite,FI,77,0,27,1,3,31,3,26,1,9,39
2020,48008,Capraia e Limite,FI,78,2,19,2,2,25,0,23,0,10,33
2020,48008,Capraia e Limite,FI,79,0,21,2,3,26,1,25,0,12,38
2020,48008,Capraia e Limite,FI,80,0,21,0,7,28,2,15,1,12,30
2020,48008,Capraia e Limite,FI,81,0,19,0,2,21,1,12,0,11,24
2020,48008,Capraia e Limite,FI,82,1,18,0,3,22,1,11,0,14,26
2020,48008,Capraia e Limite,FI,83,1,15,1,3,20,2,18,0,16,36
2020,48008,Capraia e Limite,FI,84,0,19,0,2,21,0,4,0,9,13
2020,48008,Capraia e Limite,FI,85,1,9,0,4,14,1,7,0,15,23
2020,48008,Capraia e Limite,FI,86,0,16,0,2,18,1,10,0,10,21
2020,48008,Capraia e Limite,FI,87,0,7,0,1,8,0,3,0,14,17
2020,48008,Capraia e Limite,FI,88,0,6,0,3,9,3,7,0,11,21
2020,48008,Capraia e Limite,FI,89,0,11,0,1,12,0,4,0,10,14
2020,48008,Capraia e Limite,FI,90,0,7,0,6,13,0,4,0,18,22
2020,48008,Capraia e Limite,FI,91,0,4,0,3,7,1,2,0,10,13
2020,48008,Capraia e Limite,FI,92,0,5,1,1,7,1,0,0,10,11
2020,48008,Capraia e Limite,FI,93,0,3,0,2,5,0,0,0,6,6
2020,48008,Capraia e Limite,FI,94,0,1,0,0,1,0,1,0,4,5
2020,48008,Capraia e Limite,FI,95,1,1,0,2,4,0,1,0,5,6
2020,48008,Capraia e Limite,FI,96,0,1,0,0,1,1,0,0,4,5
2020,48008,Capraia e Limite,FI,97,0,2,0,2,4,0,0,0,3,3
2020,48008,Capraia e Limite,FI,98,0,0,0,0,0,0,1,0,3,4
2020,48008,Capraia e Limite,FI,99,0,0,0,0,0,0,0,0,2,2
2020,48008,Capraia e Limite,FI,100 e più,0,0,0,0,0,0,0,0,1,1
2020,48010,Castelfiorentino,FI,0,73,0,0,0,73,53,0,0,0,53
2020,48010,Castelfiorentino,FI,1,79,0,0,0,79,53,0,0,0,53
2020,48010,Castelfiorentino,FI,2,69,0,0,0,69,72,0,0,0,72
2020,48010,Castelfiorentino,FI,3,60,0,0,0,60,70,0,0,0,70
2020,48010,Castelfiorentino,FI,4,76,0,0,0,76,78,0,0,0,78
2020,48010,Castelfiorentino,FI,5,57,0,0,0,57,73,0,0,0,73
2020,48010,Castelfiorentino,FI,6,85,0,0,0,85,74,0,0,0,74
2020,48010,Castelfiorentino,FI,7,97,0,0,0,97,79,0,0,0,79
2020,48010,Castelfiorentino,FI,8,83,0,0,0,83,78,0,0,0,78
2020,48010,Castelfiorentino,FI,9,90,0,0,0,90,51,0,0,0,51
2020,48010,Castelfiorentino,FI,10,72,0,0,0,72,67,0,0,0,67
2020,48010,Castelfiorentino,FI,11,68,0,0,0,68,88,0,0,0,88
2020,48010,Castelfiorentino,FI,12,100,0,0,0,100,69,0,0,0,69
2020,48010,Castelfiorentino,FI,13,95,0,0,0,95,61,0,0,0,61
2020,48010,Castelfiorentino,FI,14,69,0,0,0,69,85,0,0,0,85
2020,48010,Castelfiorentino,FI,15,85,0,0,0,85,81,0,0,0,81
2020,48010,Castelfiorentino,FI,16,77,0,0,0,77,77,0,0,0,77
2020,48010,Castelfiorentino,FI,17,70,0,0,0,70,84,0,0,0,84
2020,48010,Castelfiorentino,FI,18,65,0,0,0,65,67,0,0,0,67
2020,48010,Castelfiorentino,FI,19,81,0,0,0,81,79,0,0,0,79
2020,48010,Castelfiorentino,FI,20,84,0,0,0,84,71,0,0,0,71
2020,48010,Castelfiorentino,FI,21,92,1,0,0,93,67,1,0,0,68
2020,48010,Castelfiorentino,FI,22,99,0,0,0,99,89,3,0,0,92
2020,48010,Castelfiorentino,FI,23,89,0,0,0,89,83,7,0,0,90
2020,48010,Castelfiorentino,FI,24,88,3,0,0,91,89,4,1,0,94
2020,48010,Castelfiorentino,FI,25,80,1,0,0,81,77,11,0,0,88
2020,48010,Castelfiorentino,FI,26,80,5,0,0,85,95,12,0,0,107
2020,48010,Castelfiorentino,FI,27,65,4,0,0,69,62,15,0,0,77
2020,48010,Castelfiorentino,FI,28,73,3,0,0,76,69,21,1,0,91
2020,48010,Castelfiorentino,FI,29,82,4,0,0,86,59,23,0,0,82
2020,48010,Castelfiorentino,FI,30,85,14,0,0,99,55,40,1,1,97
2020,48010,Castelfiorentino,FI,31,69,9,0,0,78,75,35,0,0,110
2020,48010,Castelfiorentino,FI,32,83,24,0,0,107,75,31,1,0,107
2020,48010,Castelfiorentino,FI,33,67,29,0,0,96,46,25,1,0,72
2020,48010,Castelfiorentino,FI,34,66,38,1,0,105,47,44,1,0,92
2020,48010,Castelfiorentino,FI,35,52,28,0,0,80,49,57,0,0,106
2020,48010,Castelfiorentino,FI,36,46,44,0,0,90,55,52,0,0,107
2020,48010,Castelfiorentino,FI,37,50,32,2,0,84,29,52,1,0,82
2020,48010,Castelfiorentino,FI,38,64,42,0,0,106,24,57,3,0,84
2020,48010,Castelfiorentino,FI,39,39,56,1,0,96,30,62,4,1,97
2020,48010,Castelfiorentino,FI,40,50,63,1,0,114,29,78,4,0,111
2020,48010,Castelfiorentino,FI,41,49,63,3,1,116,30,55,1,0,86
2020,48010,Castelfiorentino,FI,42,57,60,4,0,121,38,70,1,1,110
2020,48010,Castelfiorentino,FI,43,42,62,3,1,108,40,74,6,1,121
2020,48010,Castelfiorentino,FI,44,45,82,4,0,131,29,92,9,0,130
2020,48010,Castelfiorentino,FI,45,36,85,6,0,127,46,86,13,1,146
2020,48010,Castelfiorentino,FI,46,54,69,9,0,132,31,87,9,1,128
2020,48010,Castelfiorentino,FI,47,49,92,6,0,147,34,95,10,3,142
2020,48010,Castelfiorentino,FI,48,40,87,7,2,136,22,96,9,0,127
2020,48010,Castelfiorentino,FI,49,40,98,14,0,152,28,113,11,2,154
2020,48010,Castelfiorentino,FI,50,43,76,8,2,129,16,87,8,2,113
2020,48010,Castelfiorentino,FI,51,34,107,12,1,154,24,116,7,3,150
2020,48010,Castelfiorentino,FI,52,35,87,13,0,135,34,100,10,2,146
2020,48010,Castelfiorentino,FI,53,28,95,12,1,136,20,112,14,2,148
2020,48010,Castelfiorentino,FI,54,23,117,5,0,145,13,102,10,3,128
2020,48010,Castelfiorentino,FI,55,29,119,6,1,155,17,99,22,3,141
2020,48010,Castelfiorentino,FI,56,15,101,7,1,124,13,104,8,7,132
2020,48010,Castelfiorentino,FI,57,10,88,5,2,105,17,105,5,2,129
2020,48010,Castelfiorentino,FI,58,15,99,11,2,127,9,97,4,8,118
2020,48010,Castelfiorentino,FI,59,16,101,13,2,132,10,93,5,5,113
2020,48010,Castelfiorentino,FI,60,17,111,5,2,135,12,102,4,14,132
2020,48010,Castelfiorentino,FI,61,18,86,9,3,116,9,99,9,8,125
2020,48010,Castelfiorentino,FI,62,11,86,8,2,107,9,96,8,7,120
2020,48010,Castelfiorentino,FI,63,10,87,7,7,111,13,86,3,6,108
2020,48010,Castelfiorentino,FI,64,11,74,2,1,88,3,70,4,4,81
2020,48010,Castelfiorentino,FI,65,8,85,4,6,103,4,93,3,12,112
2020,48010,Castelfiorentino,FI,66,8,85,2,5,100,7,100,3,13,123
2020,48010,Castelfiorentino,FI,67,5,87,5,4,101,1,77,4,13,95
2020,48010,Castelfiorentino,FI,68,2,67,5,4,78,6,70,4,9,89
2020,48010,Castelfiorentino,FI,69,4,84,3,5,96,2,80,5,12,99
2020,48010,Castelfiorentino,FI,70,5,86,5,6,102,5,71,0,19,95
2020,48010,Castelfiorentino,FI,71,6,91,5,4,106,4,81,1,28,114
2020,48010,Castelfiorentino,FI,72,3,91,0,3,97,4,93,3,24,124
2020,48010,Castelfiorentino,FI,73,8,96,5,14,123,7,75,3,40,125
2020,48010,Castelfiorentino,FI,74,6,74,0,4,84,2,70,1,30,103
2020,48010,Castelfiorentino,FI,75,6,68,0,15,89,2,60,1,37,100
2020,48010,Castelfiorentino,FI,76,4,75,2,8,89,0,50,4,20,74
2020,48010,Castelfiorentino,FI,77,3,55,2,16,76,4,55,1,43,103
2020,48010,Castelfiorentino,FI,78,6,46,0,5,57,3,54,0,37,94
2020,48010,Castelfiorentino,FI,79,6,47,0,8,61,5,45,1,45,96
2020,48010,Castelfiorentino,FI,80,3,64,0,12,79,0,46,1,49,96
2020,48010,Castelfiorentino,FI,81,3,59,1,13,76,2,54,3,50,109
2020,48010,Castelfiorentino,FI,82,4,50,0,7,61,1,32,0,49,82
2020,48010,Castelfiorentino,FI,83,3,45,0,10,58,1,30,0,59,90
2020,48010,Castelfiorentino,FI,84,3,45,0,14,62,4,21,0,57,82
2020,48010,Castelfiorentino,FI,85,2,37,2,12,53,2,22,0,58,82
2020,48010,Castelfiorentino,FI,86,0,35,1,13,49,1,17,0,52,70
2020,48010,Castelfiorentino,FI,87,3,26,0,4,33,0,12,0,44,56
2020,48010,Castelfiorentino,FI,88,3,16,0,11,30,3,11,0,54,68
2020,48010,Castelfiorentino,FI,89,0,16,0,7,23,2,6,0,46,54
2020,48010,Castelfiorentino,FI,90,1,14,0,8,23,1,3,0,33,37
2020,48010,Castelfiorentino,FI,91,1,8,0,2,11,1,5,0,34,40
2020,48010,Castelfiorentino,FI,92,2,9,0,2,13,0,4,0,23,27
2020,48010,Castelfiorentino,FI,93,0,8,0,5,13,0,4,0,27,31
2020,48010,Castelfiorentino,FI,94,0,3,0,2,5,1,2,0,22,25
2020,48010,Castelfiorentino,FI,95,0,3,0,4,7,1,0,0,16,17
2020,48010,Castelfiorentino,FI,96,0,1,0,4,5,0,0,0,14,14
2020,48010,Castelfiorentino,FI,97,0,0,0,2,2,0,0,0,10,10
2020,48010,Castelfiorentino,FI,98,0,0,0,1,1,0,1,0,3,4
2020,48010,Castelfiorentino,FI,99,0,0,0,0,0,0,0,0,5,5
2020,48010,Castelfiorentino,FI,100 e più,0,0,0,0,0,0,0,0,6,6
2020,48011,Cerreto Guidi,FI,0,38,0,0,0,38,40,0,0,0,40
2020,48011,Cerreto Guidi,FI,1,33,0,0,0,33,35,0,0,0,35
2020,48011,Cerreto Guidi,FI,2,26,0,0,0,26,34,0,0,0,34
2020,48011,Cerreto Guidi,FI,3,38,0,0,0,38,51,0,0,0,51
2020,48011,Cerreto Guidi,FI,4,55,0,0,0,55,42,0,0,0,42
2020,48011,Cerreto Guidi,FI,5,33,0,0,0,33,36,0,0,0,36
2020,48011,Cerreto Guidi,FI,6,47,0,0,0,47,59,0,0,0,59
2020,48011,Cerreto Guidi,FI,7,38,0,0,0,38,45,0,0,0,45
2020,48011,Cerreto Guidi,FI,8,51,0,0,0,51,48,0,0,0,48
2020,48011,Cerreto Guidi,FI,9,49,0,0,0,49,50,0,0,0,50
2020,48011,Cerreto Guidi,FI,10,48,0,0,0,48,35,0,0,0,35
2020,48011,Cerreto Guidi,FI,11,45,0,0,0,45,45,0,0,0,45
2020,48011,Cerreto Guidi,FI,12,61,0,0,0,61,51,0,0,0,51
2020,48011,Cerreto Guidi,FI,13,62,0,0,0,62,53,0,0,0,53
2020,48011,Cerreto Guidi,FI,14,70,0,0,0,70,58,0,0,0,58
2020,48011,Cerreto Guidi,FI,15,44,0,0,0,44,57,0,0,0,57
2020,48011,Cerreto Guidi,FI,16,56,0,0,0,56,53,0,0,0,53
2020,48011,Cerreto Guidi,FI,17,53,0,0,0,53,52,0,0,0,52
2020,48011,Cerreto Guidi,FI,18,50,0,0,0,50,61,0,0,0,61
2020,48011,Cerreto Guidi,FI,19,58,0,0,0,58,50,0,0,0,50
2020,48011,Cerreto Guidi,FI,20,60,0,0,0,60,49,0,0,0,49
2020,48011,Cerreto Guidi,FI,21,46,0,0,0,46,40,2,0,0,42
2020,48011,Cerreto Guidi,FI,22,51,1,0,0,52,39,0,0,0,39
2020,48011,Cerreto Guidi,FI,23,50,0,0,0,50,37,3,0,0,40
2020,48011,Cerreto Guidi,FI,24,45,0,0,0,45,38,4,0,0,42
2020,48011,Cerreto Guidi,FI,25,54,0,0,0,54,41,1,0,0,42
2020,48011,Cerreto Guidi,FI,26,47,2,0,0,49,44,3,0,1,48
2020,48011,Cerreto Guidi,FI,27,44,0,0,0,44,53,3,0,0,56
2020,48011,Cerreto Guidi,FI,28,33,5,0,0,38,43,2,0,0,45
2020,48011,Cerreto Guidi,FI,29,40,1,0,0,41,37,15,0,0,52
2020,48011,Cerreto Guidi,FI,30,42,6,0,0,48,29,13,0,0,42
2020,48011,Cerreto Guidi,FI,31,45,8,0,0,53,35,22,0,0,57
2020,48011,Cerreto Guidi,FI,32,38,13,0,0,51,40,16,0,0,56
2020,48011,Cerreto Guidi,FI,33,45,15,0,0,60,48,22,0,0,70
2020,48011,Cerreto Guidi,FI,34,46,15,0,0,61,37,25,0,0,62
2020,48011,Cerreto Guidi,FI,35,30,24,0,0,54,33,25,2,0,60
2020,48011,Cerreto Guidi,FI,36,39,20,0,0,59,30,35,2,0,67
2020,48011,Cerreto Guidi,FI,37,48,24,1,0,73,22,25,1,1,49
2020,48011,Cerreto Guidi,FI,38,35,26,0,0,61,25,37,1,0,63
2020,48011,Cerreto Guidi,FI,39,41,38,2,0,81,30,48,2,1,81
2020,48011,Cerreto Guidi,FI,40,30,31,3,0,64,30,45,2,0,77
2020,48011,Cerreto Guidi,FI,41,33,33,3,0,69,27,39,2,0,68
2020,48011,Cerreto Guidi,FI,42,43,44,4,0,91,22,50,2,0,74
2020,48011,Cerreto Guidi,FI,43,42,39,4,0,85,36,71,2,2,111
2020,48011,Cerreto Guidi,FI,44,42,64,2,2,110,24,62,10,0,96
2020,48011,Cerreto Guidi,FI,45,30,67,5,0,102,21,57,9,1,88
2020,48011,Cerreto Guidi,FI,46,41,71,6,0,118,26,75,2,1,104
2020,48011,Cerreto Guidi,FI,47,26,65,5,0,96,27,77,9,0,113
2020,48011,Cerreto Guidi,FI,48,30,77,5,0,112,23,68,5,0,96
2020,48011,Cerreto Guidi,FI,49,24,79,5,0,108,20,82,7,0,109
2020,48011,Cerreto Guidi,FI,50,17,66,3,0,86,13,68,10,0,91
2020,48011,Cerreto Guidi,FI,51,14,66,7,0,87,11,70,5,3,89
2020,48011,Cerreto Guidi,FI,52,13,54,8,1,76,8,76,7,0,91
2020,48011,Cerreto Guidi,FI,53,22,83,1,0,106,14,52,5,2,73
2020,48011,Cerreto Guidi,FI,54,12,75,7,4,98,15,82,4,0,101
2020,48011,Cerreto Guidi,FI,55,14,67,10,3,94,11,87,4,2,104
2020,48011,Cerreto Guidi,FI,56,11,79,8,4,102,10,60,3,3,76
2020,48011,Cerreto Guidi,FI,57,6,62,4,0,72,3,66,4,1,74
2020,48011,Cerreto Guidi,FI,58,7,58,12,0,77,5,52,8,3,68
2020,48011,Cerreto Guidi,FI,59,11,63,5,0,79,6,53,4,5,68
2020,48011,Cerreto Guidi,FI,60,7,61,3,2,73,5,62,3,4,74
2020,48011,Cerreto Guidi,FI,61,3,67,6,0,76,6,68,5,11,90
2020,48011,Cerreto Guidi,FI,62,8,60,6,0,74,2,54,8,5,69
2020,48011,Cerreto Guidi,FI,63,4,66,1,1,72,3,48,0,4,55
2020,48011,Cerreto Guidi,FI,64,5,47,3,2,57,5,54,4,4,67
2020,48011,Cerreto Guidi,FI,65,5,49,3,0,57,2,63,5,9,79
2020,48011,Cerreto Guidi,FI,66,5,50,2,0,57,3,53,3,11,70
2020,48011,Cerreto Guidi,FI,67,6,48,1,0,55,2,43,2,11,58
2020,48011,Cerreto Guidi,FI,68,3,44,5,2,54,4,56,3,16,79
2020,48011,Cerreto Guidi,FI,69,3,56,1,2,62,5,47,0,13,65
2020,48011,Cerreto Guidi,FI,70,3,37,0,3,43,1,51,1,13,66
2020,48011,Cerreto Guidi,FI,71,4,45,3,4,56,1,37,3,19,60
2020,48011,Cerreto Guidi,FI,72,2,59,2,4,67,3,52,1,33,89
2020,48011,Cerreto Guidi,FI,73,2,59,1,7,69,1,52,2,16,71
2020,48011,Cerreto Guidi,FI,74,4,38,0,3,45,0,31,2,27,60
2020,48011,Cerreto Guidi,FI,75,1,39,0,8,48,0,29,2,14,45
2020,48011,Cerreto Guidi,FI,76,2,36,1,5,44,0,31,0,19,50
2020,48011,Cerreto Guidi,FI,77,2,38,0,1,41,2,34,2,15,53
2020,48011,Cerreto Guidi,FI,78,3,26,0,2,31,1,23,0,21,45
2020,48011,Cerreto Guidi,FI,79,3,40,0,1,44,1,34,0,17,52
2020,48011,Cerreto Guidi,FI,80,0,40,0,9,49,0,19,0,25,44
2020,48011,Cerreto Guidi,FI,81,3,30,0,8,41,2,34,1,21,58
2020,48011,Cerreto Guidi,FI,82,2,32,2,7,43,1,13,1,30,45
2020,48011,Cerreto Guidi,FI,83,4,18,0,6,28,0,16,0,29,45
2020,48011,Cerreto Guidi,FI,84,1,18,0,4,23,1,11,0,35,47
2020,48011,Cerreto Guidi,FI,85,3,24,0,5,32,3,7,0,25,35
2020,48011,Cerreto Guidi,FI,86,2,22,0,7,31,0,13,0,26,39
2020,48011,Cerreto Guidi,FI,87,1,22,0,3,26,1,6,1,22,30
2020,48011,Cerreto Guidi,FI,88,1,8,0,5,14,1,2,0,26,29
2020,48011,Cerreto Guidi,FI,89,1,6,0,7,14,2,1,0,25,28
2020,48011,Cerreto Guidi,FI,90,0,7,0,5,12,0,1,0,18,19
2020,48011,Cerreto Guidi,FI,91,1,5,0,4,10,1,1,0,17,19
2020,48011,Cerreto Guidi,FI,92,0,3,0,2,5,0,0,0,14,14
2020,48011,Cerreto Guidi,FI,93,0,1,0,5,6,0,1,0,15,16
2020,48011,Cerreto Guidi,FI,94,0,2,0,4,6,0,0,0,9,9
2020,48011,Cerreto Guidi,FI,95,0,0,0,2,2,0,1,0,11,12
2020,48011,Cerreto Guidi,FI,96,0,2,0,1,3,0,0,0,7,7
2020,48011,Cerreto Guidi,FI,97,0,0,0,2,2,0,0,0,5,5
2020,48011,Cerreto Guidi,FI,98,0,0,0,1,1,0,0,0,3,3
2020,48011,Cerreto Guidi,FI,99,0,0,0,0,0,0,0,0,2,2
2020,48011,Cerreto Guidi,FI,100 e più,0,0,0,0,0,0,0,0,1,1
2020,48012,Certaldo,FI,0,59,0,0,0,59,52,0,0,0,52
2020,48012,Certaldo,FI,1,48,0,0,0,48,47,0,0,0,47
2020,48012,Certaldo,FI,2,41,0,0,0,41,44,0,0,0,44
2020,48012,Certaldo,FI,3,55,0,0,0,55,43,0,0,0,43
2020,48012,Certaldo,FI,4,58,0,0,0,58,55,0,0,0,55
2020,48012,Certaldo,FI,5,54,0,0,0,54,57,0,0,0,57
2020,48012,Certaldo,FI,6,65,0,0,0,65,63,0,0,0,63
2020,48012,Certaldo,FI,7,59,0,0,0,59,74,0,0,0,74
2020,48012,Certaldo,FI,8,59,0,0,0,59,53,0,0,0,53
2020,48012,Certaldo,FI,9,70,0,0,0,70,39,0,0,0,39
2020,48012,Certaldo,FI,10,80,0,0,0,80,73,0,0,0,73
2020,48012,Certaldo,FI,11,71,0,0,0,71,72,0,0,0,72
2020,48012,Certaldo,FI,12,75,0,0,0,75,64,0,0,0,64
2020,48012,Certaldo,FI,13,69,0,0,0,69,48,0,0,0,48
2020,48012,Certaldo,FI,14,77,0,0,0,77,54,0,0,0,54
2020,48012,Certaldo,FI,15,74,0,0,0,74,80,0,0,0,80
2020,48012,Certaldo,FI,16,82,0,0,0,82,47,0,0,0,47
2020,48012,Certaldo,FI,17,81,0,0,0,81,64,0,0,0,64
2020,48012,Certaldo,FI,18,75,0,0,0,75,85,0,0,0,85
2020,48012,Certaldo,FI,19,86,0,0,0,86,65,0,0,0,65
2020,48012,Certaldo,FI,20,70,0,0,0,70,59,1,0,0,60
2020,48012,Certaldo,FI,21,95,0,0,0,95,68,2,0,0,70
2020,48012,Certaldo,FI,22,97,1,0,0,98,61,3,0,0,64
2020,48012,Certaldo,FI,23,88,0,0,0,88,61,2,0,0,63
2020,48012,Certaldo,FI,24,63,2,0,0,65,60,6,0,0,66
2020,48012,Certaldo,FI,25,84,1,0,0,85,79,5,0,0,84
2020,48012,Certaldo,FI,26,82,3,0,0,85,61,11,0,0,72
2020,48012,Certaldo,FI,27,77,5,0,0,82,58,4,0,0,62
2020,48012,Certaldo,FI,28,79,2,0,0,81,48,9,0,0,57
2020,48012,Certaldo,FI,29,78,6,1,0,85,48,12,0,0,60
2020,48012,Certaldo,FI,30,66,12,0,0,78,51,20,1,0,72
2020,48012,Certaldo,FI,31,85,10,0,0,95,55,28,1,0,84
2020,48012,Certaldo,FI,32,63,17,0,0,80,53,24,1,0,78
2020,48012,Certaldo,FI,33,63,24,0,0,87,43,34,1,0,78
2020,48012,Certaldo,FI,34,53,24,0,0,77,31,38,3,0,72
2020,48012,Certaldo,FI,35,60,23,0,0,83,40,28,2,0,70
2020,48012,Certaldo,FI,36,49,39,2,1,91,36,51,0,1,88
2020,48012,Certaldo,FI,37,50,34,0,0,84,43,45,2,1,91
2020,48012,Certaldo,FI,38,47,36,1,0,84,45,49,2,1,97
2020,48012,Certaldo,FI,39,42,46,2,0,90,41,58,3,0,102
2020,48012,Certaldo,FI,40,49,28,1,0,78,30,51,7,0,88
2020,48012,Certaldo,FI,41,40,50,2,0,92,23,67,4,1,95
2020,48012,Certaldo,FI,42,40,47,0,0,87,22,68,4,2,96
2020,48012,Certaldo,FI,43,49,56,6,0,111,28,60,4,1,93
2020,48012,Certaldo,FI,44,48,59,1,0,108,24,81,5,1,111
2020,48012,Certaldo,FI,45,42,73,5,0,120,32,91,12,1,136
2020,48012,Certaldo,FI,46,50,66,4,0,120,21,115,9,1,146
2020,48012,Certaldo,FI,47,42,85,5,1,133,28,72,13,0,113
2020,48012,Certaldo,FI,48,48,70,5,0,123,23,86,19,0,128
2020,48012,Certaldo,FI,49,39,70,8,0,117,21,101,9,2,133
2020,48012,Certaldo,FI,50,36,91,10,1,138,13,88,7,3,111
2020,48012,Certaldo,FI,51,28,114,2,0,144,17,91,8,4,120
2020,48012,Certaldo,FI,52,36,81,8,0,125,8,88,8,1,105
2020,48012,Certaldo,FI,53,23,95,10,1,129,16,98,7,5,126
2020,48012,Certaldo,FI,54,28,103,11,0,142,19,100,7,9,135
2020,48012,Certaldo,FI,55,17,98,3,1,119,18,95,7,7,127
2020,48012,Certaldo,FI,56,17,106,2,2,127,13,103,16,6,138
2020,48012,Certaldo,FI,57,21,109,7,0,137,11,88,10,5,114
2020,48012,Certaldo,FI,58,17,92,12,1,122,10,89,8,3,110
2020,48012,Certaldo,FI,59,12,92,9,1,114,7,88,16,6,117
2020,48012,Certaldo,FI,60,15,77,4,1,97,3,113,7,3,126
2020,48012,Certaldo,FI,61,11,86,8,1,106,3,82,8,14,107
2020,48012,Certaldo,FI,62,12,81,6,3,102,10,75,10,6,101
2020,48012,Certaldo,FI,63,3,79,3,2,87,10,77,7,9,103
2020,48012,Certaldo,FI,64,4,72,3,1,80,12,75,5,11,103
2020,48012,Certaldo,FI,65,3,68,10,2,83,10,69,10,15,104
2020,48012,Certaldo,FI,66,4,70,3,4,81,7,73,7,12,99
2020,48012,Certaldo,FI,67,9,57,6,4,76,5,62,7,8,82
2020,48012,Certaldo,FI,68,8,78,1,4,91,4,73,5,11,93
2020,48012,Certaldo,FI,69,5,68,3,8,84,3,75,4,12,94
2020,48012,Certaldo,FI,70,7,76,5,7,95,6,83,5,15,109
2020,48012,Certaldo,FI,71,4,87,1,4,96,2,88,3,26,119
2020,48012,Certaldo,FI,72,6,103,4,4,117,3,86,4,30,123
2020,48012,Certaldo,FI,73,9,71,3,6,89,2,65,4,50,121
2020,48012,Certaldo,FI,74,4,79,1,4,88,6,57,4,33,100
2020,48012,Certaldo,FI,75,8,59,4,4,75,11,47,3,25,86
2020,48012,Certaldo,FI,76,6,55,0,9,70,4,49,5,23,81
2020,48012,Certaldo,FI,77,5,59,1,5,70,7,44,4,30,85
2020,48012,Certaldo,FI,78,4,45,0,6,55,1,39,0,30,70
2020,48012,Certaldo,FI,79,2,47,2,12,63,3,48,0,35,86
2020,48012,Certaldo,FI,80,4,45,1,5,55,3,44,2,44,93
2020,48012,Certaldo,FI,81,4,48,1,9,62,3,64,3,55,125
2020,48012,Certaldo,FI,82,0,43,3,8,54,3,34,0,53,90
2020,48012,Certaldo,FI,83,4,53,0,6,63,2,29,1,43,75
2020,48012,Certaldo,FI,84,1,32,0,15,48,1,24,1,44,70
2020,48012,Certaldo,FI,85,4,48,0,10,62,3,16,0,36,55
2020,48012,Certaldo,FI,86,0,32,0,6,38,3,15,2,42,62
2020,48012,Certaldo,FI,87,3,32,0,9,44,2,16,0,44,62
2020,48012,Certaldo,FI,88,2,23,0,11,36,0,7,0,45,52
2020,48012,Certaldo,FI,89,0,21,0,9,30,1,11,0,41,53
2020,48012,Certaldo,FI,90,0,19,0,5,24,1,7,0,36,44
2020,48012,Certaldo,FI,91,1,9,0,6,16,0,1,1,36,38
2020,48012,Certaldo,FI,92,2,8,0,5,15,2,1,0,24,27
2020,48012,Certaldo,FI,93,1,6,0,5,12,1,2,0,14,17
2020,48012,Certaldo,FI,94,0,4,0,1,5,1,2,0,15,18
2020,48012,Certaldo,FI,95,0,2,0,3,5,0,1,0,18,19
2020,48012,Certaldo,FI,96,0,1,0,1,2,0,1,0,12,13
2020,48012,Certaldo,FI,97,0,3,0,1,4,0,0,0,11,11
2020,48012,Certaldo,FI,98,0,0,0,3,3,0,0,0,4,4
2020,48012,Certaldo,FI,99,0,0,0,1,1,0,0,0,6,6
2020,48012,Certaldo,FI,100 e più,0,0,0,1,1,0,0,0,3,3
2020,48013,Dicomano,FI,0,6,0,0,0,6,11,0,0,0,11
2020,48013,Dicomano,FI,1,12,0,0,0,12,11,0,0,0,11
2020,48013,Dicomano,FI,2,18,0,0,0,18,17,0,0,0,17
2020,48013,Dicomano,FI,3,17,0,0,0,17,21,0,0,0,21
2020,48013,Dicomano,FI,4,18,0,0,0,18,20,0,0,0,20
2020,48013,Dicomano,FI,5,23,0,0,0,23,23,0,0,0,23
2020,48013,Dicomano,FI,6,27,0,0,0,27,19,0,0,0,19
2020,48013,Dicomano,FI,7,26,0,0,0,26,17,0,0,0,17
2020,48013,Dicomano,FI,8,31,0,0,0,31,25,0,0,0,25
2020,48013,Dicomano,FI,9,28,0,0,0,28,23,0,0,0,23
2020,48013,Dicomano,FI,10,31,0,0,0,31,29,0,0,0,29
2020,48013,Dicomano,FI,11,29,0,0,0,29,28,0,0,0,28
2020,48013,Dicomano,FI,12,29,0,0,0,29,21,0,0,0,21
2020,48013,Dicomano,FI,13,23,0,0,0,23,30,0,0,0,30
2020,48013,Dicomano,FI,14,25,0,0,0,25,32,0,0,0,32
2020,48013,Dicomano,FI,15,19,0,0,0,19,15,0,0,0,15
2020,48013,Dicomano,FI,16,24,0,0,0,24,24,0,0,0,24
2020,48013,Dicomano,FI,17,43,0,0,0,43,35,0,0,0,35
2020,48013,Dicomano,FI,18,25,0,0,0,25,23,0,0,0,23
2020,48013,Dicomano,FI,19,26,0,0,0,26,28,1,0,0,29
2020,48013,Dicomano,FI,20,22,0,0,0,22,25,1,0,0,26
2020,48013,Dicomano,FI,21,40,0,0,0,40,23,1,0,0,24
2020,48013,Dicomano,FI,22,29,0,0,0,29,21,4,0,0,25
2020,48013,Dicomano,FI,23,40,1,0,0,41,24,1,0,0,25
2020,48013,Dicomano,FI,24,27,0,0,0,27,17,2,0,0,19
2020,48013,Dicomano,FI,25,25,0,0,0,25,22,2,0,0,24
2020,48013,Dicomano,FI,26,28,1,0,0,29,18,6,0,0,24
2020,48013,Dicomano,FI,27,33,3,0,0,36,17,3,0,0,20
2020,48013,Dicomano,FI,28,27,4,0,0,31,20,6,0,0,26
2020,48013,Dicomano,FI,29,21,10,0,0,31,15,4,0,0,19
2020,48013,Dicomano,FI,30,25,9,2,0,36,8,6,0,0,14
2020,48013,Dicomano,FI,31,19,3,0,0,22,11,10,1,0,22
2020,48013,Dicomano,FI,32,27,6,0,0,33,18,8,1,0,27
2020,48013,Dicomano,FI,33,23,7,0,0,30,12,12,0,1,25
2020,48013,Dicomano,FI,34,18,3,0,0,21,19,17,0,0,36
2020,48013,Dicomano,FI,35,17,10,0,0,27,13,9,0,0,22
2020,48013,Dicomano,FI,36,18,6,0,0,24,12,15,3,1,31
2020,48013,Dicomano,FI,37,16,8,0,0,24,16,12,0,0,28
2020,48013,Dicomano,FI,38,16,16,1,0,33,11,15,2,0,28
2020,48013,Dicomano,FI,39,16,12,0,0,28,6,22,1,0,29
2020,48013,Dicomano,FI,40,14,9,2,0,25,19,21,1,0,41
2020,48013,Dicomano,FI,41,24,16,2,0,42,15,21,2,0,38
2020,48013,Dicomano,FI,42,16,10,1,0,27,12,20,1,0,33
2020,48013,Dicomano,FI,43,23,22,0,0,45,14,16,2,0,32
2020,48013,Dicomano,FI,44,16,27,1,0,44,12,20,3,1,36
2020,48013,Dicomano,FI,45,23,24,6,0,53,8,25,4,2,39
2020,48013,Dicomano,FI,46,20,23,2,0,45,11,28,2,0,41
2020,48013,Dicomano,FI,47,14,28,4,0,46,13,22,1,0,36
2020,48013,Dicomano,FI,48,14,27,3,0,44,17,36,2,0,55
2020,48013,Dicomano,FI,49,18,32,1,0,51,8,37,4,1,50
2020,48013,Dicomano,FI,50,11,33,2,0,46,9,32,6,0,47
2020,48013,Dicomano,FI,51,12,19,2,0,33,9,34,1,1,45
2020,48013,Dicomano,FI,52,11,44,1,0,56,6,38,3,1,48
2020,48013,Dicomano,FI,53,16,29,3,0,48,8,24,3,1,36
2020,48013,Dicomano,FI,54,12,29,4,0,45,10,23,4,1,38
2020,48013,Dicomano,FI,55,3,29,4,3,39,8,28,8,3,47
2020,48013,Dicomano,FI,56,6,33,3,1,43,3,32,3,3,41
2020,48013,Dicomano,FI,57,10,26,5,2,43,8,39,4,0,51
2020,48013,Dicomano,FI,58,11,29,0,0,40,4,38,0,5,47
2020,48013,Dicomano,FI,59,6,43,3,1,53,3,28,2,4,37
2020,48013,Dicomano,FI,60,3,30,5,0,38,1,26,4,3,34
2020,48013,Dicomano,FI,61,7,33,2,2,44,4,28,2,2,36
2020,48013,Dicomano,FI,62,10,21,3,0,34,0,31,2,5,38
2020,48013,Dicomano,FI,63,3,24,4,0,31,1,31,4,6,42
2020,48013,Dicomano,FI,64,2,29,6,1,38,0,35,3,1,39
2020,48013,Dicomano,FI,65,1,22,3,2,28,4,18,1,5,28
2020,48013,Dicomano,FI,66,3,31,5,0,39,4,19,2,5,30
2020,48013,Dicomano,FI,67,3,34,1,4,42,3,26,2,9,40
2020,48013,Dicomano,FI,68,7,22,1,2,32,1,24,5,7,37
2020,48013,Dicomano,FI,69,3,25,3,0,31,1,22,3,16,42
2020,48013,Dicomano,FI,70,3,20,2,3,28,2,17,3,7,29
2020,48013,Dicomano,FI,71,2,21,1,4,28,0,23,0,5,28
2020,48013,Dicomano,FI,72,3,30,2,2,37,1,31,2,12,46
2020,48013,Dicomano,FI,73,2,33,2,3,40,3,15,2,6,26
2020,48013,Dicomano,FI,74,3,29,1,8,41,1,16,0,12,29
2020,48013,Dicomano,FI,75,4,16,1,2,23,2,15,2,7,26
2020,48013,Dicomano,FI,76,0,15,0,3,18,1,17,1,10,29
2020,48013,Dicomano,FI,77,3,22,1,1,27,3,13,0,3,19
2020,48013,Dicomano,FI,78,3,10,0,3,16,0,8,0,12,20
2020,48013,Dicomano,FI,79,2,15,0,1,18,2,15,2,8,27
2020,48013,Dicomano,FI,80,1,23,0,4,28,1,12,1,16,30
2020,48013,Dicomano,FI,81,1,18,1,4,24,1,7,0,18,26
2020,48013,Dicomano,FI,82,1,9,1,3,14,1,11,0,14,26
2020,48013,Dicomano,FI,83,1,14,0,3,18,0,5,0,17,22
2020,48013,Dicomano,FI,84,0,12,0,5,17,0,7,0,8,15
2020,48013,Dicomano,FI,85,2,8,0,4,14,2,4,0,11,17
2020,48013,Dicomano,FI,86,1,4,0,4,9,1,2,0,15,18
2020,48013,Dicomano,FI,87,2,3,0,1,6,1,4,0,18,23
2020,48013,Dicomano,FI,88,1,5,0,4,10,0,3,0,11,14
2020,48013,Dicomano,FI,89,1,11,0,2,14,0,3,0,9,12
2020,48013,Dicomano,FI,90,0,1,0,2,3,1,2,0,8,11
2020,48013,Dicomano,FI,91,0,2,0,2,4,0,0,0,8,8
2020,48013,Dicomano,FI,92,0,2,0,2,4,0,0,0,11,11
2020,48013,Dicomano,FI,93,0,1,0,4,5,1,0,0,2,3
2020,48013,Dicomano,FI,94,0,0,0,4,4,0,0,0,7,7
2020,48013,Dicomano,FI,95,0,1,0,2,3,0,0,0,5,5
2020,48013,Dicomano,FI,96,1,0,0,0,1,0,0,0,4,4
2020,48013,Dicomano,FI,97,0,0,0,1,1,1,1,0,1,3
2020,48013,Dicomano,FI,98,0,0,0,1,1,0,1,0,0,1
2020,48013,Dicomano,FI,99,0,0,0,0,0,0,0,0,1,1
2020,48013,Dicomano,FI,100 e più,0,0,0,1,1,0,0,0,1,1
2020,48014,Empoli,FI,0,170,0,0,0,170,134,0,0,0,134
2020,48014,Empoli,FI,1,173,0,0,0,173,125,0,0,0,125
2020,48014,Empoli,FI,2,175,0,0,0,175,158,0,0,0,158
2020,48014,Empoli,FI,3,171,0,0,0,171,188,0,0,0,188
2020,48014,Empoli,FI,4,174,0,0,0,174,178,0,0,0,178
2020,48014,Empoli,FI,5,199,0,0,0,199,173,0,0,0,173
2020,48014,Empoli,FI,6,201,0,0,0,201,175,0,0,0,175
2020,48014,Empoli,FI,7,195,0,0,0,195,199,0,0,0,199
2020,48014,Empoli,FI,8,215,0,0,0,215,214,0,0,0,214
2020,48014,Empoli,FI,9,214,0,0,0,214,189,0,0,0,189
2020,48014,Empoli,FI,10,251,0,0,0,251,227,0,0,0,227
2020,48014,Empoli,FI,11,217,0,0,0,217,230,0,0,0,230
2020,48014,Empoli,FI,12,268,0,0,0,268,216,0,0,0,216
2020,48014,Empoli,FI,13,246,0,0,0,246,208,0,0,0,208
2020,48014,Empoli,FI,14,249,0,0,0,249,232,0,0,0,232
2020,48014,Empoli,FI,15,248,0,0,0,248,224,0,0,0,224
2020,48014,Empoli,FI,16,259,0,0,0,259,227,0,0,0,227
2020,48014,Empoli,FI,17,242,0,0,0,242,213,0,0,0,213
2020,48014,Empoli,FI,18,257,0,0,0,257,249,1,0,0,250
2020,48014,Empoli,FI,19,250,0,0,0,250,227,2,0,0,229
2020,48014,Empoli,FI,20,258,0,0,0,258,251,1,0,0,252
2020,48014,Empoli,FI,21,230,0,0,0,230,212,1,0,0,213
2020,48014,Empoli,FI,22,262,1,0,0,263,234,10,0,0,244
2020,48014,Empoli,FI,23,229,5,0,0,234,183,9,0,0,192
2020,48014,Empoli,FI,24,273,8,0,0,281,216,12,0,0,228
2020,48014,Empoli,FI,25,261,8,0,0,269,213,13,1,0,227
2020,48014,Empoli,FI,26,258,6,0,0,264,201,17,0,0,218
2020,48014,Empoli,FI,27,244,18,0,0,262,203,29,0,0,232
2020,48014,Empoli,FI,28,250,18,0,0,268,190,34,1,0,225
2020,48014,Empoli,FI,29,227,21,0,0,248,207,58,2,0,267
2020,48014,Empoli,FI,30,211,41,1,0,253,157,60,2,0,219
2020,48014,Empoli,FI,31,231,36,0,0,267,147,97,1,1,246
2020,48014,Empoli,FI,32,177,67,0,0,244,152,110,5,0,267
2020,48014,Empoli,FI,33,205,77,1,0,283,155,95,5,0,255
2020,48014,Empoli,FI,34,163,90,5,0,258,124,143,3,1,271
2020,48014,Empoli,FI,35,182,109,5,0,296,121,124,4,2,251
2020,48014,Empoli,FI,36,161,119,4,1,285,134,158,9,1,302
2020,48014,Empoli,FI,37,136,121,0,0,257,111,148,5,2,266
2020,48014,Empoli,FI,38,153,137,3,0,293,109,166,4,1,280
2020,48014,Empoli,FI,39,132,141,5,0,279,104,195,14,1,314
2020,48014,Empoli,FI,40,135,162,4,0,301,111,172,10,0,293
2020,48014,Empoli,FI,41,115,181,10,0,306,120,205,8,3,336
2020,48014,Empoli,FI,42,123,175,5,1,304,110,206,21,3,340
2020,48014,Empoli,FI,43,118,178,10,1,307,128,231,19,4,382
2020,48014,Empoli,FI,44,121,199,10,0,330,91,256,19,2,368
2020,48014,Empoli,FI,45,143,252,16,1,413,104,271,22,3,400
2020,48014,Empoli,FI,46,122,268,23,1,414,111,305,20,3,439
2020,48014,Empoli,FI,47,130,271,15,2,418,128,311,22,6,468
2020,48014,Empoli,FI,48,118,268,18,1,405,103,284,38,7,432
2020,48014,Empoli,FI,49,109,268,16,1,394,88,332,35,8,464
2020,48014,Empoli,FI,50,131,270,16,2,419,72,298,34,11,415
2020,48014,Empoli,FI,51,91,298,26,1,417,79,305,26,2,412
2020,48014,Empoli,FI,52,70,280,23,2,375,87,320,36,10,453
2020,48014,Empoli,FI,53,76,262,24,3,365,73,301,37,14,427
2020,48014,Empoli,FI,54,69,320,21,3,413,71,318,41,18,448
2020,48014,Empoli,FI,55,72,302,28,2,404,61,335,40,8,445
2020,48014,Empoli,FI,56,60,315,30,4,409,58,294,45,15,412
2020,48014,Empoli,FI,57,42,286,21,5,354,54,300,22,17,393
2020,48014,Empoli,FI,58,62,274,23,4,364,41,258,29,18,346
2020,48014,Empoli,FI,59,34,288,19,4,345,47,250,30,21,348
2020,48014,Empoli,FI,60,49,303,28,4,385,45,229,29,16,319
2020,48014,Empoli,FI,61,31,236,15,4,286,33,243,26,22,324
2020,48014,Empoli,FI,62,31,213,21,7,272,34,240,26,34,334
2020,48014,Empoli,FI,63,27,207,16,4,254,30,199,22,25,276
2020,48014,Empoli,FI,64,25,195,22,3,246,23,211,21,40,295
2020,48014,Empoli,FI,65,23,194,12,6,235,29,204,11,33,277
2020,48014,Empoli,FI,66,13,206,14,7,240,19,201,11,39,270
2020,48014,Empoli,FI,67,21,180,16,9,227,15,156,22,37,230
2020,48014,Empoli,FI,68,14,215,4,6,239,22,223,21,30,296
2020,48014,Empoli,FI,69,16,185,9,13,224,14,182,13,31,240
2020,48014,Empoli,FI,70,15,189,5,4,213,22,184,17,49,272
2020,48014,Empoli,FI,71,13,209,8,8,238,16,159,23,64,262
2020,48014,Empoli,FI,72,19,218,5,12,254,19,211,14,71,315
2020,48014,Empoli,FI,73,13,230,10,15,268,18,220,17,70,325
2020,48014,Empoli,FI,74,14,201,7,15,237,16,194,13,75,298
2020,48014,Empoli,FI,75,10,144,7,23,184,12,190,8,87,297
2020,48014,Empoli,FI,76,11,172,6,13,202,6,164,11,70,251
2020,48014,Empoli,FI,77,7,158,3,16,184,5,126,12,93,236
2020,48014,Empoli,FI,78,5,133,6,13,157,9,125,4,92,230
2020,48014,Empoli,FI,79,13,161,1,13,188,15,121,3,85,224
2020,48014,Empoli,FI,80,5,166,5,16,192,21,126,6,126,279
2020,48014,Empoli,FI,81,9,132,5,29,175,11,113,1,121,246
2020,48014,Empoli,FI,82,8,171,3,30,212,16,100,3,124,243
2020,48014,Empoli,FI,83,10,122,5,24,161,8,92,7,137,244
2020,48014,Empoli,FI,84,9,102,1,26,138,7,71,1,117,196
2020,48014,Empoli,FI,85,5,95,0,27,127,8,55,3,140,206
2020,48014,Empoli,FI,86,4,85,2,16,107,7,51,3,128,189
2020,48014,Empoli,FI,87,4,72,1,24,101,4,40,0,147,191
2020,48014,Empoli,FI,88,4,54,1,18,77,9,22,3,128,162
2020,48014,Empoli,FI,89,2,51,0,16,69,6,24,0,109,139
2020,48014,Empoli,FI,90,1,30,0,19,50,9,12,2,107,130
2020,48014,Empoli,FI,91,4,27,0,21,52,5,10,0,90,105
2020,48014,Empoli,FI,92,2,25,0,19,46,6,9,0,67,82
2020,48014,Empoli,FI,93,1,13,0,20,34,1,4,0,65,70
2020,48014,Empoli,FI,94,3,10,0,8,21,2,1,0,48,51
2020,48014,Empoli,FI,95,0,4,0,6,10,0,4,0,38,42
2020,48014,Empoli,FI,96,0,6,0,7,13,1,1,0,31,33
2020,48014,Empoli,FI,97,0,4,0,3,7,0,0,0,22,22
2020,48014,Empoli,FI,98,0,1,0,3,4,1,0,0,17,18
2020,48014,Empoli,FI,99,0,1,0,3,4,0,0,0,7,7
2020,48014,Empoli,FI,100 e più,0,0,0,1,1,0,0,0,12,12
2020,48015,Fiesole,FI,0,40,0,0,0,40,37,0,0,0,37
2020,48015,Fiesole,FI,1,50,0,0,0,50,38,0,0,0,38
2020,48015,Fiesole,FI,2,46,0,0,0,46,50,0,0,0,50
2020,48015,Fiesole,FI,3,61,0,0,0,61,53,0,0,0,53
2020,48015,Fiesole,FI,4,34,0,0,0,34,50,0,0,0,50
2020,48015,Fiesole,FI,5,61,0,0,0,61,33,0,0,0,33
2020,48015,Fiesole,FI,6,52,0,0,0,52,53,0,0,0,53
2020,48015,Fiesole,FI,7,44,0,0,0,44,51,0,0,0,51
2020,48015,Fiesole,FI,8,61,0,0,0,61,63,0,0,0,63
2020,48015,Fiesole,FI,9,47,0,0,0,47,68,0,0,0,68
2020,48015,Fiesole,FI,10,60,0,0,0,60,64,0,0,0,64
2020,48015,Fiesole,FI,11,73,0,0,0,73,65,0,0,0,65
2020,48015,Fiesole,FI,12,58,0,0,0,58,69,0,0,0,69
2020,48015,Fiesole,FI,13,68,0,0,0,68,43,0,0,0,43
2020,48015,Fiesole,FI,14,75,0,0,0,75,65,0,0,0,65
2020,48015,Fiesole,FI,15,70,0,0,0,70,53,0,0,0,53
2020,48015,Fiesole,FI,16,57,0,0,0,57,73,0,0,0,73
2020,48015,Fiesole,FI,17,63,0,0,0,63,53,0,0,0,53
2020,48015,Fiesole,FI,18,72,0,0,0,72,56,0,0,0,56
2020,48015,Fiesole,FI,19,65,0,0,0,65,64,0,1,0,65
2020,48015,Fiesole,FI,20,55,0,0,0,55,52,0,0,0,52
2020,48015,Fiesole,FI,21,63,0,0,0,63,41,0,0,0,41
2020,48015,Fiesole,FI,22,71,0,0,0,71,52,1,0,0,53
2020,48015,Fiesole,FI,23,63,0,0,0,63,45,0,0,0,45
2020,48015,Fiesole,FI,24,72,0,0,3,75,48,1,0,0,49
2020,48015,Fiesole,FI,25,64,0,1,0,65,59,1,0,0,60
2020,48015,Fiesole,FI,26,60,2,0,0,62,53,4,0,0,57
2020,48015,Fiesole,FI,27,67,0,0,0,67,44,2,0,0,46
2020,48015,Fiesole,FI,28,60,3,0,0,63,64,9,0,0,73
2020,48015,Fiesole,FI,29,63,3,1,0,67,41,6,0,0,47
2020,48015,Fiesole,FI,30,54,10,1,0,65,49,11,1,0,61
2020,48015,Fiesole,FI,31,57,3,0,0,60,42,14,0,0,56
2020,48015,Fiesole,FI,32,48,13,0,0,61,42,15,1,0,58
2020,48015,Fiesole,FI,33,49,21,0,0,70,59,26,1,0,86
2020,48015,Fiesole,FI,34,49,7,2,0,58,36,35,1,0,72
2020,48015,Fiesole,FI,35,52,16,2,0,70,43,29,0,0,72
2020,48015,Fiesole,FI,36,49,21,0,0,70,39,37,1,0,77
2020,48015,Fiesole,FI,37,48,22,3,0,73,34,30,3,0,67
2020,48015,Fiesole,FI,38,59,26,4,0,89,35,29,2,0,66
2020,48015,Fiesole,FI,39,34,22,0,0,56,27,39,4,0,70
2020,48015,Fiesole,FI,40,39,27,4,0,70,31,36,5,1,73
2020,48015,Fiesole,FI,41,51,37,3,0,91,35,45,3,0,83
2020,48015,Fiesole,FI,42,36,37,1,0,74,43,43,3,0,89
2020,48015,Fiesole,FI,43,37,48,3,0,88,31,51,8,0,90
2020,48015,Fiesole,FI,44,37,46,5,0,88,33,65,6,0,104
2020,48015,Fiesole,FI,45,47,41,4,0,92,38,62,8,0,108
2020,48015,Fiesole,FI,46,40,60,1,0,101,39,69,3,0,111
2020,48015,Fiesole,FI,47,27,69,5,0,101,44,81,9,0,134
2020,48015,Fiesole,FI,48,38,49,8,0,95,31,76,9,0,116
2020,48015,Fiesole,FI,49,37,63,3,1,104,28,83,9,2,122
2020,48015,Fiesole,FI,50,31,73,5,0,109,29,68,5,3,105
2020,48015,Fiesole,FI,51,45,69,2,0,116,15,64,11,1,91
2020,48015,Fiesole,FI,52,31,70,9,1,111,20,73,17,2,112
2020,48015,Fiesole,FI,53,25,64,10,1,100,20,92,12,0,124
2020,48015,Fiesole,FI,54,29,80,4,1,114,27,81,14,2,124
2020,48015,Fiesole,FI,55,23,86,11,0,120,18,79,7,5,109
2020,48015,Fiesole,FI,56,25,70,13,0,108,20,78,8,1,107
2020,48015,Fiesole,FI,57,19,77,5,1,102,16,76,14,2,108
2020,48015,Fiesole,FI,58,15,72,12,0,99,20,74,12,3,109
2020,48015,Fiesole,FI,59,22,72,7,2,103,14,83,9,7,113
2020,48015,Fiesole,FI,60,16,68,6,0,90,8,77,7,7,99
2020,48015,Fiesole,FI,61,10,62,9,2,83,14,67,8,6,95
2020,48015,Fiesole,FI,62,7,65,2,2,76,11,63,5,3,82
2020,48015,Fiesole,FI,63,9,69,8,0,86,12,75,9,8,104
2020,48015,Fiesole,FI,64,8,62,5,7,82,9,75,6,4,94
2020,48015,Fiesole,FI,65,11,66,4,4,85,9,76,8,9,102
2020,48015,Fiesole,FI,66,8,76,6,2,92,8,59,8,12,87
2020,48015,Fiesole,FI,67,8,63,2,1,74,6,66,4,5,81
2020,48015,Fiesole,FI,68,4,61,4,3,72,5,66,4,12,87
2020,48015,Fiesole,FI,69,8,57,3,3,71,4,65,9,8,86
2020,48015,Fiesole,FI,70,7,73,3,4,87,9,71,4,20,104
2020,48015,Fiesole,FI,71,9,76,6,4,95,5,66,8,19,98
2020,48015,Fiesole,FI,72,4,69,4,5,82,5,78,5,18,106
2020,48015,Fiesole,FI,73,4,67,7,6,84,1,77,5,22,105
2020,48015,Fiesole,FI,74,6,65,3,12,86,5,71,3,22,101
2020,48015,Fiesole,FI,75,3,68,4,4,79,0,57,4,24,85
2020,48015,Fiesole,FI,76,6,61,5,7,79,7,49,1,16,73
2020,48015,Fiesole,FI,77,2,65,2,5,74,6,47,1,29,83
2020,48015,Fiesole,FI,78,4,59,3,5,71,3,47,3,29,82
2020,48015,Fiesole,FI,79,7,48,0,8,63,7,44,4,31,86
2020,48015,Fiesole,FI,80,7,59,2,5,73,8,46,2,44,100
2020,48015,Fiesole,FI,81,3,49,2,14,68,10,36,2,42,90
2020,48015,Fiesole,FI,82,5,52,2,9,68,3,49,1,55,108
2020,48015,Fiesole,FI,83,6,33,2,12,53,5,19,4,53,81
2020,48015,Fiesole,FI,84,3,42,1,6,52,4,23,1,42,70
2020,48015,Fiesole,FI,85,4,32,0,12,48,6,19,0,40,65
2020,48015,Fiesole,FI,86,2,31,0,8,41,5,17,0,46,68
2020,48015,Fiesole,FI,87,1,19,2,12,34,4,17,1,35,57
2020,48015,Fiesole,FI,88,2,19,0,8,29,3,9,1,31,44
2020,48015,Fiesole,FI,89,2,18,0,3,23,6,8,0,36,50
2020,48015,Fiesole,FI,90,1,14,0,9,24,4,3,1,36,44
2020,48015,Fiesole,FI,91,0,15,0,2,17,4,5,0,19,28
2020,48015,Fiesole,FI,92,0,6,0,5,11,3,3,1,25,32
2020,48015,Fiesole,FI,93,3,7,0,4,14,1,1,0,18,20
2020,48015,Fiesole,FI,94,0,3,0,1,4,3,1,0,11,15
2020,48015,Fiesole,FI,95,0,1,0,3,4,0,0,0,13,13
2020,48015,Fiesole,FI,96,0,1,0,2,3,0,0,0,11,11
2020,48015,Fiesole,FI,97,0,0,0,2,2,1,0,0,5,6
2020,48015,Fiesole,FI,98,0,0,0,0,0,0,0,0,3,3
2020,48015,Fiesole,FI,99,0,2,0,0,2,0,0,0,4,4
2020,48015,Fiesole,FI,100 e più,0,0,0,1,1,2,0,0,4,6
2020,48017,Firenze,FI,0,1212,0,0,0,1212,1167,0,0,0,1167
2020,48017,Firenze,FI,1,1191,0,0,0,1191,1226,0,0,0,1226
2020,48017,Firenze,FI,2,1296,0,0,0,1296,1219,0,0,0,1219
2020,48017,Firenze,FI,3,1340,0,0,0,1340,1288,0,0,0,1288
2020,48017,Firenze,FI,4,1447,0,0,0,1447,1323,0,0,0,1323
2020,48017,Firenze,FI,5,1420,0,0,0,1420,1378,0,0,0,1378
2020,48017,Firenze,FI,6,1497,0,0,0,1497,1458,0,0,0,1458
2020,48017,Firenze,FI,7,1503,0,0,0,1503,1330,0,0,0,1330
2020,48017,Firenze,FI,8,1559,0,0,0,1559,1435,0,0,0,1435
2020,48017,Firenze,FI,9,1528,0,0,0,1528,1416,0,0,0,1416
2020,48017,Firenze,FI,10,1550,0,0,0,1550,1464,0,0,0,1464
2020,48017,Firenze,FI,11,1535,0,0,0,1535,1499,0,0,0,1499
2020,48017,Firenze,FI,12,1652,0,0,0,1652,1377,0,0,0,1377
2020,48017,Firenze,FI,13,1631,0,0,0,1631,1490,0,0,0,1490
2020,48017,Firenze,FI,14,1566,0,0,0,1566,1457,0,0,0,1457
2020,48017,Firenze,FI,15,1618,0,0,0,1618,1563,0,0,0,1563
2020,48017,Firenze,FI,16,1666,0,0,0,1666,1499,0,0,0,1499
2020,48017,Firenze,FI,17,1677,0,0,0,1677,1501,2,0,0,1503
2020,48017,Firenze,FI,18,1603,0,0,0,1603,1535,3,0,0,1538
2020,48017,Firenze,FI,19,1676,0,0,0,1676,1611,4,0,0,1615
2020,48017,Firenze,FI,20,1876,1,0,0,1877,1774,9,0,0,1783
2020,48017,Firenze,FI,21,1814,12,0,0,1826,1741,61,0,0,1802
2020,48017,Firenze,FI,22,1865,9,0,0,1874,1747,83,1,0,1831
2020,48017,Firenze,FI,23,1867,19,0,0,1886,1748,62,1,0,1811
2020,48017,Firenze,FI,24,1782,17,0,0,1799,1733,94,1,0,1828
2020,48017,Firenze,FI,25,1734,35,0,0,1769,1649,165,1,3,1818
2020,48017,Firenze,FI,26,1715,37,3,0,1756,1626,182,1,0,1809
2020,48017,Firenze,FI,27,1768,61,1,0,1831,1604,198,6,0,1808
2020,48017,Firenze,FI,28,1780,106,1,0,1888,1752,262,8,0,2023
2020,48017,Firenze,FI,29,1750,152,2,0,1906,1746,320,7,0,2074
2020,48017,Firenze,FI,30,1789,205,6,0,2001,1661,352,14,0,2027
2020,48017,Firenze,FI,31,1668,269,5,0,1943,1678,481,11,0,2172
2020,48017,Firenze,FI,32,1701,361,6,0,2071,1528,576,19,1,2124
2020,48017,Firenze,FI,33,1553,459,13,0,2028,1409,598,35,1,2044
2020,48017,Firenze,FI,34,1528,452,10,0,1992,1358,722,34,3,2120
2020,48017,Firenze,FI,35,1537,551,12,0,2101,1343,827,41,1,2217
2020,48017,Firenze,FI,36,1411,662,25,0,2100,1311,833,39,3,2186
2020,48017,Firenze,FI,37,1393,741,32,2,2171,1302,1013,51,3,2371
2020,48017,Firenze,FI,38,1399,815,26,3,2248,1223,1038,66,8,2338
2020,48017,Firenze,FI,39,1308,845,32,2,2194,1204,1012,46,6,2269
2020,48017,Firenze,FI,40,1239,966,37,3,2248,1156,1049,69,11,2288
2020,48017,Firenze,FI,41,1234,981,47,3,2271,1134,1113,85,14,2350
2020,48017,Firenze,FI,42,1307,1005,49,4,2367,1180,1213,109,16,2524
2020,48017,Firenze,FI,43,1232,1149,58,2,2444,1154,1280,112,9,2556
2020,48017,Firenze,FI,44,1254,1163,74,1,2495,1135,1363,123,14,2641
2020,48017,Firenze,FI,45,1316,1199,86,5,2612,1107,1468,144,13,2737
2020,48017,Firenze,FI,46,1302,1348,94,6,2759,1217,1671,172,16,3081
2020,48017,Firenze,FI,47,1247,1348,101,6,2710,1203,1602,180,20,3006
2020,48017,Firenze,FI,48,1114,1527,123,7,2775,1153,1627,213,36,3034
2020,48017,Firenze,FI,49,1060,1571,154,11,2799,1112,1737,238,34,3122
2020,48017,Firenze,FI,50,1077,1611,133,9,2833,1067,1722,260,34,3085
2020,48017,Firenze,FI,51,984,1622,173,12,2798,1073,1778,287,37,3176
2020,48017,Firenze,FI,52,965,1702,172,9,2857,991,1767,281,54,3098
2020,48017,Firenze,FI,53,917,1742,196,17,2876,934,1823,292,70,3121
2020,48017,Firenze,FI,54,902,1836,210,18,2973,899,1894,300,55,3149
2020,48017,Firenze,FI,55,806,1893,199,23,2928,834,1879,334,72,3120
2020,48017,Firenze,FI,56,782,1861,199,29,2879,819,1932,371,80,3204
2020,48017,Firenze,FI,57,642,1725,215,26,2617,758,1734,320,82,2896
2020,48017,Firenze,FI,58,598,1691,225,25,2546,680,1718,324,99,2823
2020,48017,Firenze,FI,59,552,1636,199,33,2430,665,1608,289,109,2672
2020,48017,Firenze,FI,60,491,1563,198,34,2295,576,1669,340,127,2714
2020,48017,Firenze,FI,61,431,1568,221,35,2264,612,1568,320,134,2637
2020,48017,Firenze,FI,62,375,1518,160,48,2112,536,1551,286,158,2535
2020,48017,Firenze,FI,63,335,1522,184,43,2092,487,1545,278,174,2486
2020,48017,Firenze,FI,64,362,1455,162,54,2041,435,1564,277,192,2469
2020,48017,Firenze,FI,65,305,1469,159,48,1986,424,1433,273,212,2349
2020,48017,Firenze,FI,66,279,1446,159,52,1940,401,1448,279,215,2345
2020,48017,Firenze,FI,67,278,1389,112,60,1843,355,1348,226,219,2149
2020,48017,Firenze,FI,68,252,1329,129,70,1782,319,1406,218,249,2193
2020,48017,Firenze,FI,69,208,1423,121,65,1823,273,1381,242,276,2173
2020,48017,Firenze,FI,70,197,1382,133,74,1789,276,1413,212,324,2228
2020,48017,Firenze,FI,71,192,1467,121,85,1867,273,1490,218,404,2386
2020,48017,Firenze,FI,72,181,1527,134,102,1946,244,1524,234,472,2475
2020,48017,Firenze,FI,73,174,1568,121,123,1988,243,1516,214,529,2502
2020,48017,Firenze,FI,74,146,1646,109,149,2055,252,1493,221,600,2566
2020,48017,Firenze,FI,75,119,1220,76,121,1536,180,1208,162,497,2048
2020,48017,Firenze,FI,76,101,1252,67,127,1551,185,1124,125,583,2019
2020,48017,Firenze,FI,77,100,1219,51,163,1534,186,1139,129,624,2078
2020,48017,Firenze,FI,78,112,1068,57,151,1390,201,998,128,673,2000
2020,48017,Firenze,FI,79,104,1079,66,158,1409,151,1026,115,762,2054
2020,48017,Firenze,FI,80,120,1234,49,199,1604,197,1041,109,932,2280
2020,48017,Firenze,FI,81,110,1171,45,216,1542,185,938,117,980,2220
2020,48017,Firenze,FI,82,92,1112,47,236,1487,195,868,87,1061,2211
2020,48017,Firenze,FI,83,71,892,40,189,1192,168,658,68,955,1849
2020,48017,Firenze,FI,84,46,748,26,183,1003,143,535,67,964,1709
2020,48017,Firenze,FI,85,55,740,20,193,1008,157,506,57,957,1678
2020,48017,Firenze,FI,86,38,608,22,193,861,157,354,40,996,1547
2020,48017,Firenze,FI,87,36,538,7,184,767,117,286,26,1000,1429
2020,48017,Firenze,FI,88,33,447,11,175,666,125,224,35,877,1261
2020,48017,Firenze,FI,89,28,409,16,162,616,96,187,27,882,1192
2020,48017,Firenze,FI,90,29,318,11,182,541,95,133,36,860,1124
2020,48017,Firenze,FI,91,15,252,7,161,435,81,92,13,746,932
2020,48017,Firenze,FI,92,15,165,2,118,300,70,66,15,647,798
2020,48017,Firenze,FI,93,12,130,6,90,238,66,41,9,556,672
2020,48017,Firenze,FI,94,8,91,2,71,172,48,35,11,427,521
2020,48017,Firenze,FI,95,7,51,1,54,113,31,15,6,363,415
2020,48017,Firenze,FI,96,5,39,2,47,93,31,14,5,282,332
2020,48017,Firenze,FI,97,4,28,0,50,82,21,7,4,230,262
2020,48017,Firenze,FI,98,3,16,0,25,44,20,7,2,166,195
2020,48017,Firenze,FI,99,0,5,0,24,29,10,3,0,108,121
2020,48017,Firenze,FI,100 e più,1,9,0,15,25,23,4,2,147,176
2020,48018,Firenzuola,FI,0,9,0,0,0,9,9,0,0,0,9
2020,48018,Firenzuola,FI,1,8,0,0,0,8,7,0,0,0,7
2020,48018,Firenzuola,FI,2,8,0,0,0,8,19,0,0,0,19
2020,48018,Firenzuola,FI,3,13,0,0,0,13,18,0,0,0,18
2020,48018,Firenzuola,FI,4,12,0,0,0,12,11,0,0,0,11
2020,48018,Firenzuola,FI,5,20,0,0,0,20,20,0,0,0,20
2020,48018,Firenzuola,FI,6,21,0,0,0,21,24,0,0,0,24
2020,48018,Firenzuola,FI,7,21,0,0,0,21,17,0,0,0,17
2020,48018,Firenzuola,FI,8,26,0,0,0,26,15,0,0,0,15
2020,48018,Firenzuola,FI,9,19,0,0,0,19,18,0,0,0,18
2020,48018,Firenzuola,FI,10,23,0,0,0,23,20,0,0,0,20
2020,48018,Firenzuola,FI,11,20,0,0,0,20,19,0,0,0,19
2020,48018,Firenzuola,FI,12,17,0,0,0,17,11,0,0,0,11
2020,48018,Firenzuola,FI,13,16,0,0,0,16,25,0,0,0,25
2020,48018,Firenzuola,FI,14,26,0,0,0,26,18,0,0,0,18
2020,48018,Firenzuola,FI,15,18,0,0,0,18,18,0,0,0,18
2020,48018,Firenzuola,FI,16,23,0,0,0,23,26,0,0,0,26
2020,48018,Firenzuola,FI,17,17,0,0,0,17,19,0,0,0,19
2020,48018,Firenzuola,FI,18,15,0,0,0,15,16,0,0,0,16
2020,48018,Firenzuola,FI,19,13,0,0,0,13,18,1,0,0,19
2020,48018,Firenzuola,FI,20,21,0,0,0,21,21,0,0,0,21
2020,48018,Firenzuola,FI,21,14,0,0,0,14,21,0,0,0,21
2020,48018,Firenzuola,FI,22,24,0,0,0,24,19,1,0,0,20
2020,48018,Firenzuola,FI,23,9,0,0,0,9,12,0,0,0,12
2020,48018,Firenzuola,FI,24,23,0,0,0,23,24,1,0,0,25
2020,48018,Firenzuola,FI,25,24,0,0,0,24,12,1,0,0,13
2020,48018,Firenzuola,FI,26,20,0,0,0,20,14,4,0,0,18
2020,48018,Firenzuola,FI,27,15,1,0,0,16,18,1,0,0,19
2020,48018,Firenzuola,FI,28,17,1,0,0,18,17,0,0,0,17
2020,48018,Firenzuola,FI,29,16,2,0,0,18,16,2,0,0,18
2020,48018,Firenzuola,FI,30,19,0,0,0,19,18,7,0,0,25
2020,48018,Firenzuola,FI,31,23,1,0,0,24,10,7,0,0,17
2020,48018,Firenzuola,FI,32,14,5,0,0,19,9,9,0,0,18
2020,48018,Firenzuola,FI,33,8,1,0,0,9,13,1,0,0,14
2020,48018,Firenzuola,FI,34,18,3,0,0,21,6,7,0,0,13
2020,48018,Firenzuola,FI,35,15,5,0,0,20,10,7,0,0,17
2020,48018,Firenzuola,FI,36,14,10,0,0,24,12,4,0,0,16
2020,48018,Firenzuola,FI,37,13,4,0,0,17,7,16,0,1,24
2020,48018,Firenzuola,FI,38,15,9,0,0,24,13,12,0,0,25
2020,48018,Firenzuola,FI,39,19,7,0,0,26,14,12,1,0,27
2020,48018,Firenzuola,FI,40,12,7,1,0,20,11,11,1,0,23
2020,48018,Firenzuola,FI,41,9,6,1,0,16,11,23,0,0,34
2020,48018,Firenzuola,FI,42,10,12,0,0,22,9,18,2,1,30
2020,48018,Firenzuola,FI,43,12,14,1,0,27,5,15,0,0,20
2020,48018,Firenzuola,FI,44,12,20,0,0,32,11,21,2,0,34
2020,48018,Firenzuola,FI,45,16,19,0,0,35,11,21,0,0,32
2020,48018,Firenzuola,FI,46,17,18,1,0,36,10,14,0,1,25
2020,48018,Firenzuola,FI,47,15,12,4,0,31,7,23,1,0,31
2020,48018,Firenzuola,FI,48,19,13,1,0,33,12,18,0,0,30
2020,48018,Firenzuola,FI,49,15,28,1,0,44,5,20,3,0,28
2020,48018,Firenzuola,FI,50,21,22,3,0,46,7,22,3,0,32
2020,48018,Firenzuola,FI,51,15,23,1,0,39,5,25,3,3,36
2020,48018,Firenzuola,FI,52,12,18,2,1,33,9,17,2,1,29
2020,48018,Firenzuola,FI,53,9,33,2,1,45,5,24,2,0,31
2020,48018,Firenzuola,FI,54,8,26,3,0,37,8,29,4,2,43
2020,48018,Firenzuola,FI,55,11,30,8,2,51,6,32,1,5,44
2020,48018,Firenzuola,FI,56,6,27,3,0,36,9,32,1,1,43
2020,48018,Firenzuola,FI,57,15,23,1,1,40,4,20,2,1,27
2020,48018,Firenzuola,FI,58,8,34,2,0,44,6,21,1,0,28
2020,48018,Firenzuola,FI,59,6,20,2,1,29,5,26,1,0,32
2020,48018,Firenzuola,FI,60,5,31,4,0,40,7,22,5,4,38
2020,48018,Firenzuola,FI,61,10,25,4,1,40,7,36,4,6,53
2020,48018,Firenzuola,FI,62,7,36,4,0,47,2,19,1,2,24
2020,48018,Firenzuola,FI,63,5,23,3,0,31,2,20,2,1,25
2020,48018,Firenzuola,FI,64,6,16,4,0,26,8,30,2,4,44
2020,48018,Firenzuola,FI,65,4,22,2,0,28,4,19,2,5,30
2020,48018,Firenzuola,FI,66,6,20,6,1,33,1,20,0,5,26
2020,48018,Firenzuola,FI,67,8,22,1,2,33,4,28,0,4,36
2020,48018,Firenzuola,FI,68,5,23,0,1,29,1,18,1,4,24
2020,48018,Firenzuola,FI,69,6,29,0,2,37,3,24,1,6,34
2020,48018,Firenzuola,FI,70,4,20,1,3,28,1,18,1,8,28
2020,48018,Firenzuola,FI,71,4,27,2,1,34,2,22,2,7,33
2020,48018,Firenzuola,FI,72,4,33,2,6,45,3,18,1,10,32
2020,48018,Firenzuola,FI,73,2,19,1,4,26,4,15,1,10,30
2020,48018,Firenzuola,FI,74,3,17,0,2,22,1,16,1,18,36
2020,48018,Firenzuola,FI,75,3,13,1,1,18,1,15,1,5,22
2020,48018,Firenzuola,FI,76,4,18,1,1,24,4,10,0,5,19
2020,48018,Firenzuola,FI,77,3,18,0,4,25,4,12,0,6,22
2020,48018,Firenzuola,FI,78,1,13,1,1,16,3,12,0,12,27
2020,48018,Firenzuola,FI,79,3,15,0,3,21,3,10,0,10,23
2020,48018,Firenzuola,FI,80,4,16,1,2,23,2,6,0,18,26
2020,48018,Firenzuola,FI,81,6,12,0,2,20,0,12,0,15,27
2020,48018,Firenzuola,FI,82,4,17,0,5,26,1,10,0,16,27
2020,48018,Firenzuola,FI,83,3,11,1,0,15,0,3,3,16,22
2020,48018,Firenzuola,FI,84,4,10,0,2,16,2,6,1,15,24
2020,48018,Firenzuola,FI,85,4,14,0,2,20,1,5,0,16,22
2020,48018,Firenzuola,FI,86,0,9,0,6,15,0,4,0,15,19
2020,48018,Firenzuola,FI,87,1,5,0,4,10,1,6,0,13,20
2020,48018,Firenzuola,FI,88,3,4,0,4,11,2,3,0,18,23
2020,48018,Firenzuola,FI,89,4,3,0,2,9,1,2,0,8,11
2020,48018,Firenzuola,FI,90,1,5,0,1,7,0,2,0,13,15
2020,48018,Firenzuola,FI,91,0,5,0,2,7,4,1,0,5,10
2020,48018,Firenzuola,FI,92,1,5,0,3,9,0,1,0,6,7
2020,48018,Firenzuola,FI,93,0,1,0,2,3,0,0,0,12,12
2020,48018,Firenzuola,FI,94,1,1,0,1,3,1,0,0,11,12
2020,48018,Firenzuola,FI,95,0,0,0,2,2,0,0,0,4,4
2020,48018,Firenzuola,FI,96,2,0,0,3,5,1,0,0,5,6
2020,48018,Firenzuola,FI,97,0,0,0,0,0,1,0,0,2,3
2020,48018,Firenzuola,FI,98,0,0,0,0,0,0,0,0,3,3
2020,48018,Firenzuola,FI,99,0,0,0,0,0,0,0,0,1,1
2020,48018,Firenzuola,FI,100 e più,0,0,0,1,1,0,1,0,1,2
2020,48019,Fucecchio,FI,0,81,0,0,0,81,70,0,0,0,70
2020,48019,Fucecchio,FI,1,68,0,0,0,68,75,0,0,0,75
2020,48019,Fucecchio,FI,2,81,0,0,0,81,79,0,0,0,79
2020,48019,Fucecchio,FI,3,82,0,0,0,82,85,0,0,0,85
2020,48019,Fucecchio,FI,4,87,0,0,0,87,86,0,0,0,86
2020,48019,Fucecchio,FI,5,104,0,0,0,104,84,0,0,0,84
2020,48019,Fucecchio,FI,6,109,0,0,0,109,88,0,0,0,88
2020,48019,Fucecchio,FI,7,87,0,0,0,87,101,0,0,0,101
2020,48019,Fucecchio,FI,8,120,0,0,0,120,119,0,0,0,119
2020,48019,Fucecchio,FI,9,106,0,0,0,106,104,0,0,0,104
2020,48019,Fucecchio,FI,10,118,0,0,0,118,113,0,0,0,113
2020,48019,Fucecchio,FI,11,118,0,0,0,118,112,0,0,0,112
2020,48019,Fucecchio,FI,12,142,0,0,0,142,102,0,0,0,102
2020,48019,Fucecchio,FI,13,118,0,0,0,118,104,0,0,0,104
2020,48019,Fucecchio,FI,14,137,0,0,0,137,110,0,0,0,110
2020,48019,Fucecchio,FI,15,113,0,0,0,113,116,0,0,0,116
2020,48019,Fucecchio,FI,16,121,0,0,0,121,113,0,0,0,113
2020,48019,Fucecchio,FI,17,121,0,0,0,121,97,0,0,0,97
2020,48019,Fucecchio,FI,18,105,0,0,0,105,101,0,0,0,101
2020,48019,Fucecchio,FI,19,129,0,0,0,129,80,3,0,0,83
2020,48019,Fucecchio,FI,20,120,0,0,0,120,106,0,0,0,106
2020,48019,Fucecchio,FI,21,112,0,0,0,112,110,3,0,0,113
2020,48019,Fucecchio,FI,22,116,0,0,0,116,93,7,0,0,100
2020,48019,Fucecchio,FI,23,109,0,0,0,109,88,6,0,0,94
2020,48019,Fucecchio,FI,24,126,2,0,0,128,103,16,1,0,121
2020,48019,Fucecchio,FI,25,101,3,0,0,104,85,5,0,0,90
2020,48019,Fucecchio,FI,26,115,5,0,0,120,93,18,0,0,111
2020,48019,Fucecchio,FI,27,108,4,0,0,112,74,16,0,0,90
2020,48019,Fucecchio,FI,28,92,12,0,0,104,74,23,0,0,97
2020,48019,Fucecchio,FI,29,97,9,0,0,106,95,29,0,0,124
2020,48019,Fucecchio,FI,30,90,24,1,0,115,80,31,0,0,111
2020,48019,Fucecchio,FI,31,86,31,1,0,118,81,39,2,0,122
2020,48019,Fucecchio,FI,32,105,18,0,0,123,51,45,0,0,96
2020,48019,Fucecchio,FI,33,93,33,1,0,127,57,48,2,1,108
2020,48019,Fucecchio,FI,34,74,39,0,0,113,65,75,1,0,141
2020,48019,Fucecchio,FI,35,72,50,0,0,122,60,65,0,0,125
2020,48019,Fucecchio,FI,36,62,54,0,0,116,47,80,4,0,131
2020,48019,Fucecchio,FI,37,75,51,2,0,128,54,77,0,1,132
2020,48019,Fucecchio,FI,38,74,63,1,0,138,53,77,2,0,132
2020,48019,Fucecchio,FI,39,84,67,2,0,153,35,109,4,0,148
2020,48019,Fucecchio,FI,40,52,60,4,0,116,60,84,6,0,150
2020,48019,Fucecchio,FI,41,77,104,8,0,189,43,93,9,2,147
2020,48019,Fucecchio,FI,42,77,95,4,0,176,47,131,8,1,188
2020,48019,Fucecchio,FI,43,66,110,5,0,181,59,125,6,1,191
2020,48019,Fucecchio,FI,44,86,105,7,0,198,42,140,8,1,192
2020,48019,Fucecchio,FI,45,57,119,13,0,189,34,128,14,2,178
2020,48019,Fucecchio,FI,46,75,148,8,1,232,37,158,15,6,216
2020,48019,Fucecchio,FI,47,59,144,4,0,207,30,140,17,2,189
2020,48019,Fucecchio,FI,48,56,132,9,0,197,36,148,17,1,202
2020,48019,Fucecchio,FI,49,52,140,9,2,203,29,121,12,8,170
2020,48019,Fucecchio,FI,50,51,146,7,1,205,28,140,13,2,183
2020,48019,Fucecchio,FI,51,27,153,5,2,187,26,124,23,5,178
2020,48019,Fucecchio,FI,52,45,125,13,3,186,27,168,16,1,212
2020,48019,Fucecchio,FI,53,25,136,10,2,173,26,137,19,3,185
2020,48019,Fucecchio,FI,54,29,156,14,1,200,18,137,17,13,185
2020,48019,Fucecchio,FI,55,23,145,13,1,182,23,134,27,5,189
2020,48019,Fucecchio,FI,56,26,160,14,3,203,18,129,11,3,161
2020,48019,Fucecchio,FI,57,24,126,12,2,164,13,136,11,11,171
2020,48019,Fucecchio,FI,58,16,146,11,0,173,13,131,4,5,153
2020,48019,Fucecchio,FI,59,13,132,13,2,160,13,128,6,10,157
2020,48019,Fucecchio,FI,60,12,118,7,4,141,6,136,15,15,172
2020,48019,Fucecchio,FI,61,16,113,9,4,142,12,115,11,9,147
2020,48019,Fucecchio,FI,62,15,109,14,3,141,8,99,9,16,132
2020,48019,Fucecchio,FI,63,9,112,10,1,132,5,117,12,18,152
2020,48019,Fucecchio,FI,64,9,118,10,3,140,6,103,9,12,130
2020,48019,Fucecchio,FI,65,12,99,6,4,121,10,111,5,16,142
2020,48019,Fucecchio,FI,66,7,103,12,2,124,5,123,9,17,154
2020,48019,Fucecchio,FI,67,3,110,5,7,125,9,96,9,29,143
2020,48019,Fucecchio,FI,68,6,90,6,5,107,2,116,5,15,138
2020,48019,Fucecchio,FI,69,7,95,4,4,110,7,94,6,32,139
2020,48019,Fucecchio,FI,70,3,99,2,8,112,8,131,10,25,174
2020,48019,Fucecchio,FI,71,7,110,3,7,127,6,97,8,32,143
2020,48019,Fucecchio,FI,72,4,113,5,9,131,4,104,5,29,142
2020,48019,Fucecchio,FI,73,7,115,3,8,133,8,101,1,42,152
2020,48019,Fucecchio,FI,74,4,113,1,7,126,9,106,4,31,150
2020,48019,Fucecchio,FI,75,4,92,2,11,109,5,62,3,42,112
2020,48019,Fucecchio,FI,76,4,67,2,11,84,7,67,2,34,110
2020,48019,Fucecchio,FI,77,7,78,2,10,97,4,67,1,39,111
2020,48019,Fucecchio,FI,78,2,71,2,6,81,2,41,1,48,92
2020,48019,Fucecchio,FI,79,4,61,2,7,74,1,55,2,53,111
2020,48019,Fucecchio,FI,80,5,70,0,13,88,3,52,3,43,101
2020,48019,Fucecchio,FI,81,1,75,3,13,92,1,46,1,58,106
2020,48019,Fucecchio,FI,82,3,59,0,16,78,0,36,1,62,99
2020,48019,Fucecchio,FI,83,1,62,1,16,80,4,28,3,65,100
2020,48019,Fucecchio,FI,84,1,37,0,10,48,3,30,2,58,93
2020,48019,Fucecchio,FI,85,3,54,1,13,71,4,25,1,73,103
2020,48019,Fucecchio,FI,86,1,31,0,9,41,2,15,1,58,76
2020,48019,Fucecchio,FI,87,0,28,0,6,34,1,8,0,51,60
2020,48019,Fucecchio,FI,88,2,15,0,21,38,3,4,1,55,63
2020,48019,Fucecchio,FI,89,4,13,1,8,26,2,9,0,68,79
2020,48019,Fucecchio,FI,90,0,12,0,5,17,3,5,0,52,60
2020,48019,Fucecchio,FI,91,0,6,0,7,13,0,3,0,37,40
2020,48019,Fucecchio,FI,92,0,10,0,3,13,0,2,0,30,32
2020,48019,Fucecchio,FI,93,2,4,0,6,12,1,0,0,29,30
2020,48019,Fucecchio,FI,94,1,5,0,5,11,0,0,1,20,21
2020,48019,Fucecchio,FI,95,0,1,0,0,1,0,0,1,20,21
2020,48019,Fucecchio,FI,96,0,2,0,5,7,0,0,0,14,14
2020,48019,Fucecchio,FI,97,0,0,0,3,3,0,0,1,11,12
2020,48019,Fucecchio,FI,98,0,3,0,0,3,0,0,0,3,3
2020,48019,Fucecchio,FI,99,0,0,0,1,1,0,0,0,7,7
2020,48019,Fucecchio,FI,100 e più,0,0,0,1,1,0,0,0,6,6
2020,48020,Gambassi Terme,FI,0,23,0,0,0,23,11,0,0,0,11
2020,48020,Gambassi Terme,FI,1,16,0,0,0,16,20,0,0,0,20
2020,48020,Gambassi Terme,FI,2,10,0,0,0,10,19,0,0,0,19
2020,48020,Gambassi Terme,FI,3,18,0,0,0,18,14,0,0,0,14
2020,48020,Gambassi Terme,FI,4,17,0,0,0,17,13,0,0,0,13
2020,48020,Gambassi Terme,FI,5,23,0,0,0,23,23,0,0,0,23
2020,48020,Gambassi Terme,FI,6,23,0,0,0,23,16,0,0,0,16
2020,48020,Gambassi Terme,FI,7,19,0,0,0,19,13,0,0,0,13
2020,48020,Gambassi Terme,FI,8,16,0,0,0,16,20,0,0,0,20
2020,48020,Gambassi Terme,FI,9,17,0,0,0,17,17,0,0,0,17
2020,48020,Gambassi Terme,FI,10,20,0,0,0,20,19,0,0,0,19
2020,48020,Gambassi Terme,FI,11,33,0,0,0,33,20,0,0,0,20
2020,48020,Gambassi Terme,FI,12,25,0,0,0,25,16,0,0,0,16
2020,48020,Gambassi Terme,FI,13,30,0,0,0,30,13,0,0,0,13
2020,48020,Gambassi Terme,FI,14,24,0,0,0,24,17,0,0,0,17
2020,48020,Gambassi Terme,FI,15,27,0,0,0,27,19,0,0,0,19
2020,48020,Gambassi Terme,FI,16,18,0,0,0,18,29,0,0,0,29
2020,48020,Gambassi Terme,FI,17,24,0,0,0,24,14,0,0,0,14
2020,48020,Gambassi Terme,FI,18,28,0,0,0,28,17,0,0,0,17
2020,48020,Gambassi Terme,FI,19,17,0,0,0,17,29,0,0,0,29
2020,48020,Gambassi Terme,FI,20,26,0,0,0,26,18,0,0,0,18
2020,48020,Gambassi Terme,FI,21,27,0,0,0,27,20,0,0,0,20
2020,48020,Gambassi Terme,FI,22,15,0,0,0,15,27,2,0,0,29
2020,48020,Gambassi Terme,FI,23,28,1,0,0,29,23,0,0,0,23
2020,48020,Gambassi Terme,FI,24,19,0,0,0,19,17,2,0,0,19
2020,48020,Gambassi Terme,FI,25,29,0,0,0,29,24,5,0,0,29
2020,48020,Gambassi Terme,FI,26,19,3,0,0,22,14,4,0,0,18
2020,48020,Gambassi Terme,FI,27,19,0,0,0,19,25,2,0,0,27
2020,48020,Gambassi Terme,FI,28,29,0,0,0,29,8,1,0,0,9
2020,48020,Gambassi Terme,FI,29,20,1,1,0,22,19,8,0,0,27
2020,48020,Gambassi Terme,FI,30,15,5,0,0,20,13,6,1,0,20
2020,48020,Gambassi Terme,FI,31,18,2,0,0,20,16,3,1,0,20
2020,48020,Gambassi Terme,FI,32,16,6,0,0,22,10,14,0,0,24
2020,48020,Gambassi Terme,FI,33,18,7,0,0,25,18,13,1,0,32
2020,48020,Gambassi Terme,FI,34,20,3,0,0,23,13,8,0,0,21
2020,48020,Gambassi Terme,FI,35,16,6,0,0,22,20,7,2,0,29
2020,48020,Gambassi Terme,FI,36,11,11,0,0,22,12,15,1,0,28
2020,48020,Gambassi Terme,FI,37,13,8,0,0,21,14,16,0,0,30
2020,48020,Gambassi Terme,FI,38,11,9,3,0,23,8,17,1,0,26
2020,48020,Gambassi Terme,FI,39,18,14,0,0,32,12,21,0,0,33
2020,48020,Gambassi Terme,FI,40,21,13,1,0,35,14,16,2,0,32
2020,48020,Gambassi Terme,FI,41,18,16,0,0,34,11,20,1,0,32
2020,48020,Gambassi Terme,FI,42,17,14,0,0,31,6,14,3,0,23
2020,48020,Gambassi Terme,FI,43,11,23,0,0,34,13,25,0,0,38
2020,48020,Gambassi Terme,FI,44,17,18,1,1,37,17,18,1,2,38
2020,48020,Gambassi Terme,FI,45,15,21,2,0,38,7,26,3,0,36
2020,48020,Gambassi Terme,FI,46,15,22,1,0,38,13,18,1,0,32
2020,48020,Gambassi Terme,FI,47,10,27,1,0,38,8,28,4,0,40
2020,48020,Gambassi Terme,FI,48,7,23,3,0,33,10,25,3,1,39
2020,48020,Gambassi Terme,FI,49,10,27,1,0,38,6,25,5,1,37
2020,48020,Gambassi Terme,FI,50,15,20,3,1,39,6,25,2,0,33
2020,48020,Gambassi Terme,FI,51,16,30,3,0,49,3,34,2,1,40
2020,48020,Gambassi Terme,FI,52,6,25,0,0,31,6,32,3,2,43
2020,48020,Gambassi Terme,FI,53,8,21,2,1,32,8,16,2,0,26
2020,48020,Gambassi Terme,FI,54,11,35,3,1,50,3,34,4,3,44
2020,48020,Gambassi Terme,FI,55,7,32,2,0,41,3,42,5,3,53
2020,48020,Gambassi Terme,FI,56,5,26,4,0,35,5,35,5,1,46
2020,48020,Gambassi Terme,FI,57,5,30,4,0,39,4,30,3,1,38
2020,48020,Gambassi Terme,FI,58,3,28,3,0,34,3,39,5,1,48
2020,48020,Gambassi Terme,FI,59,0,29,3,0,32,5,34,5,1,45
2020,48020,Gambassi Terme,FI,60,3,26,6,0,35,5,17,2,1,25
2020,48020,Gambassi Terme,FI,61,5,33,4,0,42,1,21,1,3,26
2020,48020,Gambassi Terme,FI,62,2,29,2,3,36,3,33,3,5,44
2020,48020,Gambassi Terme,FI,63,2,20,3,1,26,6,24,2,2,34
2020,48020,Gambassi Terme,FI,64,6,26,1,2,35,3,28,3,6,40
2020,48020,Gambassi Terme,FI,65,3,32,3,3,41,1,29,0,5,35
2020,48020,Gambassi Terme,FI,66,4,27,1,2,34,3,24,4,2,33
2020,48020,Gambassi Terme,FI,67,1,25,1,1,28,0,25,1,3,29
2020,48020,Gambassi Terme,FI,68,1,16,0,2,19,0,26,2,6,34
2020,48020,Gambassi Terme,FI,69,3,29,0,1,33,0,24,0,2,26
2020,48020,Gambassi Terme,FI,70,3,23,0,0,26,1,21,2,5,29
2020,48020,Gambassi Terme,FI,71,0,31,0,3,34,0,21,1,5,27
2020,48020,Gambassi Terme,FI,72,3,30,1,1,35,3,18,2,7,30
2020,48020,Gambassi Terme,FI,73,1,23,0,3,27,1,22,1,9,33
2020,48020,Gambassi Terme,FI,74,1,13,0,1,15,1,15,0,8,24
2020,48020,Gambassi Terme,FI,75,1,20,0,4,25,0,14,1,7,22
2020,48020,Gambassi Terme,FI,76,0,18,0,1,19,1,12,1,10,24
2020,48020,Gambassi Terme,FI,77,0,16,1,3,20,1,8,0,7,16
2020,48020,Gambassi Terme,FI,78,1,12,1,2,16,2,12,3,8,25
2020,48020,Gambassi Terme,FI,79,1,13,0,2,16,1,11,0,9,21
2020,48020,Gambassi Terme,FI,80,0,15,0,2,17,0,11,1,19,31
2020,48020,Gambassi Terme,FI,81,0,11,1,2,14,0,10,0,14,24
2020,48020,Gambassi Terme,FI,82,0,10,0,7,17,2,8,0,17,27
2020,48020,Gambassi Terme,FI,83,1,12,0,4,17,0,10,0,10,20
2020,48020,Gambassi Terme,FI,84,0,7,0,1,8,0,8,1,11,20
2020,48020,Gambassi Terme,FI,85,1,11,0,1,13,1,1,0,12,14
2020,48020,Gambassi Terme,FI,86,0,4,0,2,6,0,6,0,12,18
2020,48020,Gambassi Terme,FI,87,0,10,0,1,11,1,4,0,14,19
2020,48020,Gambassi Terme,FI,88,1,5,0,4,10,0,2,0,10,12
2020,48020,Gambassi Terme,FI,89,0,9,0,2,11,0,5,0,10,15
2020,48020,Gambassi Terme,FI,90,1,5,0,2,8,2,1,0,9,12
2020,48020,Gambassi Terme,FI,91,0,5,0,3,8,1,0,0,10,11
2020,48020,Gambassi Terme,FI,92,1,2,1,1,5,0,0,0,7,7
2020,48020,Gambassi Terme,FI,93,0,1,0,1,2,1,2,0,4,7
2020,48020,Gambassi Terme,FI,94,0,0,0,1,1,1,0,0,8,9
2020,48020,Gambassi Terme,FI,95,0,1,0,1,2,0,0,0,6,6
2020,48020,Gambassi Terme,FI,96,0,0,0,0,0,0,0,0,6,6
2020,48020,Gambassi Terme,FI,97,0,1,0,1,2,0,0,0,2,2
2020,48020,Gambassi Terme,FI,98,0,0,0,0,0,0,0,0,2,2
2020,48020,Gambassi Terme,FI,99,0,0,0,0,0,0,0,0,2,2
2020,48020,Gambassi Terme,FI,100 e più,0,0,0,0,0,0,0,0,0,0
2020,48021,Greve in Chianti,FI,0,38,0,0,0,38,53,0,0,0,53
2020,48021,Greve in Chianti,FI,1,38,0,0,0,38,47,0,0,0,47
2020,48021,Greve in Chianti,FI,2,41,0,0,0,41,36,0,0,0,36
2020,48021,Greve in Chianti,FI,3,46,0,0,0,46,42,0,0,0,42
2020,48021,Greve in Chianti,FI,4,51,0,0,0,51,53,0,0,0,53
2020,48021,Greve in Chianti,FI,5,39,0,0,0,39,38,0,0,0,38
2020,48021,Greve in Chianti,FI,6,55,0,0,0,55,60,0,0,0,60
2020,48021,Greve in Chianti,FI,7,57,0,0,0,57,58,0,0,0,58
2020,48021,Greve in Chianti,FI,8,38,0,0,0,38,41,0,0,0,41
2020,48021,Greve in Chianti,FI,9,54,0,0,0,54,46,0,0,0,46
2020,48021,Greve in Chianti,FI,10,63,0,0,0,63,63,0,0,0,63
2020,48021,Greve in Chianti,FI,11,55,0,0,0,55,59,0,0,0,59
2020,48021,Greve in Chianti,FI,12,60,0,0,0,60,65,0,0,0,65
2020,48021,Greve in Chianti,FI,13,79,0,0,0,79,63,0,0,0,63
2020,48021,Greve in Chianti,FI,14,60,0,0,0,60,61,0,0,0,61
2020,48021,Greve in Chianti,FI,15,68,0,0,0,68,67,0,0,0,67
2020,48021,Greve in Chianti,FI,16,71,0,0,0,71,64,0,0,0,64
2020,48021,Greve in Chianti,FI,17,70,0,0,0,70,59,0,0,0,59
2020,48021,Greve in Chianti,FI,18,82,0,0,0,82,66,0,0,0,66
2020,48021,Greve in Chianti,FI,19,88,0,0,0,88,58,1,0,0,59
2020,48021,Greve in Chianti,FI,20,89,0,0,0,89,88,2,0,0,90
2020,48021,Greve in Chianti,FI,21,70,0,0,0,70,69,2,0,0,71
2020,48021,Greve in Chianti,FI,22,82,0,0,0,82,81,5,0,0,86
2020,48021,Greve in Chianti,FI,23,67,0,0,0,67,58,4,0,0,62
2020,48021,Greve in Chianti,FI,24,64,2,0,0,66,56,4,0,0,60
2020,48021,Greve in Chianti,FI,25,67,1,0,0,68,65,2,0,0,67
2020,48021,Greve in Chianti,FI,26,60,4,0,0,64,62,9,0,0,71
2020,48021,Greve in Chianti,FI,27,69,3,0,0,72,58,9,1,0,68
2020,48021,Greve in Chianti,FI,28,55,4,0,0,59,61,11,0,0,72
2020,48021,Greve in Chianti,FI,29,55,7,1,0,63,53,16,1,0,70
2020,48021,Greve in Chianti,FI,30,76,9,0,0,85,41,13,0,0,54
2020,48021,Greve in Chianti,FI,31,51,4,0,0,55,26,13,0,0,39
2020,48021,Greve in Chianti,FI,32,43,14,0,0,57,32,23,0,0,55
2020,48021,Greve in Chianti,FI,33,52,17,0,0,69,32,24,2,0,58
2020,48021,Greve in Chianti,FI,34,46,17,0,0,63,27,23,1,0,51
2020,48021,Greve in Chianti,FI,35,50,20,0,0,70,28,36,3,0,67
2020,48021,Greve in Chianti,FI,36,32,29,0,1,62,30,30,0,1,61
2020,48021,Greve in Chianti,FI,37,50,26,1,0,77,24,29,0,1,54
2020,48021,Greve in Chianti,FI,38,39,28,0,0,67,24,35,0,0,59
2020,48021,Greve in Chianti,FI,39,41,33,1,0,75,16,44,1,1,62
2020,48021,Greve in Chianti,FI,40,47,24,2,0,73,31,40,5,1,77
2020,48021,Greve in Chianti,FI,41,35,27,3,0,65,29,33,4,1,67
2020,48021,Greve in Chianti,FI,42,25,40,0,0,65,24,45,3,0,72
2020,48021,Greve in Chianti,FI,43,29,34,3,0,66,30,38,5,0,73
2020,48021,Greve in Chianti,FI,44,43,40,0,0,83,29,48,6,0,83
2020,48021,Greve in Chianti,FI,45,46,44,1,0,91,27,69,4,0,100
2020,48021,Greve in Chianti,FI,46,28,50,4,0,82,32,61,2,0,95
2020,48021,Greve in Chianti,FI,47,35,51,7,1,94,36,74,3,0,113
2020,48021,Greve in Chianti,FI,48,31,65,3,1,100,23,65,6,4,98
2020,48021,Greve in Chianti,FI,49,35,59,5,0,99,20,84,6,1,111
2020,48021,Greve in Chianti,FI,50,49,78,7,2,136,17,88,17,2,124
2020,48021,Greve in Chianti,FI,51,32,67,2,1,102,24,66,7,2,99
2020,48021,Greve in Chianti,FI,52,28,82,10,0,120,19,89,12,2,122
2020,48021,Greve in Chianti,FI,53,30,85,6,2,123,21,82,8,9,120
2020,48021,Greve in Chianti,FI,54,19,78,10,3,110,17,90,11,2,120
2020,48021,Greve in Chianti,FI,55,24,93,9,1,127,18,93,3,3,117
2020,48021,Greve in Chianti,FI,56,25,102,4,0,131,16,97,11,2,126
2020,48021,Greve in Chianti,FI,57,24,90,6,0,120,16,95,11,6,128
2020,48021,Greve in Chianti,FI,58,20,79,10,4,113,10,92,9,7,118
2020,48021,Greve in Chianti,FI,59,12,78,9,0,99,10,80,11,1,102
2020,48021,Greve in Chianti,FI,60,10,76,7,0,93,10,84,6,3,103
2020,48021,Greve in Chianti,FI,61,9,97,9,5,120,9,86,7,7,109
2020,48021,Greve in Chianti,FI,62,11,89,4,1,105,8,76,6,12,102
2020,48021,Greve in Chianti,FI,63,8,80,3,1,92,10,70,8,3,91
2020,48021,Greve in Chianti,FI,64,10,62,9,1,82,10,53,8,9,80
2020,48021,Greve in Chianti,FI,65,11,83,7,2,103,6,72,6,4,88
2020,48021,Greve in Chianti,FI,66,7,75,7,0,89,5,63,4,9,81
2020,48021,Greve in Chianti,FI,67,10,51,0,2,63,5,55,7,11,78
2020,48021,Greve in Chianti,FI,68,5,65,7,4,81,9,48,2,14,73
2020,48021,Greve in Chianti,FI,69,5,56,6,4,71,3,74,6,12,95
2020,48021,Greve in Chianti,FI,70,5,60,1,4,70,4,71,7,12,94
2020,48021,Greve in Chianti,FI,71,7,73,3,7,90,6,74,2,14,96
2020,48021,Greve in Chianti,FI,72,5,76,4,3,88,4,54,3,18,79
2020,48021,Greve in Chianti,FI,73,6,75,5,1,87,2,69,3,12,86
2020,48021,Greve in Chianti,FI,74,8,70,1,3,82,5,63,4,29,101
2020,48021,Greve in Chianti,FI,75,2,55,5,3,65,1,40,6,20,67
2020,48021,Greve in Chianti,FI,76,5,49,1,6,61,1,35,0,21,57
2020,48021,Greve in Chianti,FI,77,4,45,2,6,57,2,43,2,28,75
2020,48021,Greve in Chianti,FI,78,1,41,1,4,47,2,26,2,21,51
2020,48021,Greve in Chianti,FI,79,5,47,2,7,61,5,36,2,24,67
2020,48021,Greve in Chianti,FI,80,7,37,1,9,54,2,33,2,28,65
2020,48021,Greve in Chianti,FI,81,4,45,2,11,62,1,29,2,32,64
2020,48021,Greve in Chianti,FI,82,4,30,1,8,43,3,23,3,33,62
2020,48021,Greve in Chianti,FI,83,1,30,3,8,42,1,16,0,29,46
2020,48021,Greve in Chianti,FI,84,3,20,2,5,30,2,10,1,38,51
2020,48021,Greve in Chianti,FI,85,0,36,0,11,47,1,22,1,37,61
2020,48021,Greve in Chianti,FI,86,1,22,0,6,29,0,13,0,42,55
2020,48021,Greve in Chianti,FI,87,3,20,0,5,28,1,13,0,45,59
2020,48021,Greve in Chianti,FI,88,1,16,0,3,20,3,7,1,42,53
2020,48021,Greve in Chianti,FI,89,3,9,0,3,15,1,10,0,30,41
2020,48021,Greve in Chianti,FI,90,1,14,0,5,20,0,8,0,26,34
2020,48021,Greve in Chianti,FI,91,2,8,0,3,13,1,4,0,29,34
2020,48021,Greve in Chianti,FI,92,0,10,0,5,15,2,3,1,21,27
2020,48021,Greve in Chianti,FI,93,0,7,0,1,8,1,1,0,27,29
2020,48021,Greve in Chianti,FI,94,1,4,0,3,8,1,0,0,11,12
2020,48021,Greve in Chianti,FI,95,0,1,0,2,3,0,0,1,9,10
2020,48021,Greve in Chianti,FI,96,0,0,0,1,1,2,0,0,8,10
2020,48021,Greve in Chianti,FI,97,0,1,0,1,2,0,0,0,5,5
2020,48021,Greve in Chianti,FI,98,0,0,0,0,0,1,0,0,5,6
2020,48021,Greve in Chianti,FI,99,0,0,0,0,0,0,0,0,2,2
2020,48021,Greve in Chianti,FI,100 e più,0,1,0,2,3,1,0,0,2,3
2020,48022,Impruneta,FI,0,37,0,0,0,37,51,0,0,0,51
2020,48022,Impruneta,FI,1,56,0,0,0,56,42,0,0,0,42
2020,48022,Impruneta,FI,2,52,0,0,0,52,50,0,0,0,50
2020,48022,Impruneta,FI,3,47,0,0,0,47,55,0,0,0,55
2020,48022,Impruneta,FI,4,44,0,0,0,44,58,0,0,0,58
2020,48022,Impruneta,FI,5,58,0,0,0,58,44,0,0,0,44
2020,48022,Impruneta,FI,6,57,0,0,0,57,50,0,0,0,50
2020,48022,Impruneta,FI,7,59,0,0,0,59,66,0,0,0,66
2020,48022,Impruneta,FI,8,47,0,0,0,47,63,0,0,0,63
2020,48022,Impruneta,FI,9,54,0,0,0,54,54,0,0,0,54
2020,48022,Impruneta,FI,10,55,0,0,0,55,60,0,0,0,60
2020,48022,Impruneta,FI,11,55,0,0,0,55,58,0,0,0,58
2020,48022,Impruneta,FI,12,75,0,0,0,75,49,0,0,0,49
2020,48022,Impruneta,FI,13,65,0,0,0,65,62,0,0,0,62
2020,48022,Impruneta,FI,14,81,0,0,0,81,62,0,0,0,62
2020,48022,Impruneta,FI,15,53,0,0,0,53,47,0,0,0,47
2020,48022,Impruneta,FI,16,66,0,0,0,66,70,0,0,0,70
2020,48022,Impruneta,FI,17,81,0,0,0,81,58,0,0,0,58
2020,48022,Impruneta,FI,18,80,0,0,0,80,66,0,0,0,66
2020,48022,Impruneta,FI,19,79,0,0,0,79,65,0,0,0,65
2020,48022,Impruneta,FI,20,69,0,0,0,69,79,0,0,0,79
2020,48022,Impruneta,FI,21,86,0,0,0,86,56,3,0,0,59
2020,48022,Impruneta,FI,22,72,0,0,0,72,73,4,0,0,77
2020,48022,Impruneta,FI,23,70,0,0,0,70,72,0,0,0,72
2020,48022,Impruneta,FI,24,63,0,0,0,63,59,2,0,0,61
2020,48022,Impruneta,FI,25,75,2,0,0,77,61,1,0,0,62
2020,48022,Impruneta,FI,26,70,2,0,0,72,60,4,0,0,64
2020,48022,Impruneta,FI,27,74,4,0,0,78,61,5,0,0,66
2020,48022,Impruneta,FI,28,79,3,0,0,82,66,4,0,0,70
2020,48022,Impruneta,FI,29,46,6,0,0,52,50,11,0,0,61
2020,48022,Impruneta,FI,30,82,3,0,0,85,61,15,0,1,77
2020,48022,Impruneta,FI,31,61,8,0,0,69,53,19,0,1,73
2020,48022,Impruneta,FI,32,51,10,1,0,62,49,34,0,0,83
2020,48022,Impruneta,FI,33,55,8,0,0,63,42,17,0,0,59
2020,48022,Impruneta,FI,34,48,20,0,0,68,34,24,2,0,60
2020,48022,Impruneta,FI,35,42,18,0,0,60,48,36,1,0,85
2020,48022,Impruneta,FI,36,44,36,1,0,81,35,34,0,0,69
2020,48022,Impruneta,FI,37,42,26,1,0,69,47,37,3,0,87
2020,48022,Impruneta,FI,38,39,34,1,0,74,34,32,1,1,68
2020,48022,Impruneta,FI,39,50,35,1,0,86,40,40,1,0,81
2020,48022,Impruneta,FI,40,34,32,3,0,69,47,35,3,1,86
2020,48022,Impruneta,FI,41,51,35,3,0,89,27,41,4,0,72
2020,48022,Impruneta,FI,42,35,37,0,0,72,52,41,1,0,94
2020,48022,Impruneta,FI,43,38,31,1,0,70,33,40,2,1,76
2020,48022,Impruneta,FI,44,50,38,1,0,89,38,70,3,2,113
2020,48022,Impruneta,FI,45,51,43,7,0,101,56,54,4,0,114
2020,48022,Impruneta,FI,46,43,60,4,0,107,38,57,8,1,104
2020,48022,Impruneta,FI,47,52,45,4,0,101,46,54,9,1,110
2020,48022,Impruneta,FI,48,42,58,5,1,106,40,67,12,2,121
2020,48022,Impruneta,FI,49,35,55,10,1,101,28,72,9,1,110
2020,48022,Impruneta,FI,50,30,61,12,1,104,28,75,6,1,110
2020,48022,Impruneta,FI,51,34,76,7,1,118,27,76,8,1,112
2020,48022,Impruneta,FI,52,28,77,6,0,111,28,95,8,4,135
2020,48022,Impruneta,FI,53,33,74,7,0,114,24,87,6,1,118
2020,48022,Impruneta,FI,54,25,74,11,0,110,35,92,12,3,142
2020,48022,Impruneta,FI,55,20,72,7,1,100,20,79,9,4,112
2020,48022,Impruneta,FI,56,29,76,6,1,112,21,81,14,3,119
2020,48022,Impruneta,FI,57,19,80,5,2,106,18,92,11,6,127
2020,48022,Impruneta,FI,58,12,90,12,1,115,14,73,4,6,97
2020,48022,Impruneta,FI,59,10,80,7,1,98,12,78,10,4,104
2020,48022,Impruneta,FI,60,9,80,10,0,99,20,87,9,7,123
2020,48022,Impruneta,FI,61,17,86,12,1,116,7,85,17,6,115
2020,48022,Impruneta,FI,62,17,88,11,1,117,17,74,19,5,115
2020,48022,Impruneta,FI,63,7,68,8,3,86,12,59,17,4,92
2020,48022,Impruneta,FI,64,14,69,2,2,87,13,80,14,0,107
2020,48022,Impruneta,FI,65,12,78,6,2,98,15,71,9,10,105
2020,48022,Impruneta,FI,66,7,77,7,2,93,14,76,7,7,104
2020,48022,Impruneta,FI,67,8,78,6,4,96,7,63,4,10,84
2020,48022,Impruneta,FI,68,5,75,6,2,88,7,77,7,14,105
2020,48022,Impruneta,FI,69,6,68,7,10,91,7,58,4,7,76
2020,48022,Impruneta,FI,70,8,73,0,3,84,7,66,8,23,104
2020,48022,Impruneta,FI,71,8,61,6,5,80,8,82,6,21,117
2020,48022,Impruneta,FI,72,8,80,7,3,98,9,66,6,16,97
2020,48022,Impruneta,FI,73,0,69,2,7,78,3,67,6,29,105
2020,48022,Impruneta,FI,74,7,67,2,12,88,2,78,4,21,105
2020,48022,Impruneta,FI,75,4,65,2,9,80,5,48,1,28,82
2020,48022,Impruneta,FI,76,2,48,4,6,60,2,53,1,29,85
2020,48022,Impruneta,FI,77,4,53,4,5,66,6,41,1,27,75
2020,48022,Impruneta,FI,78,3,65,3,8,79,3,43,3,25,74
2020,48022,Impruneta,FI,79,7,65,6,13,91,2,55,4,41,102
2020,48022,Impruneta,FI,80,0,62,3,10,75,2,38,3,33,76
2020,48022,Impruneta,FI,81,8,50,3,11,72,0,39,1,39,79
2020,48022,Impruneta,FI,82,7,39,3,13,62,3,34,2,34,73
2020,48022,Impruneta,FI,83,3,47,1,14,65,3,35,2,32,72
2020,48022,Impruneta,FI,84,2,34,0,9,45,2,12,2,34,50
2020,48022,Impruneta,FI,85,5,33,0,9,47,0,27,1,37,65
2020,48022,Impruneta,FI,86,3,30,0,7,40,1,11,1,53,66
2020,48022,Impruneta,FI,87,0,24,0,5,29,4,11,1,49,65
2020,48022,Impruneta,FI,88,1,16,1,9,27,3,10,0,47,60
2020,48022,Impruneta,FI,89,2,17,0,9,28,4,6,1,31,42
2020,48022,Impruneta,FI,90,2,8,0,6,16,2,7,0,21,30
2020,48022,Impruneta,FI,91,1,13,0,5,19,1,4,1,26,32
2020,48022,Impruneta,FI,92,1,5,0,6,12,0,3,0,27,30
2020,48022,Impruneta,FI,93,0,8,0,5,13,0,3,0,18,21
2020,48022,Impruneta,FI,94,1,3,0,7,11,0,1,0,21,22
2020,48022,Impruneta,FI,95,0,3,0,3,6,0,0,0,9,9
2020,48022,Impruneta,FI,96,1,1,0,1,3,0,0,0,9,9
2020,48022,Impruneta,FI,97,0,2,1,0,3,0,0,0,10,10
2020,48022,Impruneta,FI,98,0,0,0,0,0,0,0,0,4,4
2020,48022,Impruneta,FI,99,0,0,0,1,1,0,0,1,2,3
2020,48022,Impruneta,FI,100 e più,0,0,0,1,1,0,0,0,6,6
2020,48024,Lastra a Signa,FI,0,74,0,0,0,74,54,0,0,0,54
2020,48024,Lastra a Signa,FI,1,78,0,0,0,78,81,0,0,0,81
2020,48024,Lastra a Signa,FI,2,63,0,0,0,63,61,0,0,0,61
2020,48024,Lastra a Signa,FI,3,94,0,0,0,94,87,0,0,0,87
2020,48024,Lastra a Signa,FI,4,82,0,0,0,82,72,0,0,0,72
2020,48024,Lastra a Signa,FI,5,92,0,0,0,92,68,0,0,0,68
2020,48024,Lastra a Signa,FI,6,94,0,0,0,94,85,0,0,0,85
2020,48024,Lastra a Signa,FI,7,100,0,0,0,100,83,0,0,0,83
2020,48024,Lastra a Signa,FI,8,91,0,0,0,91,84,0,0,0,84
2020,48024,Lastra a Signa,FI,9,95,0,0,0,95,86,0,0,0,86
2020,48024,Lastra a Signa,FI,10,97,0,0,0,97,93,0,0,0,93
2020,48024,Lastra a Signa,FI,11,83,0,0,0,83,108,0,0,0,108
2020,48024,Lastra a Signa,FI,12,86,0,0,0,86,84,0,0,0,84
2020,48024,Lastra a Signa,FI,13,99,0,0,0,99,89,0,0,0,89
2020,48024,Lastra a Signa,FI,14,103,0,0,0,103,111,0,0,0,111
2020,48024,Lastra a Signa,FI,15,105,0,0,0,105,90,0,0,0,90
2020,48024,Lastra a Signa,FI,16,108,0,0,0,108,82,0,0,0,82
2020,48024,Lastra a Signa,FI,17,107,0,0,0,107,95,0,0,0,95
2020,48024,Lastra a Signa,FI,18,97,0,0,0,97,99,0,0,0,99
2020,48024,Lastra a Signa,FI,19,98,0,0,0,98,80,0,0,0,80
2020,48024,Lastra a Signa,FI,20,91,0,0,0,91,80,0,0,0,80
2020,48024,Lastra a Signa,FI,21,97,0,0,0,97,97,0,0,0,97
2020,48024,Lastra a Signa,FI,22,109,0,0,0,109,93,2,0,0,95
2020,48024,Lastra a Signa,FI,23,103,2,0,0,105,102,5,0,0,107
2020,48024,Lastra a Signa,FI,24,85,2,0,0,87,87,10,0,0,97
2020,48024,Lastra a Signa,FI,25,109,6,0,0,115,85,5,0,0,90
2020,48024,Lastra a Signa,FI,26,99,3,0,0,102,86,9,0,0,95
2020,48024,Lastra a Signa,FI,27,83,3,0,0,86,64,9,0,0,73
2020,48024,Lastra a Signa,FI,28,107,11,0,0,118,93,13,0,0,106
2020,48024,Lastra a Signa,FI,29,88,15,0,0,103,77,15,0,0,92
2020,48024,Lastra a Signa,FI,30,95,16,0,0,111,74,36,0,0,110
2020,48024,Lastra a Signa,FI,31,70,17,0,0,87,53,36,1,0,90
2020,48024,Lastra a Signa,FI,32,101,34,0,0,135,61,47,0,0,108
2020,48024,Lastra a Signa,FI,33,70,30,0,0,100,54,48,1,0,103
2020,48024,Lastra a Signa,FI,34,73,26,1,0,100,68,63,2,0,133
2020,48024,Lastra a Signa,FI,35,66,47,2,0,115,62,54,3,0,119
2020,48024,Lastra a Signa,FI,36,65,46,2,0,113,57,55,2,0,114
2020,48024,Lastra a Signa,FI,37,59,53,1,0,113,53,55,2,0,110
2020,48024,Lastra a Signa,FI,38,63,52,2,0,117,51,61,1,0,113
2020,48024,Lastra a Signa,FI,39,64,46,3,0,113,41,69,5,1,116
2020,48024,Lastra a Signa,FI,40,57,51,2,0,110,42,72,4,0,118
2020,48024,Lastra a Signa,FI,41,47,60,3,0,110,42,67,4,0,113
2020,48024,Lastra a Signa,FI,42,68,70,7,0,145,43,78,11,1,133
2020,48024,Lastra a Signa,FI,43,54,68,2,0,124,34,68,6,1,109
2020,48024,Lastra a Signa,FI,44,52,72,5,0,129,42,107,5,0,154
2020,48024,Lastra a Signa,FI,45,59,87,9,0,155,40,80,7,0,127
2020,48024,Lastra a Signa,FI,46,68,94,11,1,174,46,115,7,1,169
2020,48024,Lastra a Signa,FI,47,46,104,3,0,153,59,122,14,4,199
2020,48024,Lastra a Signa,FI,48,36,115,15,0,166,28,115,15,3,161
2020,48024,Lastra a Signa,FI,49,44,110,13,2,169,47,124,8,3,182
2020,48024,Lastra a Signa,FI,50,35,117,6,0,158,28,118,14,4,164
2020,48024,Lastra a Signa,FI,51,37,122,8,2,169,33,122,15,3,173
2020,48024,Lastra a Signa,FI,52,34,119,13,1,167,32,125,11,0,168
2020,48024,Lastra a Signa,FI,53,32,106,11,1,150,32,110,13,3,158
2020,48024,Lastra a Signa,FI,54,35,149,8,0,192,22,133,18,4,177
2020,48024,Lastra a Signa,FI,55,22,120,10,3,155,15,147,16,6,184
2020,48024,Lastra a Signa,FI,56,25,131,10,1,167,12,136,21,5,174
2020,48024,Lastra a Signa,FI,57,13,125,5,1,144,18,139,19,3,179
2020,48024,Lastra a Signa,FI,58,21,136,10,1,168,17,107,14,8,146
2020,48024,Lastra a Signa,FI,59,21,105,10,2,138,13,109,13,9,144
2020,48024,Lastra a Signa,FI,60,19,95,6,2,122,14,101,16,5,136
2020,48024,Lastra a Signa,FI,61,15,120,7,2,144,15,107,13,9,144
2020,48024,Lastra a Signa,FI,62,10,113,4,4,131,16,103,3,10,132
2020,48024,Lastra a Signa,FI,63,12,93,8,6,119,8,109,9,12,138
2020,48024,Lastra a Signa,FI,64,9,84,7,3,103,15,80,1,11,107
2020,48024,Lastra a Signa,FI,65,6,71,10,6,93,9,91,9,9,118
2020,48024,Lastra a Signa,FI,66,6,86,5,4,101,3,91,7,15,116
2020,48024,Lastra a Signa,FI,67,14,85,4,2,105,9,77,14,9,109
2020,48024,Lastra a Signa,FI,68,6,85,7,2,100,6,65,7,18,96
2020,48024,Lastra a Signa,FI,69,6,92,2,3,103,7,85,3,19,114
2020,48024,Lastra a Signa,FI,70,12,96,4,3,115,4,89,3,20,116
2020,48024,Lastra a Signa,FI,71,9,83,2,6,100,5,91,2,24,122
2020,48024,Lastra a Signa,FI,72,10,92,4,3,109,5,73,3,23,104
2020,48024,Lastra a Signa,FI,73,7,88,4,5,104,5,97,1,30,133
2020,48024,Lastra a Signa,FI,74,6,89,3,10,108,4,93,3,28,128
2020,48024,Lastra a Signa,FI,75,6,68,3,2,79,1,72,3,25,101
2020,48024,Lastra a Signa,FI,76,7,88,0,3,98,2,50,0,30,82
2020,48024,Lastra a Signa,FI,77,5,75,0,6,86,4,54,1,47,106
2020,48024,Lastra a Signa,FI,78,3,72,0,8,83,5,50,3,29,87
2020,48024,Lastra a Signa,FI,79,3,61,0,9,73,2,73,2,47,124
2020,48024,Lastra a Signa,FI,80,5,58,0,16,79,5,49,1,44,99
2020,48024,Lastra a Signa,FI,81,4,62,1,6,73,2,46,1,44,93
2020,48024,Lastra a Signa,FI,82,4,58,1,12,75,4,28,1,49,82
2020,48024,Lastra a Signa,FI,83,5,40,0,13,58,2,26,0,60,88
2020,48024,Lastra a Signa,FI,84,3,49,0,6,58,3,31,0,51,85
2020,48024,Lastra a Signa,FI,85,1,38,0,18,57,1,23,2,57,83
2020,48024,Lastra a Signa,FI,86,5,33,2,6,46,2,20,0,43,65
2020,48024,Lastra a Signa,FI,87,0,19,0,8,27,4,11,0,30,45
2020,48024,Lastra a Signa,FI,88,2,15,0,11,28,3,12,2,27,44
2020,48024,Lastra a Signa,FI,89,0,13,0,7,20,1,7,0,44,52
2020,48024,Lastra a Signa,FI,90,2,21,0,10,33,2,2,0,32,36
2020,48024,Lastra a Signa,FI,91,0,9,0,8,17,0,1,0,35,36
2020,48024,Lastra a Signa,FI,92,0,4,0,6,10,2,3,0,26,31
2020,48024,Lastra a Signa,FI,93,1,5,0,7,13,3,0,0,25,28
2020,48024,Lastra a Signa,FI,94,0,4,0,5,9,1,1,0,17,19
2020,48024,Lastra a Signa,FI,95,0,1,0,3,4,1,1,0,11,13
2020,48024,Lastra a Signa,FI,96,0,2,0,2,4,2,0,0,10,12
2020,48024,Lastra a Signa,FI,97,0,1,0,1,2,0,0,0,9,9
2020,48024,Lastra a Signa,FI,98,0,0,0,1,1,1,0,0,5,6
2020,48024,Lastra a Signa,FI,99,1,0,0,0,1,0,0,0,2,2
2020,48024,Lastra a Signa,FI,100 e più,0,0,0,1,1,1,0,0,2,3
2020,48025,Londa,FI,0,2,0,0,0,2,7,0,0,0,7
2020,48025,Londa,FI,1,6,0,0,0,6,4,0,0,0,4
2020,48025,Londa,FI,2,4,0,0,0,4,3,0,0,0,3
2020,48025,Londa,FI,3,3,0,0,0,3,5,0,0,0,5
2020,48025,Londa,FI,4,7,0,0,0,7,3,0,0,0,3
2020,48025,Londa,FI,5,9,0,0,0,9,6,0,0,0,6
2020,48025,Londa,FI,6,4,0,0,0,4,6,0,0,0,6
2020,48025,Londa,FI,7,8,0,0,0,8,5,0,0,0,5
2020,48025,Londa,FI,8,8,0,0,0,8,6,0,0,0,6
2020,48025,Londa,FI,9,4,0,0,0,4,10,0,0,0,10
2020,48025,Londa,FI,10,8,0,0,0,8,11,0,0,0,11
2020,48025,Londa,FI,11,11,0,0,0,11,9,0,0,0,9
2020,48025,Londa,FI,12,10,0,0,0,10,4,0,0,0,4
2020,48025,Londa,FI,13,4,0,0,0,4,11,0,0,0,11
2020,48025,Londa,FI,14,12,0,0,0,12,6,0,0,0,6
2020,48025,Londa,FI,15,11,0,0,0,11,10,0,0,0,10
2020,48025,Londa,FI,16,10,0,0,0,10,13,0,0,0,13
2020,48025,Londa,FI,17,12,0,0,0,12,9,0,0,0,9
2020,48025,Londa,FI,18,9,0,0,0,9,12,0,0,0,12
2020,48025,Londa,FI,19,15,0,0,0,15,5,0,0,0,5
2020,48025,Londa,FI,20,8,0,0,0,8,9,0,0,0,9
2020,48025,Londa,FI,21,8,0,0,0,8,9,0,0,0,9
2020,48025,Londa,FI,22,18,0,0,0,18,13,0,0,0,13
2020,48025,Londa,FI,23,24,0,0,0,24,3,0,0,0,3
2020,48025,Londa,FI,24,7,0,0,0,7,7,0,0,0,7
2020,48025,Londa,FI,25,5,0,0,0,5,10,1,0,0,11
2020,48025,Londa,FI,26,4,0,0,0,4,9,0,0,0,9
2020,48025,Londa,FI,27,9,0,0,0,9,3,0,0,0,3
2020,48025,Londa,FI,28,8,0,0,0,8,13,1,0,0,14
2020,48025,Londa,FI,29,9,1,0,0,10,4,5,0,0,9
2020,48025,Londa,FI,30,14,1,0,0,15,5,1,0,0,6
2020,48025,Londa,FI,31,4,1,0,0,5,7,0,0,0,7
2020,48025,Londa,FI,32,12,3,1,0,16,3,3,0,0,6
2020,48025,Londa,FI,33,6,1,0,0,7,5,3,0,0,8
2020,48025,Londa,FI,34,8,2,0,0,10,5,4,0,0,9
2020,48025,Londa,FI,35,6,0,0,0,6,3,3,0,0,6
2020,48025,Londa,FI,36,11,3,0,0,14,3,6,0,0,9
2020,48025,Londa,FI,37,5,2,0,0,7,5,4,0,0,9
2020,48025,Londa,FI,38,2,2,0,0,4,3,5,0,0,8
2020,48025,Londa,FI,39,9,2,0,0,11,3,5,0,0,8
2020,48025,Londa,FI,40,4,4,0,0,8,4,6,0,0,10
2020,48025,Londa,FI,41,8,2,1,0,11,2,6,0,0,8
2020,48025,Londa,FI,42,6,8,1,0,15,4,5,0,0,9
2020,48025,Londa,FI,43,12,1,0,0,13,3,6,1,0,10
2020,48025,Londa,FI,44,6,9,1,0,16,3,10,1,0,14
2020,48025,Londa,FI,45,6,7,1,0,14,4,11,1,0,16
2020,48025,Londa,FI,46,9,6,0,0,15,4,8,0,0,12
2020,48025,Londa,FI,47,5,13,2,0,20,4,8,0,0,12
2020,48025,Londa,FI,48,7,2,1,0,10,5,7,1,1,14
2020,48025,Londa,FI,49,1,11,3,0,15,0,7,1,0,8
2020,48025,Londa,FI,50,4,12,1,0,17,2,8,2,0,12
2020,48025,Londa,FI,51,7,13,1,0,21,1,12,1,0,14
2020,48025,Londa,FI,52,9,15,2,0,26,4,18,1,1,24
2020,48025,Londa,FI,53,4,17,1,0,22,2,14,2,1,19
2020,48025,Londa,FI,54,5,9,1,0,15,2,15,3,1,21
2020,48025,Londa,FI,55,5,13,1,0,19,1,16,1,0,18
2020,48025,Londa,FI,56,3,7,0,0,10,2,10,1,0,13
2020,48025,Londa,FI,57,3,13,2,0,18,1,12,2,1,16
2020,48025,Londa,FI,58,7,10,3,0,20,2,11,0,0,13
2020,48025,Londa,FI,59,1,17,3,0,21,2,9,2,1,14
2020,48025,Londa,FI,60,3,14,0,0,17,0,8,1,0,9
2020,48025,Londa,FI,61,2,10,3,0,15,1,8,3,2,14
2020,48025,Londa,FI,62,2,10,1,0,13,1,16,1,1,19
2020,48025,Londa,FI,63,3,6,1,0,10,2,15,1,1,19
2020,48025,Londa,FI,64,3,10,0,1,14,1,14,2,1,18
2020,48025,Londa,FI,65,0,15,0,0,15,1,10,3,1,15
2020,48025,Londa,FI,66,2,11,0,1,14,2,15,1,1,19
2020,48025,Londa,FI,67,0,11,1,0,12,1,9,0,2,12
2020,48025,Londa,FI,68,2,12,3,0,17,0,8,0,0,8
2020,48025,Londa,FI,69,2,7,4,1,14,1,8,1,2,12
2020,48025,Londa,FI,70,1,8,0,1,10,1,6,1,1,9
2020,48025,Londa,FI,71,0,11,2,1,14,0,5,2,1,8
2020,48025,Londa,FI,72,0,7,0,0,7,1,7,1,2,11
2020,48025,Londa,FI,73,0,4,1,1,6,0,1,1,1,3
2020,48025,Londa,FI,74,0,10,0,2,12,1,3,0,2,6
2020,48025,Londa,FI,75,2,8,0,0,10,0,6,0,4,10
2020,48025,Londa,FI,76,1,4,1,0,6,1,5,0,2,8
2020,48025,Londa,FI,77,0,7,0,0,7,0,6,0,3,9
2020,48025,Londa,FI,78,0,6,1,2,9,0,0,0,2,2
2020,48025,Londa,FI,79,0,6,0,0,6,1,8,0,5,14
2020,48025,Londa,FI,80,0,5,0,0,5,0,6,1,3,10
2020,48025,Londa,FI,81,1,5,0,0,6,0,2,0,3,5
2020,48025,Londa,FI,82,0,4,0,0,4,0,1,0,4,5
2020,48025,Londa,FI,83,2,5,0,1,8,0,2,0,2,4
2020,48025,Londa,FI,84,0,2,0,1,3,0,0,0,6,6
2020,48025,Londa,FI,85,0,4,0,2,6,0,2,0,3,5
2020,48025,Londa,FI,86,1,1,0,2,4,0,1,0,4,5
2020,48025,Londa,FI,87,0,2,0,0,2,0,0,0,7,7
2020,48025,Londa,FI,88,0,0,0,1,1,0,1,0,2,3
2020,48025,Londa,FI,89,0,0,0,4,4,0,0,0,4,4
2020,48025,Londa,FI,90,0,0,0,1,1,0,1,0,1,2
2020,48025,Londa,FI,91,0,0,0,1,1,0,0,0,2,2
2020,48025,Londa,FI,92,0,2,0,1,3,0,0,0,1,1
2020,48025,Londa,FI,93,0,0,0,0,0,0,0,0,0,0
2020,48025,Londa,FI,94,0,0,0,0,0,0,0,0,1,1
2020,48025,Londa,FI,95,0,0,0,2,2,0,0,0,1,1
2020,48025,Londa,FI,96,0,0,0,0,0,0,0,0,1,1
2020,48025,Londa,FI,97,0,0,0,1,1,0,0,0,1,1
2020,48025,Londa,FI,98,0,0,0,0,0,0,0,0,1,1
2020,48025,Londa,FI,99,0,0,0,0,0,0,0,0,0,0
2020,48025,Londa,FI,100 e più,0,0,0,0,0,0,0,0,1,1
2020,48026,Marradi,FI,0,13,0,0,0,13,9,0,0,0,9
2020,48026,Marradi,FI,1,8,0,0,0,8,7,0,0,0,7
2020,48026,Marradi,FI,2,7,0,0,0,7,12,0,0,0,12
2020,48026,Marradi,FI,3,6,0,0,0,6,4,0,0,0,4
2020,48026,Marradi,FI,4,7,0,0,0,7,7,0,0,0,7
2020,48026,Marradi,FI,5,14,0,0,0,14,9,0,0,0,9
2020,48026,Marradi,FI,6,7,0,0,0,7,8,0,0,0,8
2020,48026,Marradi,FI,7,9,0,0,0,9,10,0,0,0,10
2020,48026,Marradi,FI,8,17,0,0,0,17,10,0,0,0,10
2020,48026,Marradi,FI,9,17,0,0,0,17,9,0,0,0,9
2020,48026,Marradi,FI,10,15,0,0,0,15,10,0,0,0,10
2020,48026,Marradi,FI,11,8,0,0,0,8,13,0,0,0,13
2020,48026,Marradi,FI,12,13,0,0,0,13,7,0,0,0,7
2020,48026,Marradi,FI,13,11,0,0,0,11,10,0,0,0,10
2020,48026,Marradi,FI,14,6,0,0,0,6,11,0,0,0,11
2020,48026,Marradi,FI,15,13,0,0,0,13,11,0,0,0,11
2020,48026,Marradi,FI,16,10,0,0,0,10,11,0,0,0,11
2020,48026,Marradi,FI,17,15,0,0,0,15,8,0,0,0,8
2020,48026,Marradi,FI,18,8,0,0,0,8,11,0,0,0,11
2020,48026,Marradi,FI,19,13,0,0,0,13,10,1,0,0,11
2020,48026,Marradi,FI,20,19,0,0,0,19,4,0,0,0,4
2020,48026,Marradi,FI,21,11,0,0,0,11,16,0,0,0,16
2020,48026,Marradi,FI,22,10,0,0,0,10,13,0,0,0,13
2020,48026,Marradi,FI,23,12,0,0,0,12,10,0,0,0,10
2020,48026,Marradi,FI,24,10,0,0,0,10,13,1,0,0,14
2020,48026,Marradi,FI,25,15,0,0,0,15,12,1,0,0,13
2020,48026,Marradi,FI,26,10,0,0,0,10,5,0,0,0,5
2020,48026,Marradi,FI,27,13,0,0,0,13,9,1,0,1,11
2020,48026,Marradi,FI,28,10,1,0,0,11,6,2,0,0,8
2020,48026,Marradi,FI,29,11,1,0,0,12,12,3,0,0,15
2020,48026,Marradi,FI,30,17,2,0,0,19,8,4,0,0,12
2020,48026,Marradi,FI,31,12,1,0,0,13,13,3,0,0,16
2020,48026,Marradi,FI,32,11,5,0,0,16,6,4,0,0,10
2020,48026,Marradi,FI,33,7,0,0,0,7,7,3,0,0,10
2020,48026,Marradi,FI,34,9,5,0,0,14,9,0,0,0,9
2020,48026,Marradi,FI,35,7,2,0,0,9,5,2,0,0,7
2020,48026,Marradi,FI,36,14,4,0,0,18,6,8,2,0,16
2020,48026,Marradi,FI,37,11,4,0,0,15,11,9,0,0,20
2020,48026,Marradi,FI,38,11,4,0,0,15,9,3,1,0,13
2020,48026,Marradi,FI,39,17,6,0,0,23,1,6,0,0,7
2020,48026,Marradi,FI,40,5,1,1,0,7,11,3,1,1,16
2020,48026,Marradi,FI,41,12,10,0,0,22,12,7,1,0,20
2020,48026,Marradi,FI,42,9,6,0,0,15,7,8,0,0,15
2020,48026,Marradi,FI,43,9,6,1,0,16,4,16,0,1,21
2020,48026,Marradi,FI,44,10,7,1,0,18,5,14,1,0,20
2020,48026,Marradi,FI,45,9,4,1,0,14,7,14,0,0,21
2020,48026,Marradi,FI,46,13,11,0,0,24,10,10,0,0,20
2020,48026,Marradi,FI,47,12,10,1,0,23,3,12,0,0,15
2020,48026,Marradi,FI,48,9,9,0,0,18,8,8,1,0,17
2020,48026,Marradi,FI,49,9,5,0,0,14,10,14,0,0,24
2020,48026,Marradi,FI,50,15,13,2,0,30,7,9,2,0,18
2020,48026,Marradi,FI,51,10,12,2,0,24,6,14,2,0,22
2020,48026,Marradi,FI,52,5,13,1,0,19,6,14,1,0,21
2020,48026,Marradi,FI,53,13,17,2,0,32,2,25,3,1,31
2020,48026,Marradi,FI,54,8,9,3,0,20,4,19,1,1,25
2020,48026,Marradi,FI,55,7,14,2,0,23,5,18,1,1,25
2020,48026,Marradi,FI,56,5,12,6,0,23,3,14,0,1,18
2020,48026,Marradi,FI,57,8,15,1,0,24,3,15,0,1,19
2020,48026,Marradi,FI,58,5,19,0,0,24,4,16,2,3,25
2020,48026,Marradi,FI,59,7,18,3,2,30,3,17,2,1,23
2020,48026,Marradi,FI,60,7,22,3,1,33,3,18,3,4,28
2020,48026,Marradi,FI,61,9,15,2,1,27,4,11,3,0,18
2020,48026,Marradi,FI,62,6,14,4,0,24,4,19,3,3,29
2020,48026,Marradi,FI,63,5,18,2,0,25,2,14,0,2,18
2020,48026,Marradi,FI,64,1,13,2,0,16,1,18,1,6,26
2020,48026,Marradi,FI,65,5,11,3,2,21,2,22,2,3,29
2020,48026,Marradi,FI,66,4,20,1,0,25,2,15,1,2,20
2020,48026,Marradi,FI,67,2,28,4,1,35,4,15,0,6,25
2020,48026,Marradi,FI,68,3,16,0,0,19,3,11,2,2,18
2020,48026,Marradi,FI,69,5,16,1,1,23,0,12,1,1,14
2020,48026,Marradi,FI,70,3,10,1,0,14,0,13,1,3,17
2020,48026,Marradi,FI,71,3,18,2,2,25,0,19,2,3,24
2020,48026,Marradi,FI,72,6,20,2,0,28,0,13,0,7,20
2020,48026,Marradi,FI,73,0,23,0,0,23,0,15,1,6,22
2020,48026,Marradi,FI,74,4,23,0,2,29,0,10,0,16,26
2020,48026,Marradi,FI,75,0,19,1,0,20,0,13,0,8,21
2020,48026,Marradi,FI,76,0,11,0,3,14,1,21,1,4,27
2020,48026,Marradi,FI,77,0,14,0,4,18,0,12,0,9,21
2020,48026,Marradi,FI,78,1,9,2,2,14,5,6,0,6,17
2020,48026,Marradi,FI,79,3,11,0,2,16,3,4,1,6,14
2020,48026,Marradi,FI,80,1,12,1,4,18,2,10,0,15,27
2020,48026,Marradi,FI,81,4,7,0,3,14,0,9,0,7,16
2020,48026,Marradi,FI,82,3,12,0,3,18,0,7,0,11,18
2020,48026,Marradi,FI,83,2,12,0,4,18,0,4,0,4,8
2020,48026,Marradi,FI,84,2,6,0,3,11,1,1,0,8,10
2020,48026,Marradi,FI,85,2,8,0,5,15,0,4,0,7,11
2020,48026,Marradi,FI,86,2,2,0,2,6,1,2,0,7,10
2020,48026,Marradi,FI,87,1,5,0,2,8,1,1,1,6,9
2020,48026,Marradi,FI,88,3,2,0,2,7,1,3,0,9,13
2020,48026,Marradi,FI,89,2,6,0,0,8,0,1,0,8,9
2020,48026,Marradi,FI,90,2,2,0,3,7,2,0,0,10,12
2020,48026,Marradi,FI,91,0,2,0,2,4,0,0,0,12,12
2020,48026,Marradi,FI,92,0,1,0,0,1,0,0,0,11,11
2020,48026,Marradi,FI,93,0,1,0,1,2,1,0,0,5,6
2020,48026,Marradi,FI,94,0,1,0,0,1,0,1,0,4,5
2020,48026,Marradi,FI,95,0,0,0,0,0,0,0,0,3,3
2020,48026,Marradi,FI,96,0,0,0,0,0,0,0,0,3,3
2020,48026,Marradi,FI,97,0,0,0,1,1,0,0,0,1,1
2020,48026,Marradi,FI,98,0,0,0,0,0,0,0,0,2,2
2020,48026,Marradi,FI,99,1,0,0,0,1,0,0,0,0,0
2020,48026,Marradi,FI,100 e più,0,0,0,0,0,0,0,0,3,3
2020,48027,Montaione,FI,0,6,0,0,0,6,12,0,0,0,12
2020,48027,Montaione,FI,1,13,0,0,0,13,11,0,0,0,11
2020,48027,Montaione,FI,2,10,0,0,0,10,9,0,0,0,9
2020,48027,Montaione,FI,3,14,0,0,0,14,9,0,0,0,9
2020,48027,Montaione,FI,4,12,0,0,0,12,13,0,0,0,13
2020,48027,Montaione,FI,5,11,0,0,0,11,10,0,0,0,10
2020,48027,Montaione,FI,6,12,0,0,0,12,13,0,0,0,13
2020,48027,Montaione,FI,7,8,0,0,0,8,14,0,0,0,14
2020,48027,Montaione,FI,8,18,0,0,0,18,15,0,0,0,15
2020,48027,Montaione,FI,9,12,0,0,0,12,15,0,0,0,15
2020,48027,Montaione,FI,10,14,0,0,0,14,10,0,0,0,10
2020,48027,Montaione,FI,11,20,0,0,0,20,23,0,0,0,23
2020,48027,Montaione,FI,12,18,0,0,0,18,18,0,0,0,18
2020,48027,Montaione,FI,13,20,0,0,0,20,15,0,0,0,15
2020,48027,Montaione,FI,14,15,0,0,0,15,13,0,0,0,13
2020,48027,Montaione,FI,15,18,0,0,0,18,10,0,0,0,10
2020,48027,Montaione,FI,16,14,0,0,0,14,19,0,0,0,19
2020,48027,Montaione,FI,17,11,0,0,0,11,13,0,0,0,13
2020,48027,Montaione,FI,18,20,0,0,0,20,16,0,0,0,16
2020,48027,Montaione,FI,19,19,0,0,0,19,15,0,0,0,15
2020,48027,Montaione,FI,20,21,0,0,0,21,12,1,0,0,13
2020,48027,Montaione,FI,21,11,0,0,0,11,9,0,0,0,9
2020,48027,Montaione,FI,22,16,0,0,0,16,5,0,0,0,5
2020,48027,Montaione,FI,23,14,0,0,0,14,17,0,0,0,17
2020,48027,Montaione,FI,24,8,0,0,0,8,9,1,0,0,10
2020,48027,Montaione,FI,25,22,0,0,0,22,9,1,0,0,10
2020,48027,Montaione,FI,26,17,2,0,0,19,10,4,0,0,14
2020,48027,Montaione,FI,27,24,1,0,0,25,12,1,0,0,13
2020,48027,Montaione,FI,28,21,0,0,0,21,13,5,0,0,18
2020,48027,Montaione,FI,29,20,1,0,0,21,13,3,0,0,16
2020,48027,Montaione,FI,30,18,0,0,0,18,12,3,0,0,15
2020,48027,Montaione,FI,31,10,3,0,0,13,11,1,0,0,12
2020,48027,Montaione,FI,32,15,3,0,0,18,14,6,0,0,20
2020,48027,Montaione,FI,33,14,0,0,0,14,11,11,0,0,22
2020,48027,Montaione,FI,34,12,3,0,0,15,15,8,1,0,24
2020,48027,Montaione,FI,35,9,7,0,0,16,6,7,0,0,13
2020,48027,Montaione,FI,36,18,5,1,0,24,8,11,1,0,20
2020,48027,Montaione,FI,37,11,5,0,0,16,8,9,1,0,18
2020,48027,Montaione,FI,38,11,11,0,0,22,7,5,0,0,12
2020,48027,Montaione,FI,39,12,14,0,0,26,7,19,0,0,26
2020,48027,Montaione,FI,40,10,5,0,0,15,5,9,0,0,14
2020,48027,Montaione,FI,41,14,11,1,0,26,11,14,0,0,25
2020,48027,Montaione,FI,42,7,14,1,0,22,7,12,0,0,19
2020,48027,Montaione,FI,43,14,10,0,0,24,9,22,0,0,31
2020,48027,Montaione,FI,44,13,12,1,0,26,10,17,5,0,32
2020,48027,Montaione,FI,45,7,16,0,0,23,7,19,3,0,29
2020,48027,Montaione,FI,46,13,18,4,0,35,10,14,1,0,25
2020,48027,Montaione,FI,47,19,15,0,0,34,7,17,1,0,25
2020,48027,Montaione,FI,48,11,23,1,0,35,2,21,0,0,23
2020,48027,Montaione,FI,49,6,21,1,0,28,8,19,3,1,31
2020,48027,Montaione,FI,50,6,20,1,0,27,4,23,0,1,28
2020,48027,Montaione,FI,51,7,21,2,0,30,7,20,5,1,33
2020,48027,Montaione,FI,52,5,11,0,0,16,7,14,3,1,25
2020,48027,Montaione,FI,53,7,17,3,0,27,2,28,4,0,34
2020,48027,Montaione,FI,54,8,15,5,0,28,5,27,2,2,36
2020,48027,Montaione,FI,55,3,22,3,0,28,2,20,1,2,25
2020,48027,Montaione,FI,56,4,26,2,0,32,2,24,4,0,30
2020,48027,Montaione,FI,57,0,20,2,2,24,5,27,2,0,34
2020,48027,Montaione,FI,58,1,21,3,1,26,5,18,0,0,23
2020,48027,Montaione,FI,59,1,17,3,0,21,3,25,2,1,31
2020,48027,Montaione,FI,60,3,25,2,0,30,6,19,5,1,31
2020,48027,Montaione,FI,61,7,34,2,2,45,3,11,0,0,14
2020,48027,Montaione,FI,62,1,29,1,0,31,1,22,3,1,27
2020,48027,Montaione,FI,63,3,21,0,0,24,0,20,1,2,23
2020,48027,Montaione,FI,64,4,18,1,0,23,2,16,2,2,22
2020,48027,Montaione,FI,65,2,23,2,2,29,1,18,0,6,25
2020,48027,Montaione,FI,66,1,17,0,1,19,4,15,1,1,21
2020,48027,Montaione,FI,67,1,22,1,1,25,0,14,2,3,19
2020,48027,Montaione,FI,68,2,11,0,0,13,1,16,0,4,21
2020,48027,Montaione,FI,69,4,11,0,1,16,1,16,0,8,25
2020,48027,Montaione,FI,70,3,14,2,2,21,3,13,0,4,20
2020,48027,Montaione,FI,71,1,16,1,1,19,5,15,0,6,26
2020,48027,Montaione,FI,72,2,14,1,2,19,5,16,1,7,29
2020,48027,Montaione,FI,73,3,23,0,0,26,2,18,2,5,27
2020,48027,Montaione,FI,74,4,14,1,3,22,0,9,1,8,18
2020,48027,Montaione,FI,75,0,10,0,0,10,0,7,2,9,18
2020,48027,Montaione,FI,76,0,11,0,1,12,0,10,0,6,16
2020,48027,Montaione,FI,77,1,7,0,0,8,1,9,1,4,15
2020,48027,Montaione,FI,78,1,13,0,2,16,0,10,0,4,14
2020,48027,Montaione,FI,79,3,16,1,2,22,0,6,0,8,14
2020,48027,Montaione,FI,80,2,6,1,2,11,0,7,0,16,23
2020,48027,Montaione,FI,81,1,9,0,4,14,1,5,0,11,17
2020,48027,Montaione,FI,82,2,11,0,2,15,0,12,0,8,20
2020,48027,Montaione,FI,83,0,4,0,2,6,3,7,0,7,17
2020,48027,Montaione,FI,84,0,4,0,4,8,0,2,0,15,17
2020,48027,Montaione,FI,85,2,9,0,1,12,1,7,0,10,18
2020,48027,Montaione,FI,86,0,10,0,1,11,1,5,0,10,16
2020,48027,Montaione,FI,87,0,1,0,1,2,0,3,0,12,15
2020,48027,Montaione,FI,88,1,4,0,0,5,0,3,0,12,15
2020,48027,Montaione,FI,89,0,6,0,1,7,0,2,0,12,14
2020,48027,Montaione,FI,90,0,4,0,1,5,0,0,0,11,11
2020,48027,Montaione,FI,91,0,2,0,6,8,0,2,0,8,10
2020,48027,Montaione,FI,92,0,2,0,0,2,1,0,0,6,7
2020,48027,Montaione,FI,93,0,3,1,0,4,1,0,0,6,7
2020,48027,Montaione,FI,94,0,2,0,0,2,0,1,0,2,3
2020,48027,Montaione,FI,95,0,0,0,1,1,0,0,0,4,4
2020,48027,Montaione,FI,96,1,0,0,0,1,0,0,0,4,4
2020,48027,Montaione,FI,97,0,0,0,0,0,0,0,0,2,2
2020,48027,Montaione,FI,98,0,0,0,1,1,0,0,0,5,5
2020,48027,Montaione,FI,99,0,0,0,0,0,0,0,0,1,1
2020,48027,Montaione,FI,100 e più,0,0,0,0,0,1,0,0,3,4
2020,48028,Montelupo Fiorentino,FI,0,46,0,0,0,46,48,0,0,0,48
2020,48028,Montelupo Fiorentino,FI,1,46,0,0,0,46,55,0,0,0,55
2020,48028,Montelupo Fiorentino,FI,2,43,0,0,0,43,51,0,0,0,51
2020,48028,Montelupo Fiorentino,FI,3,58,0,0,0,58,68,0,0,0,68
2020,48028,Montelupo Fiorentino,FI,4,62,0,0,0,62,55,0,0,0,55
2020,48028,Montelupo Fiorentino,FI,5,57,0,0,0,57,64,0,0,0,64
2020,48028,Montelupo Fiorentino,FI,6,58,0,0,0,58,51,0,0,0,51
2020,48028,Montelupo Fiorentino,FI,7,62,0,0,0,62,73,0,0,0,73
2020,48028,Montelupo Fiorentino,FI,8,80,0,0,0,80,65,0,0,0,65
2020,48028,Montelupo Fiorentino,FI,9,93,0,0,0,93,78,0,0,0,78
2020,48028,Montelupo Fiorentino,FI,10,77,0,0,0,77,62,0,0,0,62
2020,48028,Montelupo Fiorentino,FI,11,89,0,0,0,89,83,0,0,0,83
2020,48028,Montelupo Fiorentino,FI,12,87,0,0,0,87,72,0,0,0,72
2020,48028,Montelupo Fiorentino,FI,13,78,0,0,0,78,67,0,0,0,67
2020,48028,Montelupo Fiorentino,FI,14,77,0,0,0,77,80,0,0,0,80
2020,48028,Montelupo Fiorentino,FI,15,86,0,0,0,86,74,0,0,0,74
2020,48028,Montelupo Fiorentino,FI,16,89,0,0,0,89,76,0,0,0,76
2020,48028,Montelupo Fiorentino,FI,17,90,0,0,0,90,64,0,0,0,64
2020,48028,Montelupo Fiorentino,FI,18,62,0,0,0,62,76,0,0,0,76
2020,48028,Montelupo Fiorentino,FI,19,70,0,0,0,70,70,0,0,0,70
2020,48028,Montelupo Fiorentino,FI,20,67,0,0,0,67,68,0,0,0,68
2020,48028,Montelupo Fiorentino,FI,21,69,0,0,0,69,62,1,0,0,63
2020,48028,Montelupo Fiorentino,FI,22,75,1,0,0,76,66,1,0,0,67
2020,48028,Montelupo Fiorentino,FI,23,74,0,0,0,74,67,5,0,0,72
2020,48028,Montelupo Fiorentino,FI,24,61,0,0,0,61,46,3,0,0,49
2020,48028,Montelupo Fiorentino,FI,25,46,0,0,0,46,52,5,1,0,58
2020,48028,Montelupo Fiorentino,FI,26,60,3,0,0,63,57,10,0,0,67
2020,48028,Montelupo Fiorentino,FI,27,58,3,0,0,61,53,3,0,0,56
2020,48028,Montelupo Fiorentino,FI,28,61,5,0,0,66,47,16,0,0,63
2020,48028,Montelupo Fiorentino,FI,29,56,6,0,0,62,51,12,0,0,63
2020,48028,Montelupo Fiorentino,FI,30,70,6,0,0,76,48,11,1,0,60
2020,48028,Montelupo Fiorentino,FI,31,48,11,0,0,59,51,20,0,0,71
2020,48028,Montelupo Fiorentino,FI,32,49,9,0,0,58,34,23,1,0,58
2020,48028,Montelupo Fiorentino,FI,33,57,16,0,0,73,40,27,0,0,67
2020,48028,Montelupo Fiorentino,FI,34,53,24,0,0,77,41,25,1,0,67
2020,48028,Montelupo Fiorentino,FI,35,53,23,1,0,77,32,29,1,0,62
2020,48028,Montelupo Fiorentino,FI,36,43,17,2,1,63,34,53,0,0,87
2020,48028,Montelupo Fiorentino,FI,37,61,28,2,0,91,35,38,2,0,75
2020,48028,Montelupo Fiorentino,FI,38,38,44,0,0,82,26,48,0,0,74
2020,48028,Montelupo Fiorentino,FI,39,43,37,2,1,83,40,61,4,0,105
2020,48028,Montelupo Fiorentino,FI,40,47,46,2,0,95,30,53,5,0,88
2020,48028,Montelupo Fiorentino,FI,41,32,50,2,0,84,36,57,5,3,101
2020,48028,Montelupo Fiorentino,FI,42,35,52,7,0,94,38,73,6,1,118
2020,48028,Montelupo Fiorentino,FI,43,41,66,6,0,113,28,77,4,2,111
2020,48028,Montelupo Fiorentino,FI,44,48,70,0,0,118,37,73,8,0,118
2020,48028,Montelupo Fiorentino,FI,45,36,71,8,0,115,28,84,9,1,122
2020,48028,Montelupo Fiorentino,FI,46,38,79,9,0,126,30,92,7,0,129
2020,48028,Montelupo Fiorentino,FI,47,49,86,3,0,138,25,106,8,2,141
2020,48028,Montelupo Fiorentino,FI,48,33,92,7,0,132,27,83,11,2,123
2020,48028,Montelupo Fiorentino,FI,49,34,93,2,0,129,39,104,13,1,157
2020,48028,Montelupo Fiorentino,FI,50,30,86,12,0,128,26,112,10,3,151
2020,48028,Montelupo Fiorentino,FI,51,27,107,7,2,143,16,111,11,1,139
2020,48028,Montelupo Fiorentino,FI,52,20,101,7,1,129,28,89,17,4,138
2020,48028,Montelupo Fiorentino,FI,53,22,99,9,1,131,19,109,5,1,134
2020,48028,Montelupo Fiorentino,FI,54,20,100,10,2,132,23,96,12,2,133
2020,48028,Montelupo Fiorentino,FI,55,14,87,9,0,110,13,96,10,6,125
2020,48028,Montelupo Fiorentino,FI,56,19,85,12,1,117,16,75,13,7,111
2020,48028,Montelupo Fiorentino,FI,57,13,96,3,1,113,12,87,8,6,113
2020,48028,Montelupo Fiorentino,FI,58,10,71,12,1,94,13,77,12,4,106
2020,48028,Montelupo Fiorentino,FI,59,12,76,6,2,96,3,75,4,12,94
2020,48028,Montelupo Fiorentino,FI,60,4,78,11,1,94,7,64,8,4,83
2020,48028,Montelupo Fiorentino,FI,61,8,68,7,2,85,6,74,5,3,88
2020,48028,Montelupo Fiorentino,FI,62,6,61,2,0,69,7,57,6,3,73
2020,48028,Montelupo Fiorentino,FI,63,4,80,3,2,89,12,60,5,7,84
2020,48028,Montelupo Fiorentino,FI,64,7,54,2,0,63,10,55,4,12,81
2020,48028,Montelupo Fiorentino,FI,65,8,59,5,3,75,4,58,6,8,76
2020,48028,Montelupo Fiorentino,FI,66,7,46,5,2,60,0,73,4,11,88
2020,48028,Montelupo Fiorentino,FI,67,5,57,3,2,67,1,53,2,10,66
2020,48028,Montelupo Fiorentino,FI,68,4,58,3,4,69,3,54,3,11,71
2020,48028,Montelupo Fiorentino,FI,69,8,44,2,1,55,1,69,5,13,88
2020,48028,Montelupo Fiorentino,FI,70,6,58,1,3,68,3,51,6,21,81
2020,48028,Montelupo Fiorentino,FI,71,5,75,0,4,84,0,59,5,17,81
2020,48028,Montelupo Fiorentino,FI,72,4,57,1,9,71,2,53,3,22,80
2020,48028,Montelupo Fiorentino,FI,73,2,52,2,8,64,1,59,2,35,97
2020,48028,Montelupo Fiorentino,FI,74,3,63,3,2,71,3,46,4,19,72
2020,48028,Montelupo Fiorentino,FI,75,5,60,1,9,75,2,45,0,19,66
2020,48028,Montelupo Fiorentino,FI,76,2,36,3,9,50,3,40,0,15,58
2020,48028,Montelupo Fiorentino,FI,77,5,41,0,7,53,2,33,5,16,56
2020,48028,Montelupo Fiorentino,FI,78,4,44,0,6,54,1,49,2,33,85
2020,48028,Montelupo Fiorentino,FI,79,0,31,5,7,43,4,39,1,19,63
2020,48028,Montelupo Fiorentino,FI,80,1,48,0,15,64,2,42,0,27,71
2020,48028,Montelupo Fiorentino,FI,81,4,42,1,4,51,2,26,2,46,76
2020,48028,Montelupo Fiorentino,FI,82,2,53,0,10,65,0,24,1,34,59
2020,48028,Montelupo Fiorentino,FI,83,2,31,0,7,40,4,20,0,43,67
2020,48028,Montelupo Fiorentino,FI,84,0,37,0,9,46,1,23,0,24,48
2020,48028,Montelupo Fiorentino,FI,85,1,25,0,5,31,2,12,1,26,41
2020,48028,Montelupo Fiorentino,FI,86,3,21,0,8,32,0,10,0,37,47
2020,48028,Montelupo Fiorentino,FI,87,1,20,0,7,28,2,7,0,37,46
2020,48028,Montelupo Fiorentino,FI,88,1,20,0,5,26,0,4,1,24,29
2020,48028,Montelupo Fiorentino,FI,89,0,9,0,5,14,2,5,0,31,38
2020,48028,Montelupo Fiorentino,FI,90,2,10,0,4,16,2,4,0,20,26
2020,48028,Montelupo Fiorentino,FI,91,0,4,0,7,11,1,2,0,14,17
2020,48028,Montelupo Fiorentino,FI,92,3,8,0,6,17,3,2,0,14,19
2020,48028,Montelupo Fiorentino,FI,93,0,2,0,4,6,0,2,0,12,14
2020,48028,Montelupo Fiorentino,FI,94,0,2,0,4,6,1,2,0,12,15
2020,48028,Montelupo Fiorentino,FI,95,0,1,0,0,1,0,0,0,12,12
2020,48028,Montelupo Fiorentino,FI,96,0,1,0,2,3,1,0,0,4,5
2020,48028,Montelupo Fiorentino,FI,97,0,0,0,1,1,1,0,0,8,9
2020,48028,Montelupo Fiorentino,FI,98,0,0,0,1,1,0,0,0,3,3
2020,48028,Montelupo Fiorentino,FI,99,0,0,0,1,1,0,0,0,3,3
2020,48028,Montelupo Fiorentino,FI,100 e più,0,0,0,0,0,0,0,0,1,1
2020,48030,Montespertoli,FI,0,44,0,0,0,44,31,0,0,0,31
2020,48030,Montespertoli,FI,1,34,0,0,0,34,42,0,0,0,42
2020,48030,Montespertoli,FI,2,52,0,0,0,52,40,0,0,0,40
2020,48030,Montespertoli,FI,3,49,0,0,0,49,41,0,0,0,41
2020,48030,Montespertoli,FI,4,55,0,0,0,55,46,0,0,0,46
2020,48030,Montespertoli,FI,5,46,0,0,0,46,58,0,0,0,58
2020,48030,Montespertoli,FI,6,54,0,0,0,54,51,0,0,0,51
2020,48030,Montespertoli,FI,7,55,0,0,0,55,45,0,0,0,45
2020,48030,Montespertoli,FI,8,61,0,0,0,61,60,0,0,0,60
2020,48030,Montespertoli,FI,9,60,0,0,0,60,64,0,0,0,64
2020,48030,Montespertoli,FI,10,61,0,0,0,61,57,0,0,0,57
2020,48030,Montespertoli,FI,11,58,0,0,0,58,62,0,0,0,62
2020,48030,Montespertoli,FI,12,59,0,0,0,59,74,0,0,0,74
2020,48030,Montespertoli,FI,13,70,0,0,0,70,60,0,0,0,60
2020,48030,Montespertoli,FI,14,56,0,0,0,56,81,0,0,0,81
2020,48030,Montespertoli,FI,15,62,0,0,0,62,62,0,0,0,62
2020,48030,Montespertoli,FI,16,85,0,0,0,85,58,0,0,0,58
2020,48030,Montespertoli,FI,17,72,0,0,0,72,80,0,0,0,80
2020,48030,Montespertoli,FI,18,63,0,0,0,63,74,0,0,0,74
2020,48030,Montespertoli,FI,19,67,0,0,0,67,65,0,0,0,65
2020,48030,Montespertoli,FI,20,86,0,0,0,86,52,1,0,0,53
2020,48030,Montespertoli,FI,21,72,0,0,0,72,62,1,0,0,63
2020,48030,Montespertoli,FI,22,72,0,0,0,72,68,0,0,0,68
2020,48030,Montespertoli,FI,23,60,0,0,0,60,61,0,0,0,61
2020,48030,Montespertoli,FI,24,86,1,0,0,87,69,4,0,0,73
2020,48030,Montespertoli,FI,25,59,4,0,0,63,54,6,0,0,60
2020,48030,Montespertoli,FI,26,64,2,0,0,66,49,8,0,0,57
2020,48030,Montespertoli,FI,27,45,2,0,0,47,41,3,0,0,44
2020,48030,Montespertoli,FI,28,54,8,0,0,62,52,4,0,0,56
2020,48030,Montespertoli,FI,29,52,6,0,0,58,40,10,0,0,50
2020,48030,Montespertoli,FI,30,56,7,0,0,63,47,11,1,0,59
2020,48030,Montespertoli,FI,31,39,15,0,0,54,44,23,2,0,69
2020,48030,Montespertoli,FI,32,42,13,1,0,56,39,22,2,0,63
2020,48030,Montespertoli,FI,33,46,15,0,0,61,40,32,1,0,73
2020,48030,Montespertoli,FI,34,55,11,1,0,67,23,24,0,0,47
2020,48030,Montespertoli,FI,35,51,21,1,0,73,38,33,0,0,71
2020,48030,Montespertoli,FI,36,38,22,0,0,60,39,35,2,0,76
2020,48030,Montespertoli,FI,37,56,27,1,0,84,28,30,3,0,61
2020,48030,Montespertoli,FI,38,33,35,1,0,69,19,38,1,0,58
2020,48030,Montespertoli,FI,39,30,36,0,0,66,37,43,3,0,83
2020,48030,Montespertoli,FI,40,39,43,2,0,84,30,52,3,0,85
2020,48030,Montespertoli,FI,41,27,42,1,0,70,34,46,3,1,84
2020,48030,Montespertoli,FI,42,40,46,5,0,91,23,50,4,0,77
2020,48030,Montespertoli,FI,43,36,44,2,0,82,27,53,7,0,87
2020,48030,Montespertoli,FI,44,46,60,0,0,106,31,55,3,1,90
2020,48030,Montespertoli,FI,45,40,49,3,1,93,37,66,8,2,113
2020,48030,Montespertoli,FI,46,44,76,4,0,124,30,75,7,0,112
2020,48030,Montespertoli,FI,47,31,66,1,1,99,26,75,9,1,111
2020,48030,Montespertoli,FI,48,34,72,3,0,109,23,66,7,0,96
2020,48030,Montespertoli,FI,49,37,73,5,0,115,24,85,4,4,117
2020,48030,Montespertoli,FI,50,32,70,4,0,106,28,77,11,0,116
2020,48030,Montespertoli,FI,51,19,88,10,0,117,26,80,11,0,117
2020,48030,Montespertoli,FI,52,34,86,3,0,123,19,96,7,2,124
2020,48030,Montespertoli,FI,53,19,77,11,1,108,25,91,12,2,130
2020,48030,Montespertoli,FI,54,36,97,11,0,144,30,91,10,4,135
2020,48030,Montespertoli,FI,55,28,88,5,0,121,22,93,10,0,125
2020,48030,Montespertoli,FI,56,23,71,5,1,100,18,88,16,5,127
2020,48030,Montespertoli,FI,57,11,96,3,1,111,14,88,8,5,115
2020,48030,Montespertoli,FI,58,13,84,7,0,104,12,80,12,6,110
2020,48030,Montespertoli,FI,59,19,71,6,2,98,10,74,9,1,94
2020,48030,Montespertoli,FI,60,12,82,10,0,104,12,80,15,3,110
2020,48030,Montespertoli,FI,61,16,83,8,1,108,10,77,8,5,100
2020,48030,Montespertoli,FI,62,10,77,10,2,99,10,68,9,6,93
2020,48030,Montespertoli,FI,63,14,80,8,0,102,6,58,11,6,81
2020,48030,Montespertoli,FI,64,6,60,8,2,76,6,68,10,10,94
2020,48030,Montespertoli,FI,65,8,66,8,4,86,3,72,5,4,84
2020,48030,Montespertoli,FI,66,11,58,10,1,80,7,66,2,3,78
2020,48030,Montespertoli,FI,67,3,64,6,2,75,6,59,6,2,73
2020,48030,Montespertoli,FI,68,7,58,1,2,68,5,64,5,14,88
2020,48030,Montespertoli,FI,69,7,61,1,2,71,5,44,3,13,65
2020,48030,Montespertoli,FI,70,2,72,6,6,86,7,55,3,11,76
2020,48030,Montespertoli,FI,71,6,70,5,4,85,4,58,4,13,79
2020,48030,Montespertoli,FI,72,9,61,3,7,80,5,70,5,22,102
2020,48030,Montespertoli,FI,73,7,57,2,4,70,2,59,4,15,80
2020,48030,Montespertoli,FI,74,4,67,1,4,76,2,55,2,10,69
2020,48030,Montespertoli,FI,75,2,57,1,4,64,1,40,2,10,53
2020,48030,Montespertoli,FI,76,4,40,2,4,50,1,35,1,16,53
2020,48030,Montespertoli,FI,77,3,54,2,6,65,2,40,2,16,60
2020,48030,Montespertoli,FI,78,1,49,3,5,58,1,35,4,19,59
2020,48030,Montespertoli,FI,79,3,39,0,3,45,2,27,2,27,58
2020,48030,Montespertoli,FI,80,3,43,1,11,58,1,23,1,24,49
2020,48030,Montespertoli,FI,81,4,46,0,14,64,0,19,1,27,47
2020,48030,Montespertoli,FI,82,5,35,1,3,44,3,22,0,30,55
2020,48030,Montespertoli,FI,83,1,21,1,6,29,1,19,1,33,54
2020,48030,Montespertoli,FI,84,1,25,2,7,35,1,14,1,28,44
2020,48030,Montespertoli,FI,85,4,25,0,4,33,1,16,2,37,56
2020,48030,Montespertoli,FI,86,0,22,2,4,28,2,15,0,29,46
2020,48030,Montespertoli,FI,87,1,17,1,10,29,1,8,0,30,39
2020,48030,Montespertoli,FI,88,1,16,0,6,23,0,6,0,23,29
2020,48030,Montespertoli,FI,89,2,11,1,6,20,0,7,0,22,29
2020,48030,Montespertoli,FI,90,2,10,0,5,17,0,5,0,20,25
2020,48030,Montespertoli,FI,91,2,2,1,4,9,0,0,0,16,16
2020,48030,Montespertoli,FI,92,0,6,0,1,7,2,3,0,15,20
2020,48030,Montespertoli,FI,93,0,3,0,1,4,0,0,0,15,15
2020,48030,Montespertoli,FI,94,0,2,0,2,4,2,1,0,13,16
2020,48030,Montespertoli,FI,95,0,3,0,0,3,0,0,0,9,9
2020,48030,Montespertoli,FI,96,0,1,0,3,4,1,0,0,6,7
2020,48030,Montespertoli,FI,97,0,0,0,1,1,0,0,0,9,9
2020,48030,Montespertoli,FI,98,0,0,0,0,0,0,1,0,1,2
2020,48030,Montespertoli,FI,99,0,0,0,0,0,1,0,0,1,2
2020,48030,Montespertoli,FI,100 e più,0,1,0,0,1,0,0,0,2,2
2020,48031,Palazzuolo sul Senio,FI,0,3,0,0,0,3,4,0,0,0,4
2020,48031,Palazzuolo sul Senio,FI,1,8,0,0,0,8,2,0,0,0,2
2020,48031,Palazzuolo sul Senio,FI,2,1,0,0,0,1,3,0,0,0,3
2020,48031,Palazzuolo sul Senio,FI,3,2,0,0,0,2,3,0,0,0,3
2020,48031,Palazzuolo sul Senio,FI,4,1,0,0,0,1,3,0,0,0,3
2020,48031,Palazzuolo sul Senio,FI,5,5,0,0,0,5,1,0,0,0,1
2020,48031,Palazzuolo sul Senio,FI,6,1,0,0,0,1,5,0,0,0,5
2020,48031,Palazzuolo sul Senio,FI,7,4,0,0,0,4,2,0,0,0,2
2020,48031,Palazzuolo sul Senio,FI,8,2,0,0,0,2,7,0,0,0,7
2020,48031,Palazzuolo sul Senio,FI,9,0,0,0,0,0,4,0,0,0,4
2020,48031,Palazzuolo sul Senio,FI,10,6,0,0,0,6,6,0,0,0,6
2020,48031,Palazzuolo sul Senio,FI,11,2,0,0,0,2,4,0,0,0,4
2020,48031,Palazzuolo sul Senio,FI,12,3,0,0,0,3,4,0,0,0,4
2020,48031,Palazzuolo sul Senio,FI,13,6,0,0,0,6,4,0,0,0,4
2020,48031,Palazzuolo sul Senio,FI,14,2,0,0,0,2,3,0,0,0,3
2020,48031,Palazzuolo sul Senio,FI,15,3,0,0,0,3,2,0,0,0,2
2020,48031,Palazzuolo sul Senio,FI,16,5,0,0,0,5,3,0,0,0,3
2020,48031,Palazzuolo sul Senio,FI,17,4,0,0,0,4,3,0,0,0,3
2020,48031,Palazzuolo sul Senio,FI,18,6,0,0,0,6,1,0,0,0,1
2020,48031,Palazzuolo sul Senio,FI,19,3,0,0,0,3,4,0,0,0,4
2020,48031,Palazzuolo sul Senio,FI,20,2,0,0,0,2,3,0,0,0,3
2020,48031,Palazzuolo sul Senio,FI,21,4,0,0,0,4,3,0,0,0,3
2020,48031,Palazzuolo sul Senio,FI,22,5,0,0,0,5,5,0,0,0,5
2020,48031,Palazzuolo sul Senio,FI,23,5,0,0,0,5,6,0,0,0,6
2020,48031,Palazzuolo sul Senio,FI,24,3,0,0,0,3,2,1,0,0,3
2020,48031,Palazzuolo sul Senio,FI,25,4,0,0,0,4,4,0,0,0,4
2020,48031,Palazzuolo sul Senio,FI,26,5,0,0,0,5,2,1,0,0,3
2020,48031,Palazzuolo sul Senio,FI,27,3,0,0,0,3,2,0,0,0,2
2020,48031,Palazzuolo sul Senio,FI,28,2,0,0,0,2,4,0,0,0,4
2020,48031,Palazzuolo sul Senio,FI,29,4,0,0,0,4,0,1,0,0,1
2020,48031,Palazzuolo sul Senio,FI,30,8,0,0,0,8,4,1,0,0,5
2020,48031,Palazzuolo sul Senio,FI,31,7,0,0,0,7,3,0,0,0,3
2020,48031,Palazzuolo sul Senio,FI,32,5,0,0,0,5,3,0,0,0,3
2020,48031,Palazzuolo sul Senio,FI,33,5,1,0,0,6,1,1,0,0,2
2020,48031,Palazzuolo sul Senio,FI,34,2,0,0,0,2,0,2,1,0,3
2020,48031,Palazzuolo sul Senio,FI,35,3,2,0,0,5,2,0,0,0,2
2020,48031,Palazzuolo sul Senio,FI,36,3,0,0,0,3,4,0,0,0,4
2020,48031,Palazzuolo sul Senio,FI,37,3,1,0,0,4,6,2,1,0,9
2020,48031,Palazzuolo sul Senio,FI,38,7,0,0,0,7,4,3,0,0,7
2020,48031,Palazzuolo sul Senio,FI,39,6,3,0,0,9,4,3,0,0,7
2020,48031,Palazzuolo sul Senio,FI,40,6,2,0,0,8,3,1,0,0,4
2020,48031,Palazzuolo sul Senio,FI,41,0,1,0,0,1,2,1,0,0,3
2020,48031,Palazzuolo sul Senio,FI,42,7,1,1,0,9,4,4,0,0,8
2020,48031,Palazzuolo sul Senio,FI,43,7,3,0,0,10,2,1,0,0,3
2020,48031,Palazzuolo sul Senio,FI,44,3,1,0,0,4,2,4,2,0,8
2020,48031,Palazzuolo sul Senio,FI,45,6,5,0,0,11,0,6,1,1,8
2020,48031,Palazzuolo sul Senio,FI,46,3,0,1,0,4,2,3,0,0,5
2020,48031,Palazzuolo sul Senio,FI,47,1,3,2,0,6,1,2,0,0,3
2020,48031,Palazzuolo sul Senio,FI,48,3,1,1,0,5,0,2,0,0,2
2020,48031,Palazzuolo sul Senio,FI,49,4,5,1,0,10,3,6,0,1,10
2020,48031,Palazzuolo sul Senio,FI,50,4,3,1,0,8,6,6,0,0,12
2020,48031,Palazzuolo sul Senio,FI,51,4,6,2,0,12,4,7,0,1,12
2020,48031,Palazzuolo sul Senio,FI,52,7,7,0,0,14,0,6,0,0,6
2020,48031,Palazzuolo sul Senio,FI,53,5,2,1,0,8,1,5,1,0,7
2020,48031,Palazzuolo sul Senio,FI,54,6,6,0,0,12,6,5,0,0,11
2020,48031,Palazzuolo sul Senio,FI,55,5,8,0,0,13,1,10,0,0,11
2020,48031,Palazzuolo sul Senio,FI,56,3,3,0,0,6,2,5,3,0,10
2020,48031,Palazzuolo sul Senio,FI,57,3,6,1,0,10,1,4,2,1,8
2020,48031,Palazzuolo sul Senio,FI,58,1,2,2,0,5,1,9,0,0,10
2020,48031,Palazzuolo sul Senio,FI,59,7,6,0,0,13,0,7,2,1,10
2020,48031,Palazzuolo sul Senio,FI,60,3,5,2,0,10,1,7,1,0,9
2020,48031,Palazzuolo sul Senio,FI,61,1,7,1,0,9,2,9,0,0,11
2020,48031,Palazzuolo sul Senio,FI,62,2,6,1,0,9,1,7,1,2,11
2020,48031,Palazzuolo sul Senio,FI,63,1,4,2,0,7,3,3,1,0,7
2020,48031,Palazzuolo sul Senio,FI,64,2,11,1,0,14,2,5,1,0,8
2020,48031,Palazzuolo sul Senio,FI,65,1,4,1,0,6,1,5,1,0,7
2020,48031,Palazzuolo sul Senio,FI,66,2,4,0,0,6,2,6,0,0,8
2020,48031,Palazzuolo sul Senio,FI,67,2,10,3,0,15,1,6,0,2,9
2020,48031,Palazzuolo sul Senio,FI,68,2,9,1,0,12,1,4,0,1,6
2020,48031,Palazzuolo sul Senio,FI,69,2,4,1,1,8,1,5,1,1,8
2020,48031,Palazzuolo sul Senio,FI,70,2,8,0,0,10,0,2,1,5,8
2020,48031,Palazzuolo sul Senio,FI,71,0,6,1,1,8,0,4,0,2,6
2020,48031,Palazzuolo sul Senio,FI,72,0,6,0,0,6,0,3,0,1,4
2020,48031,Palazzuolo sul Senio,FI,73,2,7,1,1,11,0,4,0,0,4
2020,48031,Palazzuolo sul Senio,FI,74,4,6,1,0,11,0,4,0,3,7
2020,48031,Palazzuolo sul Senio,FI,75,1,3,0,2,6,1,0,0,5,6
2020,48031,Palazzuolo sul Senio,FI,76,1,4,0,1,6,0,6,0,1,7
2020,48031,Palazzuolo sul Senio,FI,77,1,1,0,0,2,1,3,0,4,8
2020,48031,Palazzuolo sul Senio,FI,78,2,5,0,0,7,1,4,0,1,6
2020,48031,Palazzuolo sul Senio,FI,79,0,3,0,0,3,0,4,1,3,8
2020,48031,Palazzuolo sul Senio,FI,80,1,7,1,1,10,0,3,0,3,6
2020,48031,Palazzuolo sul Senio,FI,81,4,4,0,1,9,3,3,0,8,14
2020,48031,Palazzuolo sul Senio,FI,82,0,8,0,1,9,1,3,1,3,8
2020,48031,Palazzuolo sul Senio,FI,83,2,5,1,0,8,1,5,1,2,9
2020,48031,Palazzuolo sul Senio,FI,84,2,1,0,2,5,1,4,0,4,9
2020,48031,Palazzuolo sul Senio,FI,85,1,3,0,1,5,0,4,1,7,12
2020,48031,Palazzuolo sul Senio,FI,86,0,4,0,0,4,0,1,0,3,4
2020,48031,Palazzuolo sul Senio,FI,87,1,0,1,0,2,0,0,0,3,3
2020,48031,Palazzuolo sul Senio,FI,88,0,2,0,1,3,0,1,0,3,4
2020,48031,Palazzuolo sul Senio,FI,89,1,4,0,1,6,0,0,0,4,4
2020,48031,Palazzuolo sul Senio,FI,90,1,0,0,1,2,0,1,0,3,4
2020,48031,Palazzuolo sul Senio,FI,91,0,1,0,1,2,0,1,0,4,5
2020,48031,Palazzuolo sul Senio,FI,92,0,0,0,0,0,0,0,0,2,2
2020,48031,Palazzuolo sul Senio,FI,93,0,0,0,0,0,0,0,0,4,4
2020,48031,Palazzuolo sul Senio,FI,94,0,1,0,1,2,0,0,0,3,3
2020,48031,Palazzuolo sul Senio,FI,95,0,0,0,1,1,0,0,0,4,4
2020,48031,Palazzuolo sul Senio,FI,96,0,1,0,0,1,1,0,0,0,1
2020,48031,Palazzuolo sul Senio,FI,97,0,0,0,0,0,0,0,0,0,0
2020,48031,Palazzuolo sul Senio,FI,98,0,0,0,0,0,0,0,0,2,2
2020,48031,Palazzuolo sul Senio,FI,99,0,0,0,0,0,0,0,0,1,1
2020,48031,Palazzuolo sul Senio,FI,100 e più,0,0,0,0,0,0,0,0,2,2
2020,48032,Pelago,FI,0,30,0,0,0,30,20,0,0,0,20
2020,48032,Pelago,FI,1,24,0,0,0,24,18,0,0,0,18
2020,48032,Pelago,FI,2,28,0,0,0,28,19,0,0,0,19
2020,48032,Pelago,FI,3,28,0,0,0,28,24,0,0,0,24
2020,48032,Pelago,FI,4,26,0,0,0,26,36,0,0,0,36
2020,48032,Pelago,FI,5,27,0,0,0,27,23,0,0,0,23
2020,48032,Pelago,FI,6,20,0,0,0,20,39,0,0,0,39
2020,48032,Pelago,FI,7,32,0,0,0,32,36,0,0,0,36
2020,48032,Pelago,FI,8,31,0,0,0,31,22,0,0,0,22
2020,48032,Pelago,FI,9,43,0,0,0,43,31,0,0,0,31
2020,48032,Pelago,FI,10,38,0,0,0,38,40,0,0,0,40
2020,48032,Pelago,FI,11,32,0,0,0,32,41,0,0,0,41
2020,48032,Pelago,FI,12,49,0,0,0,49,42,0,0,0,42
2020,48032,Pelago,FI,13,40,0,0,0,40,34,0,0,0,34
2020,48032,Pelago,FI,14,45,0,0,0,45,36,0,0,0,36
2020,48032,Pelago,FI,15,37,0,0,0,37,47,0,0,0,47
2020,48032,Pelago,FI,16,44,0,0,0,44,41,0,0,0,41
2020,48032,Pelago,FI,17,26,0,0,0,26,33,0,0,0,33
2020,48032,Pelago,FI,18,46,0,0,0,46,31,0,0,0,31
2020,48032,Pelago,FI,19,25,0,0,0,25,39,0,0,0,39
2020,48032,Pelago,FI,20,52,0,0,0,52,34,0,0,0,34
2020,48032,Pelago,FI,21,32,0,0,0,32,38,1,0,0,39
2020,48032,Pelago,FI,22,51,0,0,0,51,27,0,0,0,27
2020,48032,Pelago,FI,23,47,0,0,0,47,35,2,0,0,37
2020,48032,Pelago,FI,24,42,0,0,0,42,30,1,0,0,31
2020,48032,Pelago,FI,25,29,0,0,0,29,37,3,0,0,40
2020,48032,Pelago,FI,26,27,2,0,0,29,24,4,0,0,28
2020,48032,Pelago,FI,27,39,2,0,0,41,33,9,0,0,42
2020,48032,Pelago,FI,28,29,8,0,0,37,31,7,1,0,39
2020,48032,Pelago,FI,29,28,6,0,0,34,23,7,1,0,31
2020,48032,Pelago,FI,30,34,11,1,0,46,20,12,0,0,32
2020,48032,Pelago,FI,31,35,3,0,0,38,36,12,0,0,48
2020,48032,Pelago,FI,32,31,9,0,0,40,20,12,0,0,32
2020,48032,Pelago,FI,33,39,8,0,0,47,22,13,0,0,35
2020,48032,Pelago,FI,34,18,12,0,0,30,18,16,0,0,34
2020,48032,Pelago,FI,35,25,16,0,0,41,21,18,0,0,39
2020,48032,Pelago,FI,36,24,14,1,0,39,13,14,1,0,28
2020,48032,Pelago,FI,37,19,15,0,0,34,18,17,1,0,36
2020,48032,Pelago,FI,38,18,19,0,0,37,17,26,0,0,43
2020,48032,Pelago,FI,39,19,17,1,0,37,15,21,3,0,39
2020,48032,Pelago,FI,40,15,18,2,0,35,13,30,2,0,45
2020,48032,Pelago,FI,41,16,14,0,0,30,13,22,1,1,37
2020,48032,Pelago,FI,42,18,27,0,0,45,21,34,1,1,57
2020,48032,Pelago,FI,43,25,28,1,0,54,20,25,3,1,49
2020,48032,Pelago,FI,44,22,31,2,0,55,24,33,2,1,60
2020,48032,Pelago,FI,45,26,30,1,0,57,19,48,1,0,68
2020,48032,Pelago,FI,46,26,34,2,0,62,21,30,5,1,57
2020,48032,Pelago,FI,47,24,43,5,0,72,20,49,5,1,75
2020,48032,Pelago,FI,48,15,35,4,0,54,19,45,3,1,68
2020,48032,Pelago,FI,49,27,43,2,1,73,13,52,4,1,70
2020,48032,Pelago,FI,50,17,49,4,0,70,10,47,2,0,59
2020,48032,Pelago,FI,51,15,46,3,1,65,17,47,3,1,68
2020,48032,Pelago,FI,52,21,48,3,0,72,13,52,4,0,69
2020,48032,Pelago,FI,53,22,51,4,1,78,8,45,8,1,62
2020,48032,Pelago,FI,54,16,40,4,0,60,9,47,7,2,65
2020,48032,Pelago,FI,55,22,53,5,1,81,5,43,5,3,56
2020,48032,Pelago,FI,56,15,23,4,0,42,14,45,5,0,64
2020,48032,Pelago,FI,57,11,53,3,1,68,8,38,7,2,55
2020,48032,Pelago,FI,58,8,36,3,1,48,10,51,4,1,66
2020,48032,Pelago,FI,59,6,41,2,1,50,8,39,4,2,53
2020,48032,Pelago,FI,60,6,58,11,1,76,8,54,7,3,72
2020,48032,Pelago,FI,61,8,37,6,0,51,5,43,3,2,53
2020,48032,Pelago,FI,62,2,51,2,3,58,6,42,3,2,53
2020,48032,Pelago,FI,63,5,41,3,1,50,1,42,5,6,54
2020,48032,Pelago,FI,64,4,31,2,3,40,7,36,3,10,56
2020,48032,Pelago,FI,65,4,29,2,2,37,3,35,5,3,46
2020,48032,Pelago,FI,66,2,41,3,0,46,8,45,3,6,62
2020,48032,Pelago,FI,67,7,46,3,0,56,1,38,4,1,44
2020,48032,Pelago,FI,68,4,36,3,0,43,3,41,2,6,52
2020,48032,Pelago,FI,69,6,29,0,3,38,1,26,1,9,37
2020,48032,Pelago,FI,70,3,39,1,5,48,1,34,2,8,45
2020,48032,Pelago,FI,71,5,43,6,3,57,2,43,2,9,56
2020,48032,Pelago,FI,72,2,45,2,3,52,1,37,2,7,47
2020,48032,Pelago,FI,73,3,38,2,4,47,2,43,0,10,55
2020,48032,Pelago,FI,74,1,39,2,3,45,3,39,3,19,64
2020,48032,Pelago,FI,75,4,22,2,2,30,1,21,1,15,38
2020,48032,Pelago,FI,76,2,32,1,4,39,1,14,1,15,31
2020,48032,Pelago,FI,77,0,24,0,5,29,1,28,0,13,42
2020,48032,Pelago,FI,78,1,28,2,4,35,3,12,1,11,27
2020,48032,Pelago,FI,79,2,20,2,1,25,1,16,2,16,35
2020,48032,Pelago,FI,80,1,32,0,5,38,0,16,1,19,36
2020,48032,Pelago,FI,81,3,31,0,6,40,2,18,0,17,37
2020,48032,Pelago,FI,82,0,22,0,6,28,1,12,3,23,39
2020,48032,Pelago,FI,83,4,8,0,5,17,0,7,0,19,26
2020,48032,Pelago,FI,84,2,12,0,7,21,1,12,0,21,34
2020,48032,Pelago,FI,85,1,13,0,7,21,1,10,1,22,34
2020,48032,Pelago,FI,86,0,15,0,3,18,1,8,1,17,27
2020,48032,Pelago,FI,87,3,7,1,4,15,0,4,0,15,19
2020,48032,Pelago,FI,88,1,3,0,3,7,0,1,1,24,26
2020,48032,Pelago,FI,89,1,11,0,3,15,1,3,0,19,23
2020,48032,Pelago,FI,90,1,5,0,4,10,0,4,0,11,15
2020,48032,Pelago,FI,91,1,6,0,5,12,2,3,0,11,16
2020,48032,Pelago,FI,92,0,4,0,2,6,1,0,0,8,9
2020,48032,Pelago,FI,93,0,1,0,1,2,0,0,0,11,11
2020,48032,Pelago,FI,94,2,0,0,1,3,0,1,0,10,11
2020,48032,Pelago,FI,95,1,0,0,1,2,1,1,0,7,9
2020,48032,Pelago,FI,96,1,2,0,0,3,0,1,0,5,6
2020,48032,Pelago,FI,97,0,0,0,1,1,1,0,0,4,5
2020,48032,Pelago,FI,98,0,0,0,1,1,0,0,0,1,1
2020,48032,Pelago,FI,99,0,0,0,0,0,0,0,0,3,3
2020,48032,Pelago,FI,100 e più,0,0,0,0,0,0,0,0,1,1
2020,48033,Pontassieve,FI,0,65,0,0,0,65,64,0,0,0,64
2020,48033,Pontassieve,FI,1,74,0,0,0,74,64,0,0,0,64
2020,48033,Pontassieve,FI,2,63,0,0,0,63,61,0,0,0,61
2020,48033,Pontassieve,FI,3,85,0,0,0,85,69,0,0,0,69
2020,48033,Pontassieve,FI,4,86,0,0,0,86,79,0,0,0,79
2020,48033,Pontassieve,FI,5,67,0,0,0,67,92,0,0,0,92
2020,48033,Pontassieve,FI,6,89,0,0,0,89,79,0,0,0,79
2020,48033,Pontassieve,FI,7,89,0,0,0,89,74,0,0,0,74
2020,48033,Pontassieve,FI,8,95,0,0,0,95,90,0,0,0,90
2020,48033,Pontassieve,FI,9,102,0,0,0,102,95,0,0,0,95
2020,48033,Pontassieve,FI,10,95,0,0,0,95,88,0,0,0,88
2020,48033,Pontassieve,FI,11,96,0,0,0,96,94,0,0,0,94
2020,48033,Pontassieve,FI,12,93,0,0,0,93,104,0,0,0,104
2020,48033,Pontassieve,FI,13,122,0,0,0,122,86,0,0,0,86
2020,48033,Pontassieve,FI,14,100,0,0,0,100,93,0,0,0,93
2020,48033,Pontassieve,FI,15,95,0,0,0,95,96,0,0,0,96
2020,48033,Pontassieve,FI,16,101,0,0,0,101,88,0,0,0,88
2020,48033,Pontassieve,FI,17,103,0,0,0,103,81,0,0,0,81
2020,48033,Pontassieve,FI,18,90,0,0,0,90,83,0,0,0,83
2020,48033,Pontassieve,FI,19,96,0,0,0,96,81,0,0,0,81
2020,48033,Pontassieve,FI,20,97,0,0,0,97,103,0,0,0,103
2020,48033,Pontassieve,FI,21,107,0,0,0,107,77,3,0,0,80
2020,48033,Pontassieve,FI,22,88,1,0,0,89,75,1,0,0,76
2020,48033,Pontassieve,FI,23,112,0,0,0,112,85,3,0,0,88
2020,48033,Pontassieve,FI,24,79,1,0,0,80,89,3,0,0,92
2020,48033,Pontassieve,FI,25,85,6,0,0,91,67,8,0,0,75
2020,48033,Pontassieve,FI,26,103,5,0,0,108,70,10,0,0,80
2020,48033,Pontassieve,FI,27,95,4,0,0,99,76,7,0,0,83
2020,48033,Pontassieve,FI,28,91,9,0,0,100,72,15,0,0,87
2020,48033,Pontassieve,FI,29,104,4,0,0,108,68,21,1,0,90
2020,48033,Pontassieve,FI,30,73,13,0,0,86,68,23,0,0,91
2020,48033,Pontassieve,FI,31,91,18,0,0,110,59,28,1,0,88
2020,48033,Pontassieve,FI,32,80,24,1,0,105,61,45,2,0,108
2020,48033,Pontassieve,FI,33,77,24,0,0,101,56,60,1,0,117
2020,48033,Pontassieve,FI,34,75,38,1,0,114,49,51,2,0,103
2020,48033,Pontassieve,FI,35,76,37,0,0,114,49,47,0,0,96
2020,48033,Pontassieve,FI,36,59,32,0,1,92,52,60,4,0,116
2020,48033,Pontassieve,FI,37,59,39,2,0,101,50,46,1,1,98
2020,48033,Pontassieve,FI,38,57,46,0,0,103,48,53,1,0,103
2020,48033,Pontassieve,FI,39,71,50,1,0,122,47,70,4,1,122
2020,48033,Pontassieve,FI,40,48,59,1,0,108,38,82,3,0,123
2020,48033,Pontassieve,FI,41,59,63,2,0,124,30,82,3,0,115
2020,48033,Pontassieve,FI,42,66,73,2,0,141,54,83,4,0,141
2020,48033,Pontassieve,FI,43,52,70,3,0,125,41,77,7,0,126
2020,48033,Pontassieve,FI,44,50,81,8,0,139,50,84,4,2,140
2020,48033,Pontassieve,FI,45,64,86,4,0,154,50,74,4,1,129
2020,48033,Pontassieve,FI,46,50,86,5,1,142,35,109,8,0,152
2020,48033,Pontassieve,FI,47,49,92,6,0,147,39,99,10,2,150
2020,48033,Pontassieve,FI,48,42,94,7,1,145,44,107,15,5,172
2020,48033,Pontassieve,FI,49,42,97,8,0,147,35,116,7,2,160
2020,48033,Pontassieve,FI,50,43,106,7,0,156,35,107,8,3,153
2020,48033,Pontassieve,FI,51,42,100,12,1,156,33,104,9,2,148
2020,48033,Pontassieve,FI,52,37,103,8,0,148,38,109,17,3,168
2020,48033,Pontassieve,FI,53,36,109,13,2,160,26,132,10,1,169
2020,48033,Pontassieve,FI,54,51,83,9,1,144,29,129,16,4,178
2020,48033,Pontassieve,FI,55,27,113,8,0,149,31,103,11,5,150
2020,48033,Pontassieve,FI,56,36,122,7,3,168,19,127,13,11,170
2020,48033,Pontassieve,FI,57,33,98,8,1,141,19,106,18,6,149
2020,48033,Pontassieve,FI,58,18,101,15,0,135,21,110,17,8,156
2020,48033,Pontassieve,FI,59,38,107,10,2,157,18,116,12,6,152
2020,48033,Pontassieve,FI,60,18,120,13,3,154,15,109,11,5,140
2020,48033,Pontassieve,FI,61,13,103,5,1,122,9,119,15,8,151
2020,48033,Pontassieve,FI,62,11,120,9,0,140,14,107,12,14,147
2020,48033,Pontassieve,FI,63,21,97,10,2,130,16,114,15,16,161
2020,48033,Pontassieve,FI,64,9,104,8,4,125,13,104,9,13,139
2020,48033,Pontassieve,FI,65,18,95,8,2,123,11,103,10,22,146
2020,48033,Pontassieve,FI,66,13,106,7,2,128,12,97,10,19,138
2020,48033,Pontassieve,FI,67,14,95,3,1,113,7,116,7,10,140
2020,48033,Pontassieve,FI,68,9,99,8,3,119,10,113,8,18,149
2020,48033,Pontassieve,FI,69,6,114,1,4,125,7,113,9,24,153
2020,48033,Pontassieve,FI,70,5,128,5,1,139,3,124,6,27,160
2020,48033,Pontassieve,FI,71,10,122,7,8,147,7,114,4,32,157
2020,48033,Pontassieve,FI,72,12,140,4,8,164,7,127,5,30,169
2020,48033,Pontassieve,FI,73,10,133,6,5,154,6,114,7,39,166
2020,48033,Pontassieve,FI,74,7,122,4,13,146,4,85,5,38,132
2020,48033,Pontassieve,FI,75,7,65,2,9,83,5,61,0,30,96
2020,48033,Pontassieve,FI,76,6,65,1,11,83,4,65,6,39,114
2020,48033,Pontassieve,FI,77,4,76,3,13,96,5,68,4,46,123
2020,48033,Pontassieve,FI,78,8,80,2,10,100,2,47,4,45,98
2020,48033,Pontassieve,FI,79,3,75,0,13,91,5,58,4,49,116
2020,48033,Pontassieve,FI,80,5,88,4,16,113,0,53,2,54,109
2020,48033,Pontassieve,FI,81,8,65,2,19,94,3,45,2,54,104
2020,48033,Pontassieve,FI,82,4,57,1,12,74,2,60,5,65,132
2020,48033,Pontassieve,FI,83,5,49,2,16,72,0,44,1,62,107
2020,48033,Pontassieve,FI,84,3,54,0,12,69,1,28,1,69,99
2020,48033,Pontassieve,FI,85,5,39,1,15,60,2,26,1,56,85
2020,48033,Pontassieve,FI,86,3,47,1,12,63,2,19,1,45,67
2020,48033,Pontassieve,FI,87,4,34,0,10,48,2,19,0,48,69
2020,48033,Pontassieve,FI,88,3,20,0,13,36,1,10,1,39,51
2020,48033,Pontassieve,FI,89,3,16,0,12,31,2,9,2,44,57
2020,48033,Pontassieve,FI,90,2,15,1,12,30,1,3,2,55,61
2020,48033,Pontassieve,FI,91,0,11,0,2,13,1,6,0,32,39
2020,48033,Pontassieve,FI,92,0,15,0,7,22,0,3,0,37,40
2020,48033,Pontassieve,FI,93,0,7,0,8,15,1,1,0,34,36
2020,48033,Pontassieve,FI,94,0,2,0,2,4,1,0,0,30,31
2020,48033,Pontassieve,FI,95,0,3,0,3,6,1,3,0,20,24
2020,48033,Pontassieve,FI,96,0,1,0,1,2,0,0,0,11,11
2020,48033,Pontassieve,FI,97,0,2,0,3,5,1,0,0,7,8
2020,48033,Pontassieve,FI,98,1,0,0,2,3,0,0,0,5,5
2020,48033,Pontassieve,FI,99,0,1,0,2,3,0,0,0,3,3
2020,48033,Pontassieve,FI,100 e più,0,0,0,1,1,0,0,0,9,9
2020,48035,Reggello,FI,0,48,0,0,0,48,44,0,0,0,44
2020,48035,Reggello,FI,1,61,0,0,0,61,54,0,0,0,54
2020,48035,Reggello,FI,2,68,0,0,0,68,62,0,0,0,62
2020,48035,Reggello,FI,3,79,0,0,0,79,68,0,0,0,68
2020,48035,Reggello,FI,4,62,0,0,0,62,55,0,0,0,55
2020,48035,Reggello,FI,5,82,0,0,0,82,50,0,0,0,50
2020,48035,Reggello,FI,6,76,0,0,0,76,60,0,0,0,60
2020,48035,Reggello,FI,7,77,0,0,0,77,76,0,0,0,76
2020,48035,Reggello,FI,8,75,0,0,0,75,72,0,0,0,72
2020,48035,Reggello,FI,9,78,0,0,0,78,77,0,0,0,77
2020,48035,Reggello,FI,10,80,0,0,0,80,71,0,0,0,71
2020,48035,Reggello,FI,11,70,0,0,0,70,70,0,0,0,70
2020,48035,Reggello,FI,12,82,0,0,0,82,75,0,0,0,75
2020,48035,Reggello,FI,13,85,0,0,0,85,83,0,0,0,83
2020,48035,Reggello,FI,14,75,0,0,0,75,65,0,0,0,65
2020,48035,Reggello,FI,15,70,0,0,0,70,69,0,0,0,69
2020,48035,Reggello,FI,16,61,0,0,0,61,98,0,0,0,98
2020,48035,Reggello,FI,17,81,0,0,0,81,79,0,0,0,79
2020,48035,Reggello,FI,18,76,0,0,0,76,65,0,0,0,65
2020,48035,Reggello,FI,19,75,0,0,0,75,74,0,0,0,74
2020,48035,Reggello,FI,20,81,0,0,0,81,77,1,0,0,78
2020,48035,Reggello,FI,21,96,0,0,0,96,72,3,0,0,75
2020,48035,Reggello,FI,22,75,1,0,0,76,57,1,0,0,58
2020,48035,Reggello,FI,23,68,0,0,0,68,65,3,0,0,68
2020,48035,Reggello,FI,24,83,2,0,0,85,66,4,0,0,70
2020,48035,Reggello,FI,25,60,1,0,0,61,69,2,0,0,71
2020,48035,Reggello,FI,26,83,3,1,0,87,72,5,0,0,77
2020,48035,Reggello,FI,27,64,1,0,0,65,62,8,0,0,70
2020,48035,Reggello,FI,28,67,4,0,0,71,61,10,0,0,71
2020,48035,Reggello,FI,29,89,3,0,0,92,63,10,0,0,73
2020,48035,Reggello,FI,30,77,7,0,0,84,69,14,0,0,83
2020,48035,Reggello,FI,31,79,13,0,0,92,73,27,1,0,101
2020,48035,Reggello,FI,32,71,14,0,0,85,56,28,1,0,85
2020,48035,Reggello,FI,33,76,26,0,0,102,55,36,1,0,92
2020,48035,Reggello,FI,34,52,18,0,0,70,52,38,3,0,93
2020,48035,Reggello,FI,35,60,32,2,0,94,34,36,1,0,71
2020,48035,Reggello,FI,36,56,42,1,0,99,40,44,3,0,87
2020,48035,Reggello,FI,37,53,30,1,0,84,40,57,2,0,99
2020,48035,Reggello,FI,38,46,33,0,0,79,42,50,6,0,98
2020,48035,Reggello,FI,39,50,43,0,0,93,36,52,4,1,93
2020,48035,Reggello,FI,40,48,42,1,0,91,37,57,6,0,100
2020,48035,Reggello,FI,41,51,59,1,0,111,41,64,5,1,111
2020,48035,Reggello,FI,42,59,56,5,0,120,43,62,11,0,116
2020,48035,Reggello,FI,43,44,77,6,0,127,35,81,10,1,127
2020,48035,Reggello,FI,44,46,65,5,0,116,38,75,3,1,117
2020,48035,Reggello,FI,45,47,66,6,0,119,30,82,3,3,118
2020,48035,Reggello,FI,46,42,92,8,1,143,39,100,7,1,147
2020,48035,Reggello,FI,47,40,74,5,0,119,30,90,5,4,129
2020,48035,Reggello,FI,48,45,81,7,0,133,20,92,12,0,124
2020,48035,Reggello,FI,49,50,87,6,0,143,31,90,14,1,136
2020,48035,Reggello,FI,50,40,78,9,0,127,22,81,12,3,118
2020,48035,Reggello,FI,51,35,79,9,0,123,25,100,12,5,142
2020,48035,Reggello,FI,52,34,86,9,1,130,24,87,12,2,125
2020,48035,Reggello,FI,53,28,89,8,1,126,23,130,9,4,166
2020,48035,Reggello,FI,54,19,105,12,0,136,12,117,14,1,144
2020,48035,Reggello,FI,55,32,109,10,1,152,26,117,14,2,159
2020,48035,Reggello,FI,56,38,130,10,4,182,35,84,16,4,139
2020,48035,Reggello,FI,57,21,81,6,3,111,10,103,10,9,132
2020,48035,Reggello,FI,58,17,81,9,1,108,8,97,7,9,121
2020,48035,Reggello,FI,59,22,92,16,3,133,6,95,14,6,121
2020,48035,Reggello,FI,60,15,96,10,2,123,11,94,4,7,116
2020,48035,Reggello,FI,61,13,95,9,4,121,10,103,8,4,125
2020,48035,Reggello,FI,62,13,85,5,3,106,7,78,8,10,103
2020,48035,Reggello,FI,63,10,89,7,4,110,7,80,3,16,106
2020,48035,Reggello,FI,64,7,77,6,3,93,11,64,12,13,100
2020,48035,Reggello,FI,65,14,79,6,4,103,9,72,6,3,90
2020,48035,Reggello,FI,66,12,75,8,6,101,6,98,5,10,119
2020,48035,Reggello,FI,67,6,81,4,3,94,6,81,6,12,105
2020,48035,Reggello,FI,68,6,88,7,3,104,3,87,3,11,104
2020,48035,Reggello,FI,69,8,81,5,8,102,1,80,9,15,105
2020,48035,Reggello,FI,70,7,78,6,4,95,5,69,5,16,95
2020,48035,Reggello,FI,71,3,94,4,4,105,4,69,3,25,101
2020,48035,Reggello,FI,72,7,84,2,8,101,4,89,2,27,122
2020,48035,Reggello,FI,73,5,94,3,6,108,3,96,4,20,123
2020,48035,Reggello,FI,74,4,89,3,8,104,4,68,8,29,109
2020,48035,Reggello,FI,75,7,66,3,4,80,2,50,3,15,70
2020,48035,Reggello,FI,76,5,54,6,10,75,5,63,2,28,98
2020,48035,Reggello,FI,77,5,65,2,5,77,1,44,3,25,73
2020,48035,Reggello,FI,78,4,52,2,11,69,1,37,2,25,65
2020,48035,Reggello,FI,79,14,53,6,7,80,2,38,0,30,70
2020,48035,Reggello,FI,80,2,64,4,6,76,3,46,0,42,91
2020,48035,Reggello,FI,81,4,61,1,14,80,0,34,0,42,76
2020,48035,Reggello,FI,82,4,52,1,13,70,4,32,2,37,75
2020,48035,Reggello,FI,83,6,34,0,13,53,0,23,0,39,62
2020,48035,Reggello,FI,84,2,35,0,8,45,1,20,0,37,58
2020,48035,Reggello,FI,85,4,31,1,4,40,3,24,0,31,58
2020,48035,Reggello,FI,86,2,30,1,9,42,0,18,2,35,55
2020,48035,Reggello,FI,87,3,21,0,11,35,1,10,0,42,53
2020,48035,Reggello,FI,88,0,17,0,6,23,0,6,0,27,33
2020,48035,Reggello,FI,89,3,12,0,9,24,1,6,0,33,40
2020,48035,Reggello,FI,90,3,18,0,3,24,0,5,0,32,37
2020,48035,Reggello,FI,91,1,5,0,5,11,2,3,1,26,32
2020,48035,Reggello,FI,92,0,5,0,3,8,0,2,1,15,18
2020,48035,Reggello,FI,93,0,4,0,7,11,1,3,0,23,27
2020,48035,Reggello,FI,94,1,4,0,2,7,1,2,0,17,20
2020,48035,Reggello,FI,95,0,3,0,3,6,0,0,0,13,13
2020,48035,Reggello,FI,96,0,1,0,0,1,0,1,0,4,5
2020,48035,Reggello,FI,97,0,1,0,1,2,1,0,0,9,10
2020,48035,Reggello,FI,98,0,0,0,3,3,1,0,0,5,6
2020,48035,Reggello,FI,99,0,0,0,1,1,0,0,0,4,4
2020,48035,Reggello,FI,100 e più,0,0,0,1,1,0,0,0,1,1
2020,48036,Rignano sull'Arno,FI,0,28,0,0,0,28,19,0,0,0,19
2020,48036,Rignano sull'Arno,FI,1,24,0,0,0,24,33,0,0,0,33
2020,48036,Rignano sull'Arno,FI,2,32,0,0,0,32,44,0,0,0,44
2020,48036,Rignano sull'Arno,FI,3,31,0,0,0,31,27,0,0,0,27
2020,48036,Rignano sull'Arno,FI,4,31,0,0,0,31,29,0,0,0,29
2020,48036,Rignano sull'Arno,FI,5,37,0,0,0,37,37,0,0,0,37
2020,48036,Rignano sull'Arno,FI,6,41,0,0,0,41,36,0,0,0,36
2020,48036,Rignano sull'Arno,FI,7,54,0,0,0,54,36,0,0,0,36
2020,48036,Rignano sull'Arno,FI,8,34,0,0,0,34,28,0,0,0,28
2020,48036,Rignano sull'Arno,FI,9,50,0,0,0,50,35,0,0,0,35
2020,48036,Rignano sull'Arno,FI,10,57,0,0,0,57,44,0,0,0,44
2020,48036,Rignano sull'Arno,FI,11,47,0,0,0,47,42,0,0,0,42
2020,48036,Rignano sull'Arno,FI,12,55,0,0,0,55,46,0,0,0,46
2020,48036,Rignano sull'Arno,FI,13,41,0,0,0,41,40,0,0,0,40
2020,48036,Rignano sull'Arno,FI,14,51,0,0,0,51,35,0,0,0,35
2020,48036,Rignano sull'Arno,FI,15,47,0,0,0,47,50,0,0,0,50
2020,48036,Rignano sull'Arno,FI,16,64,0,0,0,64,43,0,0,0,43
2020,48036,Rignano sull'Arno,FI,17,45,0,0,0,45,43,0,0,0,43
2020,48036,Rignano sull'Arno,FI,18,55,0,0,0,55,38,0,0,0,38
2020,48036,Rignano sull'Arno,FI,19,54,0,0,0,54,34,0,0,0,34
2020,48036,Rignano sull'Arno,FI,20,49,0,0,0,49,31,0,0,0,31
2020,48036,Rignano sull'Arno,FI,21,48,0,0,0,48,31,0,0,0,31
2020,48036,Rignano sull'Arno,FI,22,40,0,0,0,40,39,1,1,0,41
2020,48036,Rignano sull'Arno,FI,23,31,0,0,0,31,40,0,0,0,40
2020,48036,Rignano sull'Arno,FI,24,43,0,0,0,43,31,0,0,0,31
2020,48036,Rignano sull'Arno,FI,25,30,1,0,0,31,39,3,0,0,42
2020,48036,Rignano sull'Arno,FI,26,43,0,0,0,43,30,3,0,0,33
2020,48036,Rignano sull'Arno,FI,27,37,1,0,0,38,24,4,0,0,28
2020,48036,Rignano sull'Arno,FI,28,29,1,0,0,30,33,7,0,0,40
2020,48036,Rignano sull'Arno,FI,29,38,4,0,0,42,35,6,0,0,41
2020,48036,Rignano sull'Arno,FI,30,37,3,0,0,40,29,15,1,0,45
2020,48036,Rignano sull'Arno,FI,31,34,4,1,0,39,28,10,0,0,38
2020,48036,Rignano sull'Arno,FI,32,34,8,0,0,42,28,9,1,0,38
2020,48036,Rignano sull'Arno,FI,33,35,11,0,0,46,25,14,1,0,40
2020,48036,Rignano sull'Arno,FI,34,24,8,0,0,32,30,23,1,0,54
2020,48036,Rignano sull'Arno,FI,35,24,13,1,0,38,22,18,2,0,42
2020,48036,Rignano sull'Arno,FI,36,32,12,0,0,44,26,23,1,0,50
2020,48036,Rignano sull'Arno,FI,37,26,15,2,0,43,25,17,1,0,43
2020,48036,Rignano sull'Arno,FI,38,19,17,2,0,38,25,27,2,0,54
2020,48036,Rignano sull'Arno,FI,39,28,14,0,0,42,17,27,6,0,50
2020,48036,Rignano sull'Arno,FI,40,13,24,0,0,37,19,40,1,0,60
2020,48036,Rignano sull'Arno,FI,41,25,34,0,0,59,24,39,1,1,65
2020,48036,Rignano sull'Arno,FI,42,25,30,0,0,55,23,23,4,1,51
2020,48036,Rignano sull'Arno,FI,43,22,48,0,0,70,16,35,2,0,53
2020,48036,Rignano sull'Arno,FI,44,27,30,2,0,59,12,49,4,1,66
2020,48036,Rignano sull'Arno,FI,45,25,26,3,0,54,22,43,2,0,67
2020,48036,Rignano sull'Arno,FI,46,35,51,7,0,93,12,55,2,2,71
2020,48036,Rignano sull'Arno,FI,47,26,39,3,0,68,25,46,1,0,72
2020,48036,Rignano sull'Arno,FI,48,11,45,4,0,60,16,50,6,0,72
2020,48036,Rignano sull'Arno,FI,49,16,44,5,0,65,18,49,6,1,74
2020,48036,Rignano sull'Arno,FI,50,28,54,8,0,90,17,42,8,1,68
2020,48036,Rignano sull'Arno,FI,51,13,44,2,0,59,17,50,2,1,70
2020,48036,Rignano sull'Arno,FI,52,28,58,3,1,90,11,65,9,2,87
2020,48036,Rignano sull'Arno,FI,53,18,41,8,0,67,7,61,5,2,75
2020,48036,Rignano sull'Arno,FI,54,20,48,9,0,77,9,59,9,1,78
2020,48036,Rignano sull'Arno,FI,55,16,68,3,1,88,13,55,4,1,73
2020,48036,Rignano sull'Arno,FI,56,9,57,5,1,72,12,43,5,2,62
2020,48036,Rignano sull'Arno,FI,57,5,60,7,0,72,5,56,3,2,66
2020,48036,Rignano sull'Arno,FI,58,10,36,10,0,56,8,44,5,7,64
2020,48036,Rignano sull'Arno,FI,59,8,43,1,0,52,5,51,5,0,61
2020,48036,Rignano sull'Arno,FI,60,9,59,1,0,69,8,42,5,6,61
2020,48036,Rignano sull'Arno,FI,61,9,51,5,1,66,9,53,3,4,69
2020,48036,Rignano sull'Arno,FI,62,6,41,6,4,57,7,44,1,3,55
2020,48036,Rignano sull'Arno,FI,63,4,33,2,0,39,3,49,3,8,63
2020,48036,Rignano sull'Arno,FI,64,4,45,3,1,53,5,43,1,2,51
2020,48036,Rignano sull'Arno,FI,65,2,40,4,1,47,7,44,3,1,55
2020,48036,Rignano sull'Arno,FI,66,0,54,4,1,59,6,56,2,5,69
2020,48036,Rignano sull'Arno,FI,67,7,46,1,2,56,4,44,3,8,59
2020,48036,Rignano sull'Arno,FI,68,5,46,4,0,55,5,42,2,4,53
2020,48036,Rignano sull'Arno,FI,69,3,45,5,2,55,2,32,3,10,47
2020,48036,Rignano sull'Arno,FI,70,2,39,1,2,44,5,40,1,12,58
2020,48036,Rignano sull'Arno,FI,71,4,44,2,2,52,4,39,0,9,52
2020,48036,Rignano sull'Arno,FI,72,3,48,2,3,56,2,50,3,6,61
2020,48036,Rignano sull'Arno,FI,73,6,42,0,10,58,0,29,2,13,44
2020,48036,Rignano sull'Arno,FI,74,0,52,0,7,59,3,44,2,10,59
2020,48036,Rignano sull'Arno,FI,75,1,29,6,7,43,4,27,0,9,40
2020,48036,Rignano sull'Arno,FI,76,4,41,0,5,50,2,20,2,8,32
2020,48036,Rignano sull'Arno,FI,77,2,30,0,7,39,3,31,0,11,45
2020,48036,Rignano sull'Arno,FI,78,3,22,4,3,32,0,25,2,14,41
2020,48036,Rignano sull'Arno,FI,79,1,28,1,1,31,3,23,1,14,41
2020,48036,Rignano sull'Arno,FI,80,0,26,1,4,31,0,19,0,19,38
2020,48036,Rignano sull'Arno,FI,81,1,24,0,4,29,2,17,1,21,41
2020,48036,Rignano sull'Arno,FI,82,0,19,0,6,25,3,18,0,19,40
2020,48036,Rignano sull'Arno,FI,83,2,20,0,3,25,7,10,0,19,36
2020,48036,Rignano sull'Arno,FI,84,1,13,0,3,17,1,6,1,12,20
2020,48036,Rignano sull'Arno,FI,85,1,18,2,1,22,1,6,0,13,20
2020,48036,Rignano sull'Arno,FI,86,0,18,0,1,19,4,10,0,19,33
2020,48036,Rignano sull'Arno,FI,87,2,8,1,9,20,2,4,0,18,24
2020,48036,Rignano sull'Arno,FI,88,0,7,0,3,10,1,4,0,18,23
2020,48036,Rignano sull'Arno,FI,89,0,12,0,5,17,0,3,0,8,11
2020,48036,Rignano sull'Arno,FI,90,0,4,0,3,7,1,4,0,19,24
2020,48036,Rignano sull'Arno,FI,91,0,5,0,4,9,0,0,0,10,10
2020,48036,Rignano sull'Arno,FI,92,0,5,0,5,10,2,1,0,11,14
2020,48036,Rignano sull'Arno,FI,93,0,1,0,0,1,0,1,0,6,7
2020,48036,Rignano sull'Arno,FI,94,0,1,0,4,5,0,0,0,10,10
2020,48036,Rignano sull'Arno,FI,95,0,0,0,1,1,1,0,0,3,4
2020,48036,Rignano sull'Arno,FI,96,0,0,0,1,1,3,0,0,3,6
2020,48036,Rignano sull'Arno,FI,97,0,1,0,1,2,0,0,0,0,0
2020,48036,Rignano sull'Arno,FI,98,0,0,0,0,0,0,0,0,0,0
2020,48036,Rignano sull'Arno,FI,99,0,0,0,1,1,0,0,0,0,0
2020,48036,Rignano sull'Arno,FI,100 e più,0,0,0,0,0,0,0,0,1,1
2020,48037,Rufina,FI,0,22,0,0,0,22,25,0,0,0,25
2020,48037,Rufina,FI,1,16,0,0,0,16,17,0,0,0,17
2020,48037,Rufina,FI,2,21,0,0,0,21,19,0,0,0,19
2020,48037,Rufina,FI,3,28,0,0,0,28,14,0,0,0,14
2020,48037,Rufina,FI,4,28,0,0,0,28,16,0,0,0,16
2020,48037,Rufina,FI,5,20,0,0,0,20,21,0,0,0,21
2020,48037,Rufina,FI,6,22,0,0,0,22,17,0,0,0,17
2020,48037,Rufina,FI,7,20,0,0,0,20,29,0,0,0,29
2020,48037,Rufina,FI,8,36,0,0,0,36,29,0,0,0,29
2020,48037,Rufina,FI,9,32,0,0,0,32,32,0,0,0,32
2020,48037,Rufina,FI,10,34,0,0,0,34,27,0,0,0,27
2020,48037,Rufina,FI,11,35,0,0,0,35,32,0,0,0,32
2020,48037,Rufina,FI,12,31,0,0,0,31,39,0,0,0,39
2020,48037,Rufina,FI,13,45,0,0,0,45,33,0,0,0,33
2020,48037,Rufina,FI,14,32,0,0,0,32,38,0,0,0,38
2020,48037,Rufina,FI,15,37,0,0,0,37,35,0,0,0,35
2020,48037,Rufina,FI,16,36,0,0,0,36,32,0,0,0,32
2020,48037,Rufina,FI,17,33,0,0,0,33,25,0,0,0,25
2020,48037,Rufina,FI,18,22,0,0,0,22,33,0,0,0,33
2020,48037,Rufina,FI,19,31,0,0,0,31,36,0,0,0,36
2020,48037,Rufina,FI,20,38,0,0,0,38,44,1,0,0,45
2020,48037,Rufina,FI,21,35,1,0,0,36,30,0,0,0,30
2020,48037,Rufina,FI,22,36,0,0,0,36,30,0,0,0,30
2020,48037,Rufina,FI,23,38,0,0,0,38,33,0,0,0,33
2020,48037,Rufina,FI,24,37,1,0,0,38,25,1,0,0,26
2020,48037,Rufina,FI,25,23,0,0,0,23,30,1,0,0,31
2020,48037,Rufina,FI,26,33,0,0,0,33,23,3,0,0,26
2020,48037,Rufina,FI,27,32,0,0,0,32,31,6,0,0,37
2020,48037,Rufina,FI,28,23,3,0,0,26,27,8,0,0,35
2020,48037,Rufina,FI,29,27,3,0,0,30,31,6,0,0,37
2020,48037,Rufina,FI,30,34,4,0,0,38,18,8,1,0,27
2020,48037,Rufina,FI,31,19,6,0,0,25,24,8,1,0,33
2020,48037,Rufina,FI,32,42,7,0,0,49,24,15,0,0,39
2020,48037,Rufina,FI,33,30,13,0,0,43,24,14,0,0,38
2020,48037,Rufina,FI,34,23,10,0,0,33,16,14,0,0,30
2020,48037,Rufina,FI,35,28,8,0,0,36,20,11,1,0,32
2020,48037,Rufina,FI,36,24,7,0,0,31,15,14,2,0,31
2020,48037,Rufina,FI,37,38,15,1,0,54,17,13,2,0,32
2020,48037,Rufina,FI,38,15,12,2,0,29,15,21,0,0,36
2020,48037,Rufina,FI,39,23,20,0,0,43,5,29,0,1,35
2020,48037,Rufina,FI,40,21,15,3,1,40,13,14,3,0,30
2020,48037,Rufina,FI,41,19,17,1,0,37,19,22,2,0,43
2020,48037,Rufina,FI,42,19,25,0,0,44,13,17,0,0,30
2020,48037,Rufina,FI,43,28,18,1,0,47,20,29,4,0,53
2020,48037,Rufina,FI,44,25,21,2,0,48,17,25,0,0,42
2020,48037,Rufina,FI,45,20,27,1,0,48,20,44,5,0,69
2020,48037,Rufina,FI,46,25,34,0,0,59,18,37,5,1,61
2020,48037,Rufina,FI,47,15,33,3,0,51,14,30,6,0,50
2020,48037,Rufina,FI,48,32,39,4,0,75,12,45,6,1,64
2020,48037,Rufina,FI,49,26,31,4,1,62,20,41,3,1,65
2020,48037,Rufina,FI,50,17,33,2,1,53,9,48,4,2,63
2020,48037,Rufina,FI,51,16,48,5,0,69,18,51,4,1,74
2020,48037,Rufina,FI,52,18,53,6,0,77,8,54,8,5,75
2020,48037,Rufina,FI,53,18,38,4,1,61,16,49,7,1,73
2020,48037,Rufina,FI,54,14,37,4,1,56,12,43,10,2,67
2020,48037,Rufina,FI,55,11,54,4,0,69,6,51,5,2,64
2020,48037,Rufina,FI,56,16,45,1,1,63,11,40,2,4,57
2020,48037,Rufina,FI,57,12,40,2,3,57,5,37,5,3,50
2020,48037,Rufina,FI,58,5,46,2,1,54,4,37,5,4,50
2020,48037,Rufina,FI,59,8,31,7,1,47,3,46,6,7,62
2020,48037,Rufina,FI,60,3,43,5,0,51,3,50,8,4,65
2020,48037,Rufina,FI,61,8,40,6,0,54,5,39,4,4,52
2020,48037,Rufina,FI,62,9,37,2,0,48,5,37,2,4,48
2020,48037,Rufina,FI,63,4,50,4,1,59,4,40,3,4,51
2020,48037,Rufina,FI,64,5,35,3,4,47,1,34,2,0,37
2020,48037,Rufina,FI,65,7,39,1,1,48,1,38,6,4,49
2020,48037,Rufina,FI,66,3,43,1,1,48,1,46,0,4,51
2020,48037,Rufina,FI,67,4,33,3,2,42,2,21,3,10,36
2020,48037,Rufina,FI,68,5,31,6,2,44,2,36,5,5,48
2020,48037,Rufina,FI,69,2,35,4,3,44,3,35,4,3,45
2020,48037,Rufina,FI,70,5,36,3,3,47,1,28,5,12,46
2020,48037,Rufina,FI,71,2,44,0,6,52,1,38,2,11,52
2020,48037,Rufina,FI,72,3,49,1,3,56,6,39,1,17,63
2020,48037,Rufina,FI,73,1,43,5,0,49,1,46,2,13,62
2020,48037,Rufina,FI,74,3,47,1,1,52,2,34,2,11,49
2020,48037,Rufina,FI,75,5,21,0,4,30,1,30,0,8,39
2020,48037,Rufina,FI,76,0,30,2,4,36,1,14,1,11,27
2020,48037,Rufina,FI,77,0,22,1,4,27,1,24,3,13,41
2020,48037,Rufina,FI,78,1,23,0,3,27,1,19,0,18,38
2020,48037,Rufina,FI,79,0,18,1,3,22,2,10,0,20,32
2020,48037,Rufina,FI,80,1,30,2,8,41,0,22,0,18,40
2020,48037,Rufina,FI,81,0,22,1,5,28,1,16,0,17,34
2020,48037,Rufina,FI,82,4,19,0,5,28,1,7,0,21,29
2020,48037,Rufina,FI,83,2,19,1,1,23,1,19,0,17,37
2020,48037,Rufina,FI,84,2,11,0,3,16,0,9,0,20,29
2020,48037,Rufina,FI,85,0,11,0,1,12,1,5,0,14,20
2020,48037,Rufina,FI,86,1,9,0,3,13,0,5,0,19,24
2020,48037,Rufina,FI,87,0,6,0,3,9,0,6,1,13,20
2020,48037,Rufina,FI,88,3,11,0,3,17,0,1,0,14,15
2020,48037,Rufina,FI,89,2,7,0,1,10,0,1,0,18,19
2020,48037,Rufina,FI,90,0,12,0,3,15,0,3,0,11,14
2020,48037,Rufina,FI,91,0,3,0,4,7,0,1,0,14,15
2020,48037,Rufina,FI,92,2,4,0,5,11,1,3,0,9,13
2020,48037,Rufina,FI,93,0,3,0,1,4,0,0,0,7,7
2020,48037,Rufina,FI,94,1,3,0,4,8,0,1,0,6,7
2020,48037,Rufina,FI,95,0,0,0,0,0,0,0,0,4,4
2020,48037,Rufina,FI,96,0,0,0,1,1,0,0,0,1,1
2020,48037,Rufina,FI,97,0,1,0,0,1,0,0,0,4,4
2020,48037,Rufina,FI,98,0,0,0,0,0,0,0,1,2,3
2020,48037,Rufina,FI,99,0,1,0,0,1,0,0,0,2,2
2020,48037,Rufina,FI,100 e più,0,0,0,1,1,0,0,0,5,5
2020,48038,San Casciano in Val di Pesa,FI,0,50,0,0,0,50,49,0,0,0,49
2020,48038,San Casciano in Val di Pesa,FI,1,68,0,0,0,68,46,0,0,0,46
2020,48038,San Casciano in Val di Pesa,FI,2,50,0,0,0,50,42,0,0,0,42
2020,48038,San Casciano in Val di Pesa,FI,3,61,0,0,0,61,62,0,0,0,62
2020,48038,San Casciano in Val di Pesa,FI,4,61,0,0,0,61,66,0,0,0,66
2020,48038,San Casciano in Val di Pesa,FI,5,70,0,0,0,70,64,0,0,0,64
2020,48038,San Casciano in Val di Pesa,FI,6,67,0,0,0,67,59,0,0,0,59
2020,48038,San Casciano in Val di Pesa,FI,7,66,0,0,0,66,71,0,0,0,71
2020,48038,San Casciano in Val di Pesa,FI,8,54,0,0,0,54,72,0,0,0,72
2020,48038,San Casciano in Val di Pesa,FI,9,64,0,0,0,64,73,0,0,0,73
2020,48038,San Casciano in Val di Pesa,FI,10,70,0,0,0,70,69,0,0,0,69
2020,48038,San Casciano in Val di Pesa,FI,11,72,0,0,0,72,97,0,0,0,97
2020,48038,San Casciano in Val di Pesa,FI,12,98,0,0,0,98,79,0,0,0,79
2020,48038,San Casciano in Val di Pesa,FI,13,60,0,0,0,60,78,0,0,0,78
2020,48038,San Casciano in Val di Pesa,FI,14,77,0,0,0,77,88,0,0,0,88
2020,48038,San Casciano in Val di Pesa,FI,15,94,0,0,0,94,56,0,0,0,56
2020,48038,San Casciano in Val di Pesa,FI,16,96,0,0,0,96,77,0,0,0,77
2020,48038,San Casciano in Val di Pesa,FI,17,84,0,0,0,84,79,0,0,0,79
2020,48038,San Casciano in Val di Pesa,FI,18,91,0,0,0,91,92,0,0,0,92
2020,48038,San Casciano in Val di Pesa,FI,19,74,0,0,0,74,87,0,0,0,87
2020,48038,San Casciano in Val di Pesa,FI,20,77,0,0,0,77,76,0,0,0,76
2020,48038,San Casciano in Val di Pesa,FI,21,84,1,0,0,85,60,0,0,0,60
2020,48038,San Casciano in Val di Pesa,FI,22,96,0,0,0,96,67,3,0,0,70
2020,48038,San Casciano in Val di Pesa,FI,23,85,1,0,0,86,80,2,0,0,82
2020,48038,San Casciano in Val di Pesa,FI,24,61,0,0,0,61,65,3,0,0,68
2020,48038,San Casciano in Val di Pesa,FI,25,64,2,0,0,66,65,6,0,0,71
2020,48038,San Casciano in Val di Pesa,FI,26,73,2,0,0,75,70,6,0,0,76
2020,48038,San Casciano in Val di Pesa,FI,27,79,4,0,0,83,54,9,1,0,64
2020,48038,San Casciano in Val di Pesa,FI,28,64,4,0,0,68,79,7,0,0,86
2020,48038,San Casciano in Val di Pesa,FI,29,59,5,0,0,64,59,9,0,0,68
2020,48038,San Casciano in Val di Pesa,FI,30,56,3,1,0,60,66,12,0,0,78
2020,48038,San Casciano in Val di Pesa,FI,31,72,13,0,0,85,47,25,1,1,74
2020,48038,San Casciano in Val di Pesa,FI,32,66,13,0,0,79,62,25,2,0,89
2020,48038,San Casciano in Val di Pesa,FI,33,54,16,0,0,70,59,28,0,0,87
2020,48038,San Casciano in Val di Pesa,FI,34,69,12,0,0,81,50,25,0,1,76
2020,48038,San Casciano in Val di Pesa,FI,35,53,14,1,0,68,41,31,3,0,75
2020,48038,San Casciano in Val di Pesa,FI,36,47,20,0,0,67,51,21,1,0,73
2020,48038,San Casciano in Val di Pesa,FI,37,37,24,3,0,64,48,26,0,0,74
2020,48038,San Casciano in Val di Pesa,FI,38,54,27,0,0,81,42,29,5,0,76
2020,48038,San Casciano in Val di Pesa,FI,39,56,34,1,0,91,34,43,3,1,81
2020,48038,San Casciano in Val di Pesa,FI,40,48,42,7,0,97,32,45,2,1,80
2020,48038,San Casciano in Val di Pesa,FI,41,49,44,1,0,94,57,50,3,0,110
2020,48038,San Casciano in Val di Pesa,FI,42,46,38,3,0,87,33,59,6,3,101
2020,48038,San Casciano in Val di Pesa,FI,43,38,62,5,0,105,47,69,5,1,122
2020,48038,San Casciano in Val di Pesa,FI,44,53,48,2,1,104,38,78,3,1,120
2020,48038,San Casciano in Val di Pesa,FI,45,67,52,5,0,124,38,66,6,0,110
2020,48038,San Casciano in Val di Pesa,FI,46,56,74,4,0,134,43,86,7,1,137
2020,48038,San Casciano in Val di Pesa,FI,47,53,76,7,0,136,37,78,11,0,126
2020,48038,San Casciano in Val di Pesa,FI,48,44,76,5,0,125,35,90,17,1,143
2020,48038,San Casciano in Val di Pesa,FI,49,45,86,7,1,139,39,87,12,0,138
2020,48038,San Casciano in Val di Pesa,FI,50,40,83,6,0,129,32,77,11,0,120
2020,48038,San Casciano in Val di Pesa,FI,51,41,82,5,0,128,24,107,6,1,138
2020,48038,San Casciano in Val di Pesa,FI,52,33,84,4,0,121,29,98,13,2,142
2020,48038,San Casciano in Val di Pesa,FI,53,31,93,12,0,136,29,106,19,2,156
2020,48038,San Casciano in Val di Pesa,FI,54,35,104,5,2,146,33,95,8,1,137
2020,48038,San Casciano in Val di Pesa,FI,55,33,91,6,0,130,28,100,13,3,144
2020,48038,San Casciano in Val di Pesa,FI,56,33,111,10,2,156,20,101,5,7,133
2020,48038,San Casciano in Val di Pesa,FI,57,25,112,10,1,148,19,85,12,6,122
2020,48038,San Casciano in Val di Pesa,FI,58,11,107,13,1,132,23,99,20,2,144
2020,48038,San Casciano in Val di Pesa,FI,59,25,80,10,1,116,19,86,10,8,123
2020,48038,San Casciano in Val di Pesa,FI,60,18,89,8,0,115,12,100,12,6,130
2020,48038,San Casciano in Val di Pesa,FI,61,12,103,7,1,123,16,94,9,9,128
2020,48038,San Casciano in Val di Pesa,FI,62,11,90,10,2,113,15,110,14,8,147
2020,48038,San Casciano in Val di Pesa,FI,63,15,87,9,5,116,13,73,11,2,99
2020,48038,San Casciano in Val di Pesa,FI,64,17,94,7,1,119,17,98,9,8,132
2020,48038,San Casciano in Val di Pesa,FI,65,12,86,7,2,107,10,99,5,11,125
2020,48038,San Casciano in Val di Pesa,FI,66,15,92,9,5,121,11,76,11,16,114
2020,48038,San Casciano in Val di Pesa,FI,67,13,82,8,3,106,13,69,7,13,102
2020,48038,San Casciano in Val di Pesa,FI,68,13,93,5,1,112,10,76,7,14,107
2020,48038,San Casciano in Val di Pesa,FI,69,13,70,5,4,92,9,75,3,16,103
2020,48038,San Casciano in Val di Pesa,FI,70,10,80,7,3,100,6,81,5,12,104
2020,48038,San Casciano in Val di Pesa,FI,71,11,85,4,6,106,8,89,3,34,134
2020,48038,San Casciano in Val di Pesa,FI,72,6,71,6,8,91,11,85,4,23,123
2020,48038,San Casciano in Val di Pesa,FI,73,12,107,1,6,126,10,88,6,25,129
2020,48038,San Casciano in Val di Pesa,FI,74,9,79,1,7,96,4,68,6,35,113
2020,48038,San Casciano in Val di Pesa,FI,75,5,70,3,6,84,5,50,4,15,74
2020,48038,San Casciano in Val di Pesa,FI,76,4,64,1,9,78,5,51,1,17,74
2020,48038,San Casciano in Val di Pesa,FI,77,5,53,0,5,63,3,58,4,23,88
2020,48038,San Casciano in Val di Pesa,FI,78,3,54,0,9,66,8,41,1,25,75
2020,48038,San Casciano in Val di Pesa,FI,79,2,51,3,8,64,5,51,2,32,90
2020,48038,San Casciano in Val di Pesa,FI,80,7,66,2,15,90,9,51,2,32,94
2020,48038,San Casciano in Val di Pesa,FI,81,7,62,2,8,79,4,46,1,54,105
2020,48038,San Casciano in Val di Pesa,FI,82,5,62,0,15,82,4,45,1,55,105
2020,48038,San Casciano in Val di Pesa,FI,83,6,54,0,9,69,6,29,1,42,78
2020,48038,San Casciano in Val di Pesa,FI,84,1,39,1,7,48,7,17,0,44,68
2020,48038,San Casciano in Val di Pesa,FI,85,4,33,0,8,45,2,19,2,50,73
2020,48038,San Casciano in Val di Pesa,FI,86,3,29,0,4,36,4,12,0,43,59
2020,48038,San Casciano in Val di Pesa,FI,87,5,30,0,6,41,1,16,0,54,71
2020,48038,San Casciano in Val di Pesa,FI,88,3,13,0,9,25,2,7,0,46,55
2020,48038,San Casciano in Val di Pesa,FI,89,3,20,0,10,33,1,8,1,44,54
2020,48038,San Casciano in Val di Pesa,FI,90,4,8,0,11,23,3,4,0,46,53
2020,48038,San Casciano in Val di Pesa,FI,91,1,7,1,8,17,2,3,0,36,41
2020,48038,San Casciano in Val di Pesa,FI,92,1,13,0,4,18,3,3,1,21,28
2020,48038,San Casciano in Val di Pesa,FI,93,1,5,0,9,15,2,0,0,26,28
2020,48038,San Casciano in Val di Pesa,FI,94,0,4,0,3,7,2,0,0,17,19
2020,48038,San Casciano in Val di Pesa,FI,95,0,2,0,5,7,1,0,0,15,16
2020,48038,San Casciano in Val di Pesa,FI,96,0,0,0,2,2,2,0,0,12,14
2020,48038,San Casciano in Val di Pesa,FI,97,0,0,0,0,0,0,0,0,8,8
2020,48038,San Casciano in Val di Pesa,FI,98,0,1,0,1,2,0,0,0,5,5
2020,48038,San Casciano in Val di Pesa,FI,99,0,0,0,0,0,1,0,0,4,5
2020,48038,San Casciano in Val di Pesa,FI,100 e più,1,0,0,0,1,2,0,0,3,5
2020,48039,San Godenzo,FI,0,1,0,0,0,1,0,0,0,0,0
2020,48039,San Godenzo,FI,1,5,0,0,0,5,5,0,0,0,5
2020,48039,San Godenzo,FI,2,0,0,0,0,0,3,0,0,0,3
2020,48039,San Godenzo,FI,3,5,0,0,0,5,3,0,0,0,3
2020,48039,San Godenzo,FI,4,5,0,0,0,5,3,0,0,0,3
2020,48039,San Godenzo,FI,5,2,0,0,0,2,3,0,0,0,3
2020,48039,San Godenzo,FI,6,3,0,0,0,3,3,0,0,0,3
2020,48039,San Godenzo,FI,7,6,0,0,0,6,6,0,0,0,6
2020,48039,San Godenzo,FI,8,6,0,0,0,6,1,0,0,0,1
2020,48039,San Godenzo,FI,9,7,0,0,0,7,2,0,0,0,2
2020,48039,San Godenzo,FI,10,3,0,0,0,3,5,0,0,0,5
2020,48039,San Godenzo,FI,11,4,0,0,0,4,5,0,0,0,5
2020,48039,San Godenzo,FI,12,3,0,0,0,3,6,0,0,0,6
2020,48039,San Godenzo,FI,13,0,0,0,0,0,8,0,0,0,8
2020,48039,San Godenzo,FI,14,3,0,0,0,3,1,0,0,0,1
2020,48039,San Godenzo,FI,15,2,0,0,0,2,5,0,0,0,5
2020,48039,San Godenzo,FI,16,8,0,0,0,8,2,0,0,0,2
2020,48039,San Godenzo,FI,17,7,0,0,0,7,1,0,0,0,1
2020,48039,San Godenzo,FI,18,2,0,0,0,2,5,0,0,0,5
2020,48039,San Godenzo,FI,19,1,0,0,0,1,1,0,0,0,1
2020,48039,San Godenzo,FI,20,6,0,0,0,6,7,0,0,0,7
2020,48039,San Godenzo,FI,21,5,0,0,0,5,4,0,0,0,4
2020,48039,San Godenzo,FI,22,10,0,0,0,10,1,0,0,0,1
2020,48039,San Godenzo,FI,23,10,0,0,0,10,3,0,0,0,3
2020,48039,San Godenzo,FI,24,8,0,0,0,8,5,0,0,0,5
2020,48039,San Godenzo,FI,25,7,0,0,0,7,6,0,0,0,6
2020,48039,San Godenzo,FI,26,8,0,0,0,8,2,0,0,0,2
2020,48039,San Godenzo,FI,27,7,0,0,0,7,5,1,0,0,6
2020,48039,San Godenzo,FI,28,8,0,0,0,8,2,0,0,0,2
2020,48039,San Godenzo,FI,29,6,1,0,0,7,3,1,0,0,4
2020,48039,San Godenzo,FI,30,4,0,0,0,4,3,2,0,0,5
2020,48039,San Godenzo,FI,31,3,0,0,0,3,2,0,0,0,2
2020,48039,San Godenzo,FI,32,4,0,0,0,4,3,0,0,0,3
2020,48039,San Godenzo,FI,33,2,1,0,0,3,1,2,0,0,3
2020,48039,San Godenzo,FI,34,1,0,0,0,1,1,1,0,0,2
2020,48039,San Godenzo,FI,35,6,0,0,0,6,3,1,0,0,4
2020,48039,San Godenzo,FI,36,2,1,0,0,3,2,1,1,0,4
2020,48039,San Godenzo,FI,37,5,3,0,0,8,2,4,0,0,6
2020,48039,San Godenzo,FI,38,2,1,2,0,5,2,4,0,0,6
2020,48039,San Godenzo,FI,39,4,3,0,0,7,2,3,1,0,6
2020,48039,San Godenzo,FI,40,7,1,0,0,8,1,2,0,0,3
2020,48039,San Godenzo,FI,41,2,1,1,0,4,0,1,0,0,1
2020,48039,San Godenzo,FI,42,2,3,0,0,5,3,5,0,0,8
2020,48039,San Godenzo,FI,43,2,3,0,0,5,1,4,0,0,5
2020,48039,San Godenzo,FI,44,5,3,0,0,8,5,3,0,0,8
2020,48039,San Godenzo,FI,45,5,3,1,0,9,2,4,0,0,6
2020,48039,San Godenzo,FI,46,1,1,0,0,2,1,4,0,0,5
2020,48039,San Godenzo,FI,47,2,7,0,0,9,3,6,0,0,9
2020,48039,San Godenzo,FI,48,1,0,0,0,1,0,8,1,0,9
2020,48039,San Godenzo,FI,49,5,5,1,0,11,1,3,0,0,4
2020,48039,San Godenzo,FI,50,2,3,0,0,5,5,6,0,1,12
2020,48039,San Godenzo,FI,51,4,4,0,0,8,4,5,2,0,11
2020,48039,San Godenzo,FI,52,3,8,1,0,12,0,7,0,0,7
2020,48039,San Godenzo,FI,53,3,9,1,0,13,1,9,0,0,10
2020,48039,San Godenzo,FI,54,4,8,0,0,12,1,8,1,0,10
2020,48039,San Godenzo,FI,55,3,5,0,0,8,1,7,2,1,11
2020,48039,San Godenzo,FI,56,2,7,2,0,11,0,5,2,0,7
2020,48039,San Godenzo,FI,57,2,10,0,0,12,3,9,0,1,13
2020,48039,San Godenzo,FI,58,1,13,1,1,16,0,7,1,2,10
2020,48039,San Godenzo,FI,59,3,8,1,0,12,2,10,0,1,13
2020,48039,San Godenzo,FI,60,1,10,0,0,11,0,7,0,0,7
2020,48039,San Godenzo,FI,61,0,7,1,0,8,2,10,0,0,12
2020,48039,San Godenzo,FI,62,0,2,0,0,2,0,4,0,0,4
2020,48039,San Godenzo,FI,63,1,9,0,0,10,1,3,0,1,5
2020,48039,San Godenzo,FI,64,2,3,0,0,5,4,3,2,2,11
2020,48039,San Godenzo,FI,65,3,5,1,0,9,1,5,2,0,8
2020,48039,San Godenzo,FI,66,3,6,1,0,10,1,10,1,2,14
2020,48039,San Godenzo,FI,67,0,6,0,0,6,0,6,1,0,7
2020,48039,San Godenzo,FI,68,0,7,0,0,7,0,10,2,4,16
2020,48039,San Godenzo,FI,69,1,4,1,0,6,1,5,0,2,8
2020,48039,San Godenzo,FI,70,0,14,2,0,16,1,5,0,0,6
2020,48039,San Godenzo,FI,71,0,7,0,0,7,1,4,1,2,8
2020,48039,San Godenzo,FI,72,2,5,0,0,7,0,8,1,1,10
2020,48039,San Godenzo,FI,73,0,8,2,0,10,1,1,0,6,8
2020,48039,San Godenzo,FI,74,0,4,0,0,4,0,2,0,4,6
2020,48039,San Godenzo,FI,75,0,4,0,0,4,1,3,0,3,7
2020,48039,San Godenzo,FI,76,0,3,0,0,3,1,2,0,1,4
2020,48039,San Godenzo,FI,77,0,1,0,1,2,0,0,1,2,3
2020,48039,San Godenzo,FI,78,2,3,0,0,5,0,3,0,4,7
2020,48039,San Godenzo,FI,79,0,3,1,0,4,0,2,0,1,3
2020,48039,San Godenzo,FI,80,0,2,0,1,3,1,3,0,4,8
2020,48039,San Godenzo,FI,81,0,4,0,2,6,0,1,0,4,5
2020,48039,San Godenzo,FI,82,0,1,0,0,1,0,1,0,5,6
2020,48039,San Godenzo,FI,83,0,2,0,3,5,0,2,0,4,6
2020,48039,San Godenzo,FI,84,1,3,0,0,4,0,1,0,4,5
2020,48039,San Godenzo,FI,85,1,1,0,1,3,1,2,0,2,5
2020,48039,San Godenzo,FI,86,0,0,0,0,0,0,2,0,2,4
2020,48039,San Godenzo,FI,87,0,2,0,0,2,0,0,0,4,4
2020,48039,San Godenzo,FI,88,0,1,0,0,1,1,0,0,3,4
2020,48039,San Godenzo,FI,89,0,1,0,1,2,0,0,0,3,3
2020,48039,San Godenzo,FI,90,0,1,0,1,2,0,0,0,7,7
2020,48039,San Godenzo,FI,91,0,0,0,0,0,0,1,0,3,4
2020,48039,San Godenzo,FI,92,0,1,0,0,1,0,0,0,2,2
2020,48039,San Godenzo,FI,93,0,1,0,0,1,0,0,0,3,3
2020,48039,San Godenzo,FI,94,0,0,0,0,0,0,0,0,1,1
2020,48039,San Godenzo,FI,95,1,0,0,0,1,0,0,0,1,1
2020,48039,San Godenzo,FI,96,0,0,0,0,0,0,0,0,0,0
2020,48039,San Godenzo,FI,97,0,0,0,0,0,0,0,0,1,1
2020,48039,San Godenzo,FI,98,0,0,0,0,0,0,0,0,0,0
2020,48039,San Godenzo,FI,99,0,0,0,1,1,0,0,0,0,0
2020,48039,San Godenzo,FI,100 e più,0,0,0,0,0,0,0,0,0,0
2020,48041,Scandicci,FI,0,132,0,0,0,132,150,0,0,0,150
2020,48041,Scandicci,FI,1,176,0,0,0,176,153,0,0,0,153
2020,48041,Scandicci,FI,2,169,0,0,0,169,187,0,0,0,187
2020,48041,Scandicci,FI,3,183,0,0,0,183,171,0,0,0,171
2020,48041,Scandicci,FI,4,168,0,0,0,168,203,0,0,0,203
2020,48041,Scandicci,FI,5,216,0,0,0,216,195,0,0,0,195
2020,48041,Scandicci,FI,6,186,0,0,0,186,185,0,0,0,185
2020,48041,Scandicci,FI,7,200,0,0,0,200,179,0,0,0,179
2020,48041,Scandicci,FI,8,215,0,0,0,215,221,0,0,0,221
2020,48041,Scandicci,FI,9,236,0,0,0,236,210,0,0,0,210
2020,48041,Scandicci,FI,10,239,0,0,0,239,216,0,0,0,216
2020,48041,Scandicci,FI,11,237,0,0,0,237,201,0,0,0,201
2020,48041,Scandicci,FI,12,233,0,0,0,233,213,0,0,0,213
2020,48041,Scandicci,FI,13,226,0,0,0,226,234,0,0,0,234
2020,48041,Scandicci,FI,14,261,0,0,0,261,229,0,0,0,229
2020,48041,Scandicci,FI,15,232,0,0,0,232,237,0,0,0,237
2020,48041,Scandicci,FI,16,258,0,0,0,258,217,0,0,0,217
2020,48041,Scandicci,FI,17,240,0,0,0,240,243,0,0,0,243
2020,48041,Scandicci,FI,18,235,0,0,0,235,235,0,0,0,235
2020,48041,Scandicci,FI,19,271,0,0,0,271,260,0,0,0,260
2020,48041,Scandicci,FI,20,262,0,0,0,262,194,2,0,0,196
2020,48041,Scandicci,FI,21,246,0,0,0,246,228,2,0,0,230
2020,48041,Scandicci,FI,22,264,0,0,0,264,209,6,0,0,215
2020,48041,Scandicci,FI,23,295,0,0,0,295,218,7,0,0,225
2020,48041,Scandicci,FI,24,247,7,0,0,254,212,7,0,0,219
2020,48041,Scandicci,FI,25,227,5,0,0,232,202,14,0,0,216
2020,48041,Scandicci,FI,26,215,13,0,0,228,202,17,0,0,219
2020,48041,Scandicci,FI,27,219,9,0,0,228,205,23,1,0,230
2020,48041,Scandicci,FI,28,229,20,0,0,249,183,37,0,0,220
2020,48041,Scandicci,FI,29,221,22,0,0,243,184,49,1,0,234
2020,48041,Scandicci,FI,30,208,26,1,0,235,168,60,1,0,229
2020,48041,Scandicci,FI,31,224,36,0,0,261,169,73,1,0,243
2020,48041,Scandicci,FI,32,196,60,0,1,257,174,88,2,1,265
2020,48041,Scandicci,FI,33,192,69,3,0,264,126,102,4,2,234
2020,48041,Scandicci,FI,34,152,79,1,0,232,167,114,3,0,285
2020,48041,Scandicci,FI,35,147,86,1,0,235,136,137,7,0,280
2020,48041,Scandicci,FI,36,142,106,2,0,250,106,134,5,0,245
2020,48041,Scandicci,FI,37,123,108,3,0,235,117,143,10,0,270
2020,48041,Scandicci,FI,38,128,141,4,0,273,119,148,9,0,276
2020,48041,Scandicci,FI,39,130,162,3,0,295,84,161,10,2,257
2020,48041,Scandicci,FI,40,125,132,6,0,264,112,193,10,2,317
2020,48041,Scandicci,FI,41,148,152,10,1,311,114,165,9,2,291
2020,48041,Scandicci,FI,42,141,172,13,1,327,125,171,9,2,307
2020,48041,Scandicci,FI,43,126,179,6,1,312,102,194,20,2,319
2020,48041,Scandicci,FI,44,145,178,9,0,332,123,208,20,3,354
2020,48041,Scandicci,FI,45,143,195,14,0,353,109,254,23,1,387
2020,48041,Scandicci,FI,46,146,216,21,0,384,95,250,35,5,385
2020,48041,Scandicci,FI,47,129,226,15,1,372,115,249,31,5,400
2020,48041,Scandicci,FI,48,135,242,12,1,391,105,292,30,4,432
2020,48041,Scandicci,FI,49,141,251,21,2,415,94,278,34,8,414
2020,48041,Scandicci,FI,50,115,266,28,1,410,95,317,32,5,449
2020,48041,Scandicci,FI,51,107,282,27,1,418,91,298,44,6,439
2020,48041,Scandicci,FI,52,88,289,24,0,402,87,270,43,6,406
2020,48041,Scandicci,FI,53,108,289,27,1,425,78,315,40,10,443
2020,48041,Scandicci,FI,54,116,283,34,2,436,65,313,38,4,420
2020,48041,Scandicci,FI,55,103,279,25,3,410,65,316,40,7,428
2020,48041,Scandicci,FI,56,76,306,32,1,416,61,313,31,13,418
2020,48041,Scandicci,FI,57,76,262,27,6,371,56,275,46,15,392
2020,48041,Scandicci,FI,58,53,281,26,3,363,41,291,39,12,383
2020,48041,Scandicci,FI,59,51,248,21,9,329,31,290,29,7,357
2020,48041,Scandicci,FI,60,47,254,26,3,330,39,254,28,16,337
2020,48041,Scandicci,FI,61,38,232,17,6,293,28,272,27,20,347
2020,48041,Scandicci,FI,62,29,229,17,10,286,36,218,16,17,287
2020,48041,Scandicci,FI,63,24,252,16,10,302,31,243,36,22,332
2020,48041,Scandicci,FI,64,27,189,16,11,245,27,213,26,20,286
2020,48041,Scandicci,FI,65,21,201,16,9,247,23,211,34,43,311
2020,48041,Scandicci,FI,66,22,179,7,11,219,23,227,20,32,302
2020,48041,Scandicci,FI,67,16,192,8,6,222,32,219,25,28,304
2020,48041,Scandicci,FI,68,16,214,7,11,248,9,219,24,42,294
2020,48041,Scandicci,FI,69,16,190,12,12,230,15,256,21,43,335
2020,48041,Scandicci,FI,70,20,222,6,19,267,14,236,20,55,325
2020,48041,Scandicci,FI,71,13,252,7,10,282,15,215,18,61,309
2020,48041,Scandicci,FI,72,16,269,18,17,320,13,238,14,79,345
2020,48041,Scandicci,FI,73,20,252,6,24,303,14,262,25,94,395
2020,48041,Scandicci,FI,74,10,240,9,19,279,15,303,18,99,435
2020,48041,Scandicci,FI,75,11,193,4,19,227,3,187,6,74,270
2020,48041,Scandicci,FI,76,7,226,11,24,268,10,187,11,94,302
2020,48041,Scandicci,FI,77,12,227,9,27,275,8,200,13,118,339
2020,48041,Scandicci,FI,78,5,205,2,17,229,5,183,14,104,306
2020,48041,Scandicci,FI,79,11,192,4,22,229,13,198,10,126,347
2020,48041,Scandicci,FI,80,5,200,9,26,240,13,175,8,155,351
2020,48041,Scandicci,FI,81,16,215,6,39,276,5,167,6,157,335
2020,48041,Scandicci,FI,82,9,192,3,47,251,8,152,4,174,338
2020,48041,Scandicci,FI,83,6,166,3,39,214,9,110,8,179,306
2020,48041,Scandicci,FI,84,8,159,2,44,213,13,91,3,151,258
2020,48041,Scandicci,FI,85,4,129,4,28,165,3,80,2,148,233
2020,48041,Scandicci,FI,86,4,111,3,37,155,9,67,3,148,227
2020,48041,Scandicci,FI,87,7,78,1,46,132,4,40,1,119,164
2020,48041,Scandicci,FI,88,3,70,1,23,97,2,30,3,136,171
2020,48041,Scandicci,FI,89,2,66,0,17,85,9,25,5,119,158
2020,48041,Scandicci,FI,90,2,46,1,13,62,2,17,1,109,129
2020,48041,Scandicci,FI,91,1,37,0,9,47,3,10,2,84,99
2020,48041,Scandicci,FI,92,1,27,0,20,48,5,8,1,66,80
2020,48041,Scandicci,FI,93,0,17,0,17,34,4,5,1,49,59
2020,48041,Scandicci,FI,94,0,16,0,12,28,1,3,1,45,50
2020,48041,Scandicci,FI,95,0,6,0,12,18,6,1,1,40,48
2020,48041,Scandicci,FI,96,0,0,0,10,10,1,2,0,33,36
2020,48041,Scandicci,FI,97,0,1,0,7,8,1,2,0,19,22
2020,48041,Scandicci,FI,98,0,1,0,0,1,1,0,0,10,11
2020,48041,Scandicci,FI,99,0,1,0,3,4,0,0,0,10,10
2020,48041,Scandicci,FI,100 e più,0,0,0,3,3,1,2,0,12,15
2020,48043,Sesto Fiorentino,FI,0,159,0,0,0,159,157,0,0,0,157
2020,48043,Sesto Fiorentino,FI,1,191,0,0,0,191,154,0,0,0,154
2020,48043,Sesto Fiorentino,FI,2,183,0,0,0,183,179,0,0,0,179
2020,48043,Sesto Fiorentino,FI,3,185,0,0,0,185,172,0,0,0,172
2020,48043,Sesto Fiorentino,FI,4,185,0,0,0,185,193,0,0,0,193
2020,48043,Sesto Fiorentino,FI,5,189,0,0,0,189,196,0,0,0,196
2020,48043,Sesto Fiorentino,FI,6,197,0,0,0,197,186,0,0,0,186
2020,48043,Sesto Fiorentino,FI,7,205,0,0,0,205,183,0,0,0,183
2020,48043,Sesto Fiorentino,FI,8,226,0,0,0,226,232,0,0,0,232
2020,48043,Sesto Fiorentino,FI,9,204,0,0,0,204,207,0,0,0,207
2020,48043,Sesto Fiorentino,FI,10,243,0,0,0,243,226,0,0,0,226
2020,48043,Sesto Fiorentino,FI,11,240,0,0,0,240,231,0,0,0,231
2020,48043,Sesto Fiorentino,FI,12,267,0,0,0,267,245,0,0,0,245
2020,48043,Sesto Fiorentino,FI,13,228,0,0,0,228,250,0,0,0,250
2020,48043,Sesto Fiorentino,FI,14,248,0,0,0,248,223,0,0,0,223
2020,48043,Sesto Fiorentino,FI,15,255,0,0,0,255,236,0,0,0,236
2020,48043,Sesto Fiorentino,FI,16,258,0,0,0,258,221,0,0,0,221
2020,48043,Sesto Fiorentino,FI,17,244,0,0,0,244,216,0,0,0,216
2020,48043,Sesto Fiorentino,FI,18,242,0,0,0,242,243,0,0,0,243
2020,48043,Sesto Fiorentino,FI,19,218,0,0,0,218,250,0,0,0,250
2020,48043,Sesto Fiorentino,FI,20,241,0,0,0,241,198,1,0,0,199
2020,48043,Sesto Fiorentino,FI,21,228,1,0,0,229,180,2,0,0,182
2020,48043,Sesto Fiorentino,FI,22,241,1,0,0,242,213,8,0,0,221
2020,48043,Sesto Fiorentino,FI,23,252,0,0,0,252,200,8,0,0,208
2020,48043,Sesto Fiorentino,FI,24,206,5,1,0,212,203,9,0,0,212
2020,48043,Sesto Fiorentino,FI,25,221,6,0,0,227,208,17,0,0,225
2020,48043,Sesto Fiorentino,FI,26,205,7,0,0,212,173,18,0,0,191
2020,48043,Sesto Fiorentino,FI,27,233,3,0,0,236,178,26,0,1,206
2020,48043,Sesto Fiorentino,FI,28,220,18,0,0,238,196,27,0,0,224
2020,48043,Sesto Fiorentino,FI,29,241,22,0,0,263,189,48,1,0,238
2020,48043,Sesto Fiorentino,FI,30,224,26,0,0,250,169,51,2,1,223
2020,48043,Sesto Fiorentino,FI,31,195,30,0,0,225,165,69,0,0,234
2020,48043,Sesto Fiorentino,FI,32,240,52,3,0,295,155,96,1,0,252
2020,48043,Sesto Fiorentino,FI,33,189,63,1,0,253,138,93,2,0,233
2020,48043,Sesto Fiorentino,FI,34,163,80,3,0,246,151,106,4,0,262
2020,48043,Sesto Fiorentino,FI,35,167,110,3,0,280,128,119,6,1,255
2020,48043,Sesto Fiorentino,FI,36,135,96,3,0,235,126,138,5,0,271
2020,48043,Sesto Fiorentino,FI,37,146,120,3,0,269,125,151,13,0,290
2020,48043,Sesto Fiorentino,FI,38,154,123,3,0,280,131,167,8,2,309
2020,48043,Sesto Fiorentino,FI,39,138,130,5,0,274,101,165,5,0,273
2020,48043,Sesto Fiorentino,FI,40,122,159,4,0,285,96,152,10,1,259
2020,48043,Sesto Fiorentino,FI,41,113,149,5,0,268,115,173,6,0,296
2020,48043,Sesto Fiorentino,FI,42,142,170,9,1,323,109,179,25,2,316
2020,48043,Sesto Fiorentino,FI,43,102,157,13,0,273,113,182,12,2,310
2020,48043,Sesto Fiorentino,FI,44,123,172,14,0,309,126,215,26,5,373
2020,48043,Sesto Fiorentino,FI,45,146,210,7,0,363,119,233,21,2,376
2020,48043,Sesto Fiorentino,FI,46,132,210,17,1,360,108,263,33,3,409
2020,48043,Sesto Fiorentino,FI,47,159,222,19,0,401,104,268,34,5,413
2020,48043,Sesto Fiorentino,FI,48,130,253,20,2,405,116,290,32,1,440
2020,48043,Sesto Fiorentino,FI,49,117,251,21,0,389,113,304,34,3,454
2020,48043,Sesto Fiorentino,FI,50,104,253,30,2,389,86,262,31,4,383
2020,48043,Sesto Fiorentino,FI,51,108,278,21,1,408,94,268,40,3,405
2020,48043,Sesto Fiorentino,FI,52,100,279,23,0,402,97,264,43,8,412
2020,48043,Sesto Fiorentino,FI,53,87,298,27,4,416,78,316,47,14,455
2020,48043,Sesto Fiorentino,FI,54,101,279,25,3,409,63,294,57,6,420
2020,48043,Sesto Fiorentino,FI,55,74,259,28,1,362,68,281,47,11,408
2020,48043,Sesto Fiorentino,FI,56,67,288,28,3,386,56,311,51,10,428
2020,48043,Sesto Fiorentino,FI,57,54,270,27,3,354,45,292,42,11,391
2020,48043,Sesto Fiorentino,FI,58,54,266,37,1,358,41,282,45,13,382
2020,48043,Sesto Fiorentino,FI,59,44,238,20,5,308,35,234,34,16,319
2020,48043,Sesto Fiorentino,FI,60,29,259,25,7,320,35,256,37,15,343
2020,48043,Sesto Fiorentino,FI,61,40,259,21,5,325,35,291,28,17,371
2020,48043,Sesto Fiorentino,FI,62,31,256,21,4,312,31,267,24,20,342
2020,48043,Sesto Fiorentino,FI,63,30,245,13,5,293,26,243,35,28,332
2020,48043,Sesto Fiorentino,FI,64,20,221,18,10,269,24,238,37,20,319
2020,48043,Sesto Fiorentino,FI,65,26,226,17,8,277,17,227,36,23,303
2020,48043,Sesto Fiorentino,FI,66,19,211,21,8,259,30,240,18,33,321
2020,48043,Sesto Fiorentino,FI,67,16,230,16,8,270,22,204,24,36,286
2020,48043,Sesto Fiorentino,FI,68,19,204,9,5,237,17,201,20,33,271
2020,48043,Sesto Fiorentino,FI,69,11,213,13,14,252,21,212,22,35,290
2020,48043,Sesto Fiorentino,FI,70,13,212,14,11,250,14,217,21,46,298
2020,48043,Sesto Fiorentino,FI,71,10,222,9,15,256,16,215,20,52,303
2020,48043,Sesto Fiorentino,FI,72,15,246,9,13,283,10,256,19,64,349
2020,48043,Sesto Fiorentino,FI,73,14,244,9,16,283,16,233,12,72,333
2020,48043,Sesto Fiorentino,FI,74,21,239,8,27,296,14,264,15,84,377
2020,48043,Sesto Fiorentino,FI,75,6,183,6,22,217,10,182,12,89,293
2020,48043,Sesto Fiorentino,FI,76,6,192,4,18,221,11,177,13,92,293
2020,48043,Sesto Fiorentino,FI,77,8,180,5,14,207,15,174,11,93,293
2020,48043,Sesto Fiorentino,FI,78,10,189,5,22,227,16,149,5,101,271
2020,48043,Sesto Fiorentino,FI,79,17,197,3,25,242,20,153,5,116,294
2020,48043,Sesto Fiorentino,FI,80,9,203,3,21,236,16,159,9,141,325
2020,48043,Sesto Fiorentino,FI,81,10,194,3,37,244,14,136,12,135,297
2020,48043,Sesto Fiorentino,FI,82,8,145,2,39,194,15,122,4,131,272
2020,48043,Sesto Fiorentino,FI,83,2,132,6,34,174,10,98,7,150,265
2020,48043,Sesto Fiorentino,FI,84,5,103,0,34,142,17,64,7,128,216
2020,48043,Sesto Fiorentino,FI,85,4,111,4,24,143,6,63,5,146,220
2020,48043,Sesto Fiorentino,FI,86,5,75,1,27,108,8,52,6,134,200
2020,48043,Sesto Fiorentino,FI,87,3,73,1,25,102,7,51,3,111,172
2020,48043,Sesto Fiorentino,FI,88,1,59,0,26,86,6,31,2,120,159
2020,48043,Sesto Fiorentino,FI,89,3,53,1,31,88,9,19,2,110,140
2020,48043,Sesto Fiorentino,FI,90,1,39,0,24,64,9,17,3,98,127
2020,48043,Sesto Fiorentino,FI,91,1,40,1,19,61,7,16,2,110,135
2020,48043,Sesto Fiorentino,FI,92,3,24,0,20,47,3,7,1,66,77
2020,48043,Sesto Fiorentino,FI,93,1,18,0,9,28,5,3,2,64,74
2020,48043,Sesto Fiorentino,FI,94,2,15,0,10,27,4,5,0,53,62
2020,48043,Sesto Fiorentino,FI,95,0,3,0,5,8,10,1,0,40,51
2020,48043,Sesto Fiorentino,FI,96,0,6,0,8,14,2,1,0,27,30
2020,48043,Sesto Fiorentino,FI,97,0,4,0,4,8,1,1,0,29,31
2020,48043,Sesto Fiorentino,FI,98,0,1,0,2,3,2,0,0,15,17
2020,48043,Sesto Fiorentino,FI,99,0,2,0,2,4,0,0,0,11,11
2020,48043,Sesto Fiorentino,FI,100 e più,0,0,0,5,5,3,0,0,16,19
2020,48044,Signa,FI,0,82,0,0,0,82,55,0,0,0,55
2020,48044,Signa,FI,1,77,0,0,0,77,58,0,0,0,58
2020,48044,Signa,FI,2,85,0,0,0,85,71,0,0,0,71
2020,48044,Signa,FI,3,70,0,0,0,70,79,0,0,0,79
2020,48044,Signa,FI,4,93,0,0,0,93,71,0,0,0,71
2020,48044,Signa,FI,5,87,0,0,0,87,58,0,0,0,58
2020,48044,Signa,FI,6,102,0,0,0,102,100,0,0,0,100
2020,48044,Signa,FI,7,83,0,0,0,83,88,0,0,0,88
2020,48044,Signa,FI,8,101,0,0,0,101,107,0,0,0,107
2020,48044,Signa,FI,9,95,0,0,0,95,88,0,0,0,88
2020,48044,Signa,FI,10,106,0,0,0,106,110,0,0,0,110
2020,48044,Signa,FI,11,116,0,0,0,116,95,0,0,0,95
2020,48044,Signa,FI,12,98,0,0,0,98,123,0,0,0,123
2020,48044,Signa,FI,13,117,0,0,0,117,114,0,0,0,114
2020,48044,Signa,FI,14,114,0,0,0,114,88,0,0,0,88
2020,48044,Signa,FI,15,92,0,0,0,92,116,0,0,0,116
2020,48044,Signa,FI,16,101,0,0,0,101,104,0,0,0,104
2020,48044,Signa,FI,17,108,0,0,0,108,84,0,0,0,84
2020,48044,Signa,FI,18,121,0,0,0,121,94,0,0,0,94
2020,48044,Signa,FI,19,95,0,0,0,95,112,0,0,0,112
2020,48044,Signa,FI,20,87,0,0,0,87,94,0,0,0,94
2020,48044,Signa,FI,21,90,1,0,0,91,101,2,0,0,103
2020,48044,Signa,FI,22,97,0,0,0,97,89,1,0,0,90
2020,48044,Signa,FI,23,92,0,0,0,92,79,4,0,0,83
2020,48044,Signa,FI,24,88,1,0,0,89,79,5,0,0,84
2020,48044,Signa,FI,25,111,3,0,0,114,85,11,0,0,96
2020,48044,Signa,FI,26,77,5,1,0,83,70,8,0,0,78
2020,48044,Signa,FI,27,83,6,0,0,89,86,9,1,0,96
2020,48044,Signa,FI,28,80,11,0,0,91,72,14,1,0,87
2020,48044,Signa,FI,29,86,3,0,0,89,58,17,1,0,76
2020,48044,Signa,FI,30,100,9,0,0,109,57,31,1,0,89
2020,48044,Signa,FI,31,80,23,0,0,103,76,39,0,0,115
2020,48044,Signa,FI,32,85,23,0,0,108,72,46,1,0,119
2020,48044,Signa,FI,33,68,30,0,0,98,44,37,2,1,84
2020,48044,Signa,FI,34,68,39,0,0,107,49,52,2,0,103
2020,48044,Signa,FI,35,61,42,1,0,104,68,51,3,1,123
2020,48044,Signa,FI,36,52,48,1,0,101,57,64,2,0,123
2020,48044,Signa,FI,37,71,53,1,0,125,57,72,2,0,131
2020,48044,Signa,FI,38,60,57,1,0,118,56,70,0,0,126
2020,48044,Signa,FI,39,61,70,3,0,134,35,84,6,2,127
2020,48044,Signa,FI,40,56,74,1,0,131,47,77,5,0,129
2020,48044,Signa,FI,41,56,77,2,0,135,42,78,9,0,129
2020,48044,Signa,FI,42,68,72,2,1,143,60,96,6,1,163
2020,48044,Signa,FI,43,55,96,7,0,158,45,105,4,0,154
2020,48044,Signa,FI,44,68,80,9,0,157,45,111,5,1,162
2020,48044,Signa,FI,45,65,85,5,0,155,47,116,2,0,165
2020,48044,Signa,FI,46,78,92,4,0,174,56,110,10,4,180
2020,48044,Signa,FI,47,55,113,7,0,175,42,123,11,0,176
2020,48044,Signa,FI,48,59,115,4,1,179,42,153,12,3,210
2020,48044,Signa,FI,49,55,133,3,1,192,39,125,7,2,173
2020,48044,Signa,FI,50,30,140,11,0,181,32,113,15,1,161
2020,48044,Signa,FI,51,37,128,10,1,176,30,124,18,7,179
2020,48044,Signa,FI,52,40,127,11,3,181,20,108,20,5,153
2020,48044,Signa,FI,53,32,129,12,0,173,24,132,15,4,175
2020,48044,Signa,FI,54,34,100,8,3,145,29,119,9,5,162
2020,48044,Signa,FI,55,15,124,11,3,153,19,134,11,2,166
2020,48044,Signa,FI,56,19,123,17,2,161,16,95,9,5,125
2020,48044,Signa,FI,57,25,99,12,0,136,15,100,12,6,133
2020,48044,Signa,FI,58,18,97,13,1,129,14,93,17,6,130
2020,48044,Signa,FI,59,16,97,12,0,125,16,81,8,5,110
2020,48044,Signa,FI,60,11,91,9,2,113,9,87,14,11,121
2020,48044,Signa,FI,61,5,89,9,1,104,12,77,12,2,103
2020,48044,Signa,FI,62,10,89,8,2,109,10,77,7,1,95
2020,48044,Signa,FI,63,12,87,9,3,111,11,72,5,17,105
2020,48044,Signa,FI,64,18,80,5,3,106,6,77,2,8,93
2020,48044,Signa,FI,65,7,83,5,0,95,11,71,7,15,104
2020,48044,Signa,FI,66,3,80,5,3,91,10,78,2,12,102
2020,48044,Signa,FI,67,4,71,2,4,81,2,71,3,17,93
2020,48044,Signa,FI,68,3,70,0,0,73,7,74,7,10,98
2020,48044,Signa,FI,69,5,73,8,5,91,3,66,4,13,86
2020,48044,Signa,FI,70,5,85,2,4,96,5,74,5,11,95
2020,48044,Signa,FI,71,6,84,2,5,97,1,82,7,20,110
2020,48044,Signa,FI,72,3,83,4,7,97,8,75,4,28,115
2020,48044,Signa,FI,73,8,58,3,2,71,8,75,8,28,119
2020,48044,Signa,FI,74,7,75,1,6,89,6,75,7,28,116
2020,48044,Signa,FI,75,3,65,4,6,78,2,58,6,24,90
2020,48044,Signa,FI,76,1,57,1,7,66,4,58,3,34,99
2020,48044,Signa,FI,77,7,54,2,8,71,3,41,0,20,64
2020,48044,Signa,FI,78,1,52,2,6,61,6,49,2,37,94
2020,48044,Signa,FI,79,3,46,0,6,55,4,47,3,29,83
2020,48044,Signa,FI,80,2,53,3,12,70,6,38,2,38,84
2020,48044,Signa,FI,81,0,66,0,4,70,5,38,1,35,79
2020,48044,Signa,FI,82,4,46,2,7,59,8,39,0,52,99
2020,48044,Signa,FI,83,2,50,2,18,72,10,35,1,52,98
2020,48044,Signa,FI,84,2,32,0,10,44,5,22,1,35,63
2020,48044,Signa,FI,85,0,28,0,5,33,4,10,0,32,46
2020,48044,Signa,FI,86,2,24,0,12,38,4,14,1,37,56
2020,48044,Signa,FI,87,1,22,0,12,35,4,6,1,35,46
2020,48044,Signa,FI,88,1,19,0,10,30,2,7,1,44,54
2020,48044,Signa,FI,89,1,8,0,9,18,6,4,0,18,28
2020,48044,Signa,FI,90,2,14,0,7,23,1,3,0,27,31
2020,48044,Signa,FI,91,0,7,0,3,10,5,2,0,19,26
2020,48044,Signa,FI,92,2,1,0,7,10,2,2,0,21,25
2020,48044,Signa,FI,93,0,7,0,1,8,0,2,1,25,28
2020,48044,Signa,FI,94,0,4,0,4,8,2,0,0,21,23
2020,48044,Signa,FI,95,0,0,0,1,1,2,1,0,12,15
2020,48044,Signa,FI,96,0,2,0,4,6,0,0,0,8,8
2020,48044,Signa,FI,97,0,0,0,0,0,1,0,0,5,6
2020,48044,Signa,FI,98,0,0,0,0,0,0,0,0,2,2
2020,48044,Signa,FI,99,0,0,1,1,2,0,0,0,2,2
2020,48044,Signa,FI,100 e più,0,1,0,0,1,1,0,0,5,6
2020,48046,Vaglia,FI,0,19,0,0,0,19,20,0,0,0,20
2020,48046,Vaglia,FI,1,14,0,0,0,14,13,0,0,0,13
2020,48046,Vaglia,FI,2,20,0,0,0,20,27,0,0,0,27
2020,48046,Vaglia,FI,3,20,0,0,0,20,12,0,0,0,12
2020,48046,Vaglia,FI,4,22,0,0,0,22,20,0,0,0,20
2020,48046,Vaglia,FI,5,17,0,0,0,17,18,0,0,0,18
2020,48046,Vaglia,FI,6,13,0,0,0,13,24,0,0,0,24
2020,48046,Vaglia,FI,7,10,0,0,0,10,19,0,0,0,19
2020,48046,Vaglia,FI,8,23,0,0,0,23,16,0,0,0,16
2020,48046,Vaglia,FI,9,28,0,0,0,28,18,0,0,0,18
2020,48046,Vaglia,FI,10,23,0,0,0,23,24,0,0,0,24
2020,48046,Vaglia,FI,11,19,0,0,0,19,23,0,0,0,23
2020,48046,Vaglia,FI,12,22,0,0,0,22,19,0,0,0,19
2020,48046,Vaglia,FI,13,16,0,0,0,16,17,0,0,0,17
2020,48046,Vaglia,FI,14,28,0,0,0,28,28,0,0,0,28
2020,48046,Vaglia,FI,15,27,0,0,0,27,18,0,0,0,18
2020,48046,Vaglia,FI,16,21,0,0,0,21,22,0,0,0,22
2020,48046,Vaglia,FI,17,22,0,0,0,22,21,0,0,0,21
2020,48046,Vaglia,FI,18,28,0,0,0,28,27,0,0,0,27
2020,48046,Vaglia,FI,19,29,0,0,0,29,30,0,0,0,30
2020,48046,Vaglia,FI,20,19,0,0,0,19,26,0,0,0,26
2020,48046,Vaglia,FI,21,19,0,0,0,19,23,0,0,0,23
2020,48046,Vaglia,FI,22,24,0,0,0,24,23,0,0,0,23
2020,48046,Vaglia,FI,23,16,0,0,0,16,25,0,0,0,25
2020,48046,Vaglia,FI,24,25,0,0,0,25,15,1,0,0,16
2020,48046,Vaglia,FI,25,22,0,0,0,22,19,1,0,0,20
2020,48046,Vaglia,FI,26,17,0,0,0,17,26,1,0,0,27
2020,48046,Vaglia,FI,27,27,0,0,0,27,18,0,1,0,19
2020,48046,Vaglia,FI,28,26,1,0,0,27,24,4,0,0,28
2020,48046,Vaglia,FI,29,19,0,0,0,19,19,4,0,0,23
2020,48046,Vaglia,FI,30,24,2,0,0,26,24,4,0,0,28
2020,48046,Vaglia,FI,31,20,3,0,0,23,17,7,0,0,24
2020,48046,Vaglia,FI,32,17,2,0,0,19,12,10,0,0,22
2020,48046,Vaglia,FI,33,18,3,0,0,21,11,11,0,0,22
2020,48046,Vaglia,FI,34,20,6,2,0,28,10,3,0,0,13
2020,48046,Vaglia,FI,35,14,7,0,0,21,14,18,0,0,32
2020,48046,Vaglia,FI,36,14,7,0,0,21,10,10,0,0,20
2020,48046,Vaglia,FI,37,18,12,2,0,32,20,10,1,0,31
2020,48046,Vaglia,FI,38,15,10,0,0,25,14,15,1,0,30
2020,48046,Vaglia,FI,39,11,8,0,0,19,18,10,3,1,32
2020,48046,Vaglia,FI,40,11,9,0,0,20,6,10,1,0,17
2020,48046,Vaglia,FI,41,14,12,3,0,29,17,15,1,0,33
2020,48046,Vaglia,FI,42,12,13,2,0,27,12,20,0,0,32
2020,48046,Vaglia,FI,43,15,17,0,0,32,23,20,0,0,43
2020,48046,Vaglia,FI,44,10,18,3,0,31,9,18,3,1,31
2020,48046,Vaglia,FI,45,13,18,2,0,33,17,23,3,0,43
2020,48046,Vaglia,FI,46,12,18,1,0,31,28,21,2,1,52
2020,48046,Vaglia,FI,47,15,21,4,0,40,17,22,3,0,42
2020,48046,Vaglia,FI,48,21,24,0,0,45,15,31,1,0,47
2020,48046,Vaglia,FI,49,18,22,5,1,46,9,20,1,1,31
2020,48046,Vaglia,FI,50,25,29,0,0,54,9,27,4,1,41
2020,48046,Vaglia,FI,51,15,29,2,2,48,11,36,2,0,49
2020,48046,Vaglia,FI,52,9,26,2,1,38,8,33,3,0,44
2020,48046,Vaglia,FI,53,15,38,1,0,54,11,41,3,3,58
2020,48046,Vaglia,FI,54,16,27,6,1,50,10,25,4,0,39
2020,48046,Vaglia,FI,55,10,34,3,1,48,7,34,5,0,46
2020,48046,Vaglia,FI,56,10,32,5,0,47,8,37,6,0,51
2020,48046,Vaglia,FI,57,6,22,4,0,32,11,23,5,0,39
2020,48046,Vaglia,FI,58,7,31,6,0,44,7,33,5,3,48
2020,48046,Vaglia,FI,59,6,28,3,1,38,11,36,3,1,51
2020,48046,Vaglia,FI,60,6,42,3,2,53,7,32,2,2,43
2020,48046,Vaglia,FI,61,7,30,6,0,43,7,27,8,3,45
2020,48046,Vaglia,FI,62,3,32,3,0,38,5,25,5,2,37
2020,48046,Vaglia,FI,63,6,25,3,1,35,2,30,4,0,36
2020,48046,Vaglia,FI,64,8,26,2,2,38,5,33,4,3,45
2020,48046,Vaglia,FI,65,8,25,3,1,37,4,22,2,3,31
2020,48046,Vaglia,FI,66,2,31,8,1,42,4,26,2,2,34
2020,48046,Vaglia,FI,67,0,27,4,3,34,1,23,2,3,29
2020,48046,Vaglia,FI,68,3,25,3,1,32,2,30,1,4,37
2020,48046,Vaglia,FI,69,3,33,2,1,39,3,19,3,7,32
2020,48046,Vaglia,FI,70,3,27,1,0,31,1,25,0,1,27
2020,48046,Vaglia,FI,71,0,28,2,4,34,1,17,3,5,26
2020,48046,Vaglia,FI,72,3,35,1,0,39,2,20,1,7,30
2020,48046,Vaglia,FI,73,2,30,0,1,33,1,27,1,9,38
2020,48046,Vaglia,FI,74,3,30,3,2,38,0,28,0,10,38
2020,48046,Vaglia,FI,75,1,20,3,1,25,1,20,2,10,33
2020,48046,Vaglia,FI,76,3,27,0,5,35,1,21,0,8,30
2020,48046,Vaglia,FI,77,3,17,0,0,20,1,16,2,10,29
2020,48046,Vaglia,FI,78,0,20,1,3,24,4,11,1,9,25
2020,48046,Vaglia,FI,79,3,19,0,2,24,0,10,2,16,28
2020,48046,Vaglia,FI,80,0,18,0,1,19,0,12,1,7,20
2020,48046,Vaglia,FI,81,4,14,0,5,23,1,15,1,19,36
2020,48046,Vaglia,FI,82,1,11,1,3,16,1,17,1,9,28
2020,48046,Vaglia,FI,83,2,13,0,9,24,1,7,0,7,15
2020,48046,Vaglia,FI,84,0,10,1,2,13,0,8,0,12,20
2020,48046,Vaglia,FI,85,1,19,0,2,22,1,7,0,12,20
2020,48046,Vaglia,FI,86,1,10,1,2,14,0,7,2,9,18
2020,48046,Vaglia,FI,87,2,6,0,2,10,1,4,0,11,16
2020,48046,Vaglia,FI,88,0,3,0,4,7,0,4,0,5,9
2020,48046,Vaglia,FI,89,0,5,0,5,10,0,3,0,13,16
2020,48046,Vaglia,FI,90,0,3,0,1,4,0,4,0,4,8
2020,48046,Vaglia,FI,91,0,3,0,1,4,0,0,0,4,4
2020,48046,Vaglia,FI,92,0,7,0,1,8,0,0,0,10,10
2020,48046,Vaglia,FI,93,0,1,0,1,2,1,1,0,3,5
2020,48046,Vaglia,FI,94,1,0,0,0,1,0,0,0,4,4
2020,48046,Vaglia,FI,95,0,0,0,3,3,0,0,0,5,5
2020,48046,Vaglia,FI,96,0,1,0,0,1,0,0,0,2,2
2020,48046,Vaglia,FI,97,0,0,0,0,0,0,0,0,2,2
2020,48046,Vaglia,FI,98,0,1,0,0,1,0,0,0,3,3
2020,48046,Vaglia,FI,99,0,0,0,0,0,1,0,0,1,2
2020,48046,Vaglia,FI,100 e più,0,0,0,0,0,0,0,0,0,0
2020,48049,Vicchio,FI,0,22,0,0,0,22,15,0,0,0,15
2020,48049,Vicchio,FI,1,24,0,0,0,24,29,0,0,0,29
2020,48049,Vicchio,FI,2,21,0,0,0,21,23,0,0,0,23
2020,48049,Vicchio,FI,3,27,0,0,0,27,26,0,0,0,26
2020,48049,Vicchio,FI,4,33,0,0,0,33,24,0,0,0,24
2020,48049,Vicchio,FI,5,34,0,0,0,34,29,0,0,0,29
2020,48049,Vicchio,FI,6,33,0,0,0,33,25,0,0,0,25
2020,48049,Vicchio,FI,7,35,0,0,0,35,43,0,0,0,43
2020,48049,Vicchio,FI,8,30,0,0,0,30,30,0,0,0,30
2020,48049,Vicchio,FI,9,38,0,0,0,38,31,0,0,0,31
2020,48049,Vicchio,FI,10,48,0,0,0,48,31,0,0,0,31
2020,48049,Vicchio,FI,11,52,0,0,0,52,51,0,0,0,51
2020,48049,Vicchio,FI,12,45,0,0,0,45,46,0,0,0,46
2020,48049,Vicchio,FI,13,42,0,0,0,42,26,0,0,0,26
2020,48049,Vicchio,FI,14,43,0,0,0,43,42,0,0,0,42
2020,48049,Vicchio,FI,15,32,0,0,0,32,38,0,0,0,38
2020,48049,Vicchio,FI,16,50,0,0,0,50,44,0,0,0,44
2020,48049,Vicchio,FI,17,36,0,0,0,36,39,0,0,0,39
2020,48049,Vicchio,FI,18,40,0,0,0,40,30,0,0,0,30
2020,48049,Vicchio,FI,19,47,0,0,0,47,37,0,0,0,37
2020,48049,Vicchio,FI,20,44,0,0,0,44,23,0,0,0,23
2020,48049,Vicchio,FI,21,41,0,0,0,41,39,1,0,0,40
2020,48049,Vicchio,FI,22,45,0,0,0,45,43,2,0,0,45
2020,48049,Vicchio,FI,23,44,0,0,0,44,29,0,0,0,29
2020,48049,Vicchio,FI,24,45,0,0,0,45,37,3,0,0,40
2020,48049,Vicchio,FI,25,31,0,0,0,31,33,1,0,0,34
2020,48049,Vicchio,FI,26,37,0,0,0,37,28,7,0,0,35
2020,48049,Vicchio,FI,27,53,0,0,0,53,34,8,0,0,42
2020,48049,Vicchio,FI,28,34,2,0,0,36,31,8,1,0,40
2020,48049,Vicchio,FI,29,35,3,0,0,38,28,14,0,0,42
2020,48049,Vicchio,FI,30,36,5,0,0,41,29,6,0,0,35
2020,48049,Vicchio,FI,31,47,8,0,0,55,17,8,2,0,27
2020,48049,Vicchio,FI,32,29,12,1,0,42,22,12,1,0,35
2020,48049,Vicchio,FI,33,27,7,1,0,35,18,13,0,0,31
2020,48049,Vicchio,FI,34,32,12,0,0,44,25,20,0,0,45
2020,48049,Vicchio,FI,35,23,14,0,0,37,15,17,1,0,33
2020,48049,Vicchio,FI,36,27,20,0,0,47,21,18,1,0,40
2020,48049,Vicchio,FI,37,20,16,1,0,37,17,23,3,0,43
2020,48049,Vicchio,FI,38,16,19,2,0,37,17,20,3,0,40
2020,48049,Vicchio,FI,39,18,21,0,0,39,18,22,0,0,40
2020,48049,Vicchio,FI,40,28,11,2,0,41,21,22,0,0,43
2020,48049,Vicchio,FI,41,21,21,1,0,43,25,30,3,0,58
2020,48049,Vicchio,FI,42,23,21,0,0,44,15,33,3,1,52
2020,48049,Vicchio,FI,43,32,24,0,0,56,23,28,0,0,51
2020,48049,Vicchio,FI,44,28,26,2,0,56,17,35,1,0,53
2020,48049,Vicchio,FI,45,33,28,1,2,64,31,31,6,1,69
2020,48049,Vicchio,FI,46,23,40,2,0,65,21,39,9,0,69
2020,48049,Vicchio,FI,47,32,33,2,0,67,19,45,4,1,69
2020,48049,Vicchio,FI,48,27,39,4,0,70,23,48,6,1,78
2020,48049,Vicchio,FI,49,32,32,1,0,65,19,45,2,1,67
2020,48049,Vicchio,FI,50,30,48,5,1,84,12,39,4,0,55
2020,48049,Vicchio,FI,51,30,38,3,0,71,15,46,5,2,68
2020,48049,Vicchio,FI,52,21,36,5,1,63,16,46,5,1,68
2020,48049,Vicchio,FI,53,20,41,3,0,64,14,41,4,2,61
2020,48049,Vicchio,FI,54,7,46,4,0,57,11,49,4,3,67
2020,48049,Vicchio,FI,55,14,46,8,1,69,12,52,7,4,75
2020,48049,Vicchio,FI,56,17,54,6,1,78,14,44,6,2,66
2020,48049,Vicchio,FI,57,14,59,5,0,78,7,40,5,5,57
2020,48049,Vicchio,FI,58,15,52,6,0,73,8,48,7,2,65
2020,48049,Vicchio,FI,59,13,42,11,1,67,1,48,8,2,59
2020,48049,Vicchio,FI,60,14,39,4,0,57,6,41,6,2,55
2020,48049,Vicchio,FI,61,9,44,6,1,60,6,53,8,4,71
2020,48049,Vicchio,FI,62,7,40,4,0,51,7,44,10,2,63
2020,48049,Vicchio,FI,63,7,40,5,3,55,2,44,3,4,53
2020,48049,Vicchio,FI,64,4,45,3,0,52,7,46,1,3,57
2020,48049,Vicchio,FI,65,4,47,3,1,55,3,41,1,8,53
2020,48049,Vicchio,FI,66,3,40,3,3,49,1,49,3,5,58
2020,48049,Vicchio,FI,67,5,38,6,1,50,4,24,0,6,34
2020,48049,Vicchio,FI,68,3,37,4,0,44,5,33,3,10,51
2020,48049,Vicchio,FI,69,5,38,1,3,47,1,34,4,9,48
2020,48049,Vicchio,FI,70,0,46,3,5,54,5,39,1,6,51
2020,48049,Vicchio,FI,71,3,26,2,1,32,0,47,0,2,49
2020,48049,Vicchio,FI,72,3,39,3,3,48,3,40,0,8,51
2020,48049,Vicchio,FI,73,2,43,1,3,49,3,43,3,9,58
2020,48049,Vicchio,FI,74,5,43,2,3,53,3,35,0,17,55
2020,48049,Vicchio,FI,75,5,36,3,4,48,0,19,0,6,25
2020,48049,Vicchio,FI,76,1,23,1,5,30,1,22,2,8,33
2020,48049,Vicchio,FI,77,2,24,1,3,30,1,23,1,19,44
2020,48049,Vicchio,FI,78,2,24,0,4,30,3,20,1,17,41
2020,48049,Vicchio,FI,79,2,25,1,2,30,0,17,1,13,31
2020,48049,Vicchio,FI,80,6,28,0,2,36,2,9,1,18,30
2020,48049,Vicchio,FI,81,3,22,1,5,31,0,15,1,26,42
2020,48049,Vicchio,FI,82,3,32,1,3,39,1,10,0,24,35
2020,48049,Vicchio,FI,83,2,19,0,6,27,1,10,0,17,28
2020,48049,Vicchio,FI,84,3,15,0,4,22,0,11,0,22,33
2020,48049,Vicchio,FI,85,0,13,0,3,16,0,8,0,34,42
2020,48049,Vicchio,FI,86,3,11,0,5,19,0,5,0,18,23
2020,48049,Vicchio,FI,87,1,11,0,5,17,2,7,0,17,26
2020,48049,Vicchio,FI,88,0,12,0,2,14,0,4,0,23,27
2020,48049,Vicchio,FI,89,3,4,0,5,12,2,3,0,17,22
2020,48049,Vicchio,FI,90,0,5,1,3,9,1,2,0,17,20
2020,48049,Vicchio,FI,91,0,3,0,2,5,0,1,0,14,15
2020,48049,Vicchio,FI,92,0,5,0,3,8,2,1,0,9,12
2020,48049,Vicchio,FI,93,1,2,0,3,6,2,0,1,9,12
2020,48049,Vicchio,FI,94,0,2,0,1,3,0,0,0,6,6
2020,48049,Vicchio,FI,95,0,1,0,2,3,0,0,0,8,8
2020,48049,Vicchio,FI,96,0,1,0,0,1,0,2,0,5,7
2020,48049,Vicchio,FI,97,0,0,0,0,0,0,0,0,7,7
2020,48049,Vicchio,FI,98,0,0,0,0,0,0,0,0,0,0
2020,48049,Vicchio,FI,99,0,0,0,1,1,0,0,0,2,2
2020,48049,Vicchio,FI,100 e più,0,0,0,1,1,0,0,0,1,1
2020,48050,Vinci,FI,0,46,0,0,0,46,35,0,0,0,35
2020,48050,Vinci,FI,1,45,0,0,0,45,40,0,0,0,40
2020,48050,Vinci,FI,2,67,0,0,0,67,30,0,0,0,30
2020,48050,Vinci,FI,3,39,0,0,0,39,45,0,0,0,45
2020,48050,Vinci,FI,4,49,0,0,0,49,68,0,0,0,68
2020,48050,Vinci,FI,5,52,0,0,0,52,43,0,0,0,43
2020,48050,Vinci,FI,6,61,0,0,0,61,57,0,0,0,57
2020,48050,Vinci,FI,7,61,0,0,0,61,51,0,0,0,51
2020,48050,Vinci,FI,8,60,0,0,0,60,67,0,0,0,67
2020,48050,Vinci,FI,9,72,0,0,0,72,63,0,0,0,63
2020,48050,Vinci,FI,10,77,0,0,0,77,58,0,0,0,58
2020,48050,Vinci,FI,11,76,0,0,0,76,72,0,0,0,72
2020,48050,Vinci,FI,12,75,0,0,0,75,62,0,0,0,62
2020,48050,Vinci,FI,13,77,0,0,0,77,66,0,0,0,66
2020,48050,Vinci,FI,14,69,0,0,0,69,73,0,0,0,73
2020,48050,Vinci,FI,15,82,0,0,0,82,74,0,0,0,74
2020,48050,Vinci,FI,16,84,0,0,0,84,63,0,0,0,63
2020,48050,Vinci,FI,17,73,0,0,0,73,56,0,0,0,56
2020,48050,Vinci,FI,18,84,0,0,0,84,63,0,0,0,63
2020,48050,Vinci,FI,19,72,0,0,0,72,74,0,0,0,74
2020,48050,Vinci,FI,20,82,0,0,0,82,76,2,0,0,78
2020,48050,Vinci,FI,21,83,1,0,0,84,75,0,0,0,75
2020,48050,Vinci,FI,22,73,0,0,0,73,59,1,0,0,60
2020,48050,Vinci,FI,23,74,0,0,0,74,60,3,0,0,63
2020,48050,Vinci,FI,24,65,0,0,0,65,54,3,0,0,57
2020,48050,Vinci,FI,25,66,2,0,0,68,58,6,0,0,64
2020,48050,Vinci,FI,26,70,3,0,0,73,65,6,0,0,71
2020,48050,Vinci,FI,27,65,0,0,0,65,61,5,0,0,66
2020,48050,Vinci,FI,28,73,7,0,0,80,57,13,0,0,70
2020,48050,Vinci,FI,29,58,4,0,0,62,51,14,0,0,65
2020,48050,Vinci,FI,30,63,14,0,0,77,49,22,0,0,71
2020,48050,Vinci,FI,31,61,10,0,0,71,41,18,0,0,59
2020,48050,Vinci,FI,32,45,20,0,0,65,37,27,2,0,66
2020,48050,Vinci,FI,33,58,25,0,0,83,31,30,3,0,64
2020,48050,Vinci,FI,34,49,19,0,0,68,34,33,1,0,68
2020,48050,Vinci,FI,35,50,27,0,0,77,45,33,1,0,79
2020,48050,Vinci,FI,36,42,25,1,0,68,31,55,2,0,88
2020,48050,Vinci,FI,37,49,37,2,0,88,38,44,0,0,82
2020,48050,Vinci,FI,38,42,33,1,0,76,32,50,4,0,86
2020,48050,Vinci,FI,39,42,37,2,0,81,38,47,3,0,88
2020,48050,Vinci,FI,40,30,45,1,0,76,34,47,6,0,87
2020,48050,Vinci,FI,41,38,44,1,1,84,35,62,5,0,102
2020,48050,Vinci,FI,42,51,74,4,0,129,35,63,6,0,104
2020,48050,Vinci,FI,43,53,67,2,1,123,39,74,3,1,117
2020,48050,Vinci,FI,44,53,70,5,0,128,33,77,5,0,115
2020,48050,Vinci,FI,45,50,49,4,1,104,42,76,4,0,122
2020,48050,Vinci,FI,46,40,80,5,0,125,36,82,5,0,123
2020,48050,Vinci,FI,47,40,78,2,1,121,27,97,11,0,135
2020,48050,Vinci,FI,48,45,79,6,1,131,31,94,6,4,135
2020,48050,Vinci,FI,49,30,92,7,0,129,32,85,12,2,131
2020,48050,Vinci,FI,50,33,102,4,1,140,14,85,10,2,111
2020,48050,Vinci,FI,51,29,88,11,0,128,22,102,7,0,131
2020,48050,Vinci,FI,52,25,105,11,0,141,17,95,10,2,124
2020,48050,Vinci,FI,53,25,85,5,1,116,25,98,7,7,137
2020,48050,Vinci,FI,54,20,81,8,1,110,19,79,14,2,114
2020,48050,Vinci,FI,55,17,95,10,0,122,18,111,9,3,141
2020,48050,Vinci,FI,56,12,75,4,3,94,24,95,15,1,135
2020,48050,Vinci,FI,57,16,91,9,0,116,13,91,11,4,119
2020,48050,Vinci,FI,58,15,86,12,1,114,11,78,4,6,99
2020,48050,Vinci,FI,59,8,76,7,2,93,15,76,2,3,96
2020,48050,Vinci,FI,60,12,76,5,1,94,12,98,7,6,123
2020,48050,Vinci,FI,61,9,81,12,0,102,6,80,8,5,99
2020,48050,Vinci,FI,62,10,90,8,2,110,6,78,7,8,99
2020,48050,Vinci,FI,63,6,55,8,1,70,14,73,6,6,99
2020,48050,Vinci,FI,64,11,73,6,3,93,11,69,3,10,93
2020,48050,Vinci,FI,65,8,73,1,5,87,7,59,7,13,86
2020,48050,Vinci,FI,66,4,66,3,3,76,6,69,4,13,92
2020,48050,Vinci,FI,67,4,67,5,4,80,3,60,2,14,79
2020,48050,Vinci,FI,68,3,58,8,4,73,4,74,3,6,87
2020,48050,Vinci,FI,69,4,63,4,4,75,6,66,6,11,89
2020,48050,Vinci,FI,70,1,76,2,5,84,1,62,5,16,84
2020,48050,Vinci,FI,71,4,71,3,4,82,4,57,3,14,78
2020,48050,Vinci,FI,72,4,71,3,4,82,1,69,0,16,86
2020,48050,Vinci,FI,73,3,75,1,4,83,6,69,6,39,120
2020,48050,Vinci,FI,74,2,74,3,12,91,1,78,5,22,106
2020,48050,Vinci,FI,75,5,52,0,6,63,5,60,2,21,88
2020,48050,Vinci,FI,76,1,52,1,10,64,5,55,0,26,86
2020,48050,Vinci,FI,77,4,67,2,4,77,5,42,3,24,74
2020,48050,Vinci,FI,78,4,49,2,7,62,1,37,1,27,66
2020,48050,Vinci,FI,79,2,50,1,10,63,2,50,3,20,75
2020,48050,Vinci,FI,80,3,44,0,7,54,4,38,1,26,69
2020,48050,Vinci,FI,81,2,46,1,7,56,1,41,3,52,97
2020,48050,Vinci,FI,82,3,50,1,6,60,1,36,1,33,71
2020,48050,Vinci,FI,83,5,47,1,5,58,3,18,0,44,65
2020,48050,Vinci,FI,84,0,33,0,7,40,1,20,0,33,54
2020,48050,Vinci,FI,85,1,42,0,7,50,3,24,0,42,69
2020,48050,Vinci,FI,86,2,20,1,7,30,2,13,0,37,52
2020,48050,Vinci,FI,87,1,19,0,7,27,1,12,0,28,41
2020,48050,Vinci,FI,88,0,19,0,7,26,4,11,0,25,40
2020,48050,Vinci,FI,89,1,15,0,6,22,1,7,0,35,43
2020,48050,Vinci,FI,90,0,10,0,2,12,1,4,1,32,38
2020,48050,Vinci,FI,91,0,13,0,2,15,1,3,1,24,29
2020,48050,Vinci,FI,92,0,6,0,4,10,1,1,0,21,23
2020,48050,Vinci,FI,93,2,5,0,2,9,1,0,0,19,20
2020,48050,Vinci,FI,94,1,5,0,2,8,0,2,0,10,12
2020,48050,Vinci,FI,95,0,2,0,2,4,1,0,0,6,7
2020,48050,Vinci,FI,96,0,2,0,4,6,0,1,0,9,10
2020,48050,Vinci,FI,97,0,0,0,0,0,0,1,0,4,5
2020,48050,Vinci,FI,98,0,1,0,0,1,0,0,0,2,2
2020,48050,Vinci,FI,99,0,0,0,0,0,0,0,0,3,3
2020,48050,Vinci,FI,100 e più,0,0,0,0,0,0,0,0,3,3
2020,48052,Figline e Incisa Valdarno,FI,0,81,0,0,0,81,79,0,0,0,79
2020,48052,Figline e Incisa Valdarno,FI,1,66,0,0,0,66,75,0,0,0,75
2020,48052,Figline e Incisa Valdarno,FI,2,81,0,0,0,81,95,0,0,0,95
2020,48052,Figline e Incisa Valdarno,FI,3,88,0,0,0,88,79,0,0,0,79
2020,48052,Figline e Incisa Valdarno,FI,4,75,0,0,0,75,79,0,0,0,79
2020,48052,Figline e Incisa Valdarno,FI,5,103,0,0,0,103,88,0,0,0,88
2020,48052,Figline e Incisa Valdarno,FI,6,101,0,0,0,101,90,0,0,0,90
2020,48052,Figline e Incisa Valdarno,FI,7,99,0,0,0,99,91,0,0,0,91
2020,48052,Figline e Incisa Valdarno,FI,8,118,0,0,0,118,99,0,0,0,99
2020,48052,Figline e Incisa Valdarno,FI,9,116,0,0,0,116,98,0,0,0,98
2020,48052,Figline e Incisa Valdarno,FI,10,93,0,0,0,93,109,0,0,0,109
2020,48052,Figline e Incisa Valdarno,FI,11,102,0,0,0,102,108,0,0,0,108
2020,48052,Figline e Incisa Valdarno,FI,12,112,0,0,0,112,115,0,0,0,115
2020,48052,Figline e Incisa Valdarno,FI,13,111,0,0,0,111,111,0,0,0,111
2020,48052,Figline e Incisa Valdarno,FI,14,110,0,0,0,110,102,0,0,0,102
2020,48052,Figline e Incisa Valdarno,FI,15,108,0,0,0,108,115,0,0,0,115
2020,48052,Figline e Incisa Valdarno,FI,16,97,0,0,0,97,93,0,0,0,93
2020,48052,Figline e Incisa Valdarno,FI,17,125,0,0,0,125,106,0,0,0,106
2020,48052,Figline e Incisa Valdarno,FI,18,117,0,0,0,117,122,0,0,0,122
2020,48052,Figline e Incisa Valdarno,FI,19,130,0,0,0,130,95,2,0,0,97
2020,48052,Figline e Incisa Valdarno,FI,20,110,0,0,0,110,111,0,0,0,111
2020,48052,Figline e Incisa Valdarno,FI,21,107,0,0,0,107,100,1,0,0,101
2020,48052,Figline e Incisa Valdarno,FI,22,107,0,0,0,107,94,0,0,0,94
2020,48052,Figline e Incisa Valdarno,FI,23,94,1,0,0,95,105,2,0,0,107
2020,48052,Figline e Incisa Valdarno,FI,24,104,3,0,0,107,100,7,0,0,107
2020,48052,Figline e Incisa Valdarno,FI,25,111,2,0,0,113,97,5,0,0,102
2020,48052,Figline e Incisa Valdarno,FI,26,107,3,0,0,110,92,8,1,0,101
2020,48052,Figline e Incisa Valdarno,FI,27,98,3,0,0,101,82,17,2,0,101
2020,48052,Figline e Incisa Valdarno,FI,28,118,5,0,0,123,93,23,0,0,116
2020,48052,Figline e Incisa Valdarno,FI,29,103,15,1,0,119,85,24,0,0,109
2020,48052,Figline e Incisa Valdarno,FI,30,113,20,0,0,133,87,39,3,0,129
2020,48052,Figline e Incisa Valdarno,FI,31,116,14,0,0,130,97,34,1,0,132
2020,48052,Figline e Incisa Valdarno,FI,32,87,30,2,0,119,71,38,3,0,112
2020,48052,Figline e Incisa Valdarno,FI,33,75,36,1,0,112,74,60,2,0,136
2020,48052,Figline e Incisa Valdarno,FI,34,64,28,1,0,93,61,59,2,0,122
2020,48052,Figline e Incisa Valdarno,FI,35,89,38,2,0,130,53,71,3,0,127
2020,48052,Figline e Incisa Valdarno,FI,36,78,52,4,0,134,69,72,2,0,143
2020,48052,Figline e Incisa Valdarno,FI,37,74,52,1,0,127,48,82,3,0,133
2020,48052,Figline e Incisa Valdarno,FI,38,79,68,0,0,147,67,89,3,0,159
2020,48052,Figline e Incisa Valdarno,FI,39,66,69,1,0,136,45,75,5,0,125
2020,48052,Figline e Incisa Valdarno,FI,40,85,88,2,0,175,43,81,6,0,130
2020,48052,Figline e Incisa Valdarno,FI,41,61,68,2,0,131,42,74,6,0,122
2020,48052,Figline e Incisa Valdarno,FI,42,72,83,5,0,160,36,93,8,2,139
2020,48052,Figline e Incisa Valdarno,FI,43,46,89,5,0,141,46,96,11,0,153
2020,48052,Figline e Incisa Valdarno,FI,44,60,99,8,0,167,57,99,11,0,168
2020,48052,Figline e Incisa Valdarno,FI,45,80,110,9,1,200,33,139,10,1,183
2020,48052,Figline e Incisa Valdarno,FI,46,65,114,7,0,187,42,108,12,1,163
2020,48052,Figline e Incisa Valdarno,FI,47,57,111,4,1,174,53,111,17,3,184
2020,48052,Figline e Incisa Valdarno,FI,48,37,116,10,3,166,43,148,12,3,206
2020,48052,Figline e Incisa Valdarno,FI,49,50,124,9,1,184,33,139,24,1,197
2020,48052,Figline e Incisa Valdarno,FI,50,44,112,10,0,166,32,144,15,1,192
2020,48052,Figline e Incisa Valdarno,FI,51,42,127,8,1,179,32,147,20,2,202
2020,48052,Figline e Incisa Valdarno,FI,52,39,114,10,3,166,40,142,14,6,202
2020,48052,Figline e Incisa Valdarno,FI,53,33,151,16,2,202,41,141,19,4,205
2020,48052,Figline e Incisa Valdarno,FI,54,40,144,13,0,197,32,131,14,7,184
2020,48052,Figline e Incisa Valdarno,FI,55,29,134,8,1,172,24,144,16,7,191
2020,48052,Figline e Incisa Valdarno,FI,56,23,119,13,2,157,25,148,13,8,194
2020,48052,Figline e Incisa Valdarno,FI,57,28,138,16,3,185,20,141,9,11,181
2020,48052,Figline e Incisa Valdarno,FI,58,31,136,11,4,182,22,148,14,11,195
2020,48052,Figline e Incisa Valdarno,FI,59,19,123,12,1,155,14,117,28,11,170
2020,48052,Figline e Incisa Valdarno,FI,60,21,127,11,1,160,22,135,19,13,189
2020,48052,Figline e Incisa Valdarno,FI,61,17,140,11,3,171,26,140,10,6,182
2020,48052,Figline e Incisa Valdarno,FI,62,23,120,5,4,152,12,115,15,10,152
2020,48052,Figline e Incisa Valdarno,FI,63,25,103,12,5,145,15,109,10,8,142
2020,48052,Figline e Incisa Valdarno,FI,64,8,95,12,4,119,11,124,10,19,164
2020,48052,Figline e Incisa Valdarno,FI,65,19,109,5,4,137,15,132,4,14,165
2020,48052,Figline e Incisa Valdarno,FI,66,6,136,14,2,158,8,103,10,22,143
2020,48052,Figline e Incisa Valdarno,FI,67,13,135,8,7,163,13,117,11,19,160
2020,48052,Figline e Incisa Valdarno,FI,68,8,104,12,6,130,10,107,4,19,140
2020,48052,Figline e Incisa Valdarno,FI,69,12,111,8,1,132,6,99,8,24,137
2020,48052,Figline e Incisa Valdarno,FI,70,10,126,11,3,150,10,105,9,22,146
2020,48052,Figline e Incisa Valdarno,FI,71,9,109,5,7,130,6,104,6,47,163
2020,48052,Figline e Incisa Valdarno,FI,72,5,120,5,6,136,6,120,7,48,181
2020,48052,Figline e Incisa Valdarno,FI,73,11,121,5,6,143,7,104,5,36,152
2020,48052,Figline e Incisa Valdarno,FI,74,8,117,7,15,147,3,89,8,35,135
2020,48052,Figline e Incisa Valdarno,FI,75,8,96,4,5,113,4,74,0,45,123
2020,48052,Figline e Incisa Valdarno,FI,76,9,80,5,7,101,8,76,3,36,123
2020,48052,Figline e Incisa Valdarno,FI,77,7,88,3,13,111,4,75,3,41,123
2020,48052,Figline e Incisa Valdarno,FI,78,8,71,3,9,91,5,54,2,47,108
2020,48052,Figline e Incisa Valdarno,FI,79,13,71,0,11,95,9,67,4,37,117
2020,48052,Figline e Incisa Valdarno,FI,80,6,99,6,14,125,3,57,4,66,130
2020,48052,Figline e Incisa Valdarno,FI,81,8,68,1,19,96,6,65,1,70,142
2020,48052,Figline e Incisa Valdarno,FI,82,3,64,1,9,77,7,42,2,50,101
2020,48052,Figline e Incisa Valdarno,FI,83,7,56,1,17,81,6,36,2,57,101
2020,48052,Figline e Incisa Valdarno,FI,84,6,40,0,25,71,3,17,0,74,94
2020,48052,Figline e Incisa Valdarno,FI,85,6,49,2,11,68,3,24,2,50,79
2020,48052,Figline e Incisa Valdarno,FI,86,2,30,0,4,36,4,26,0,56,86
2020,48052,Figline e Incisa Valdarno,FI,87,2,32,0,12,46,3,22,0,53,78
2020,48052,Figline e Incisa Valdarno,FI,88,5,13,0,12,30,0,12,0,58,70
2020,48052,Figline e Incisa Valdarno,FI,89,5,19,0,9,33,6,3,0,61,70
2020,48052,Figline e Incisa Valdarno,FI,90,3,19,0,10,32,6,8,2,43,59
2020,48052,Figline e Incisa Valdarno,FI,91,1,15,0,4,20,2,3,0,44,49
2020,48052,Figline e Incisa Valdarno,FI,92,3,6,0,7,16,4,1,0,30,35
2020,48052,Figline e Incisa Valdarno,FI,93,0,5,0,6,11,1,0,0,24,25
2020,48052,Figline e Incisa Valdarno,FI,94,0,3,0,7,10,4,2,0,22,28
2020,48052,Figline e Incisa Valdarno,FI,95,0,2,0,1,3,1,0,0,19,20
2020,48052,Figline e Incisa Valdarno,FI,96,0,0,0,5,5,0,0,0,9,9
2020,48052,Figline e Incisa Valdarno,FI,97,0,0,0,3,3,0,0,0,13,13
2020,48052,Figline e Incisa Valdarno,FI,98,0,1,0,2,3,0,0,0,8,8
2020,48052,Figline e Incisa Valdarno,FI,99,1,0,0,3,4,0,0,0,3,3
2020,48052,Figline e Incisa Valdarno,FI,100 e più,0,0,0,0,0,0,0,0,6,6
2020,48053,Scarperia e San Piero,FI,0,40,0,0,0,40,37,0,0,0,37
2020,48053,Scarperia e San Piero,FI,1,45,0,0,0,45,45,0,0,0,45
2020,48053,Scarperia e San Piero,FI,2,48,0,0,0,48,39,0,0,0,39
2020,48053,Scarperia e San Piero,FI,3,53,0,0,0,53,41,0,0,0,41
2020,48053,Scarperia e San Piero,FI,4,48,0,0,0,48,46,0,0,0,46
2020,48053,Scarperia e San Piero,FI,5,50,0,0,0,50,44,0,0,0,44
2020,48053,Scarperia e San Piero,FI,6,57,0,0,0,57,46,0,0,0,46
2020,48053,Scarperia e San Piero,FI,7,62,0,0,0,62,58,0,0,0,58
2020,48053,Scarperia e San Piero,FI,8,53,0,0,0,53,49,0,0,0,49
2020,48053,Scarperia e San Piero,FI,9,55,0,0,0,55,64,0,0,0,64
2020,48053,Scarperia e San Piero,FI,10,65,0,0,0,65,59,0,0,0,59
2020,48053,Scarperia e San Piero,FI,11,49,0,0,0,49,51,0,0,0,51
2020,48053,Scarperia e San Piero,FI,12,64,0,0,0,64,39,0,0,0,39
2020,48053,Scarperia e San Piero,FI,13,42,0,0,0,42,59,0,0,0,59
2020,48053,Scarperia e San Piero,FI,14,63,0,0,0,63,76,0,0,0,76
2020,48053,Scarperia e San Piero,FI,15,55,0,0,0,55,58,0,0,0,58
2020,48053,Scarperia e San Piero,FI,16,62,0,0,0,62,71,0,0,0,71
2020,48053,Scarperia e San Piero,FI,17,66,0,0,0,66,44,0,0,0,44
2020,48053,Scarperia e San Piero,FI,18,58,0,0,0,58,51,0,0,0,51
2020,48053,Scarperia e San Piero,FI,19,51,0,0,0,51,48,0,0,0,48
2020,48053,Scarperia e San Piero,FI,20,81,0,0,0,81,58,1,0,0,59
2020,48053,Scarperia e San Piero,FI,21,62,0,0,0,62,42,1,0,0,43
2020,48053,Scarperia e San Piero,FI,22,62,0,0,0,62,55,1,0,0,56
2020,48053,Scarperia e San Piero,FI,23,69,0,0,0,69,68,1,0,0,69
2020,48053,Scarperia e San Piero,FI,24,69,2,0,0,71,50,6,0,0,56
2020,48053,Scarperia e San Piero,FI,25,58,0,0,0,58,62,7,0,0,69
2020,48053,Scarperia e San Piero,FI,26,68,1,1,0,70,52,9,0,0,61
2020,48053,Scarperia e San Piero,FI,27,56,4,0,0,60,39,10,0,0,49
2020,48053,Scarperia e San Piero,FI,28,49,2,0,0,51,46,14,0,0,60
2020,48053,Scarperia e San Piero,FI,29,51,9,0,0,60,46,11,0,0,57
2020,48053,Scarperia e San Piero,FI,30,69,11,0,0,80,40,15,0,1,56
2020,48053,Scarperia e San Piero,FI,31,45,12,1,0,58,46,17,0,1,64
2020,48053,Scarperia e San Piero,FI,32,48,13,0,0,61,39,20,1,0,60
2020,48053,Scarperia e San Piero,FI,33,50,12,0,0,62,35,31,1,0,67
2020,48053,Scarperia e San Piero,FI,34,40,16,0,0,56,30,33,1,0,64
2020,48053,Scarperia e San Piero,FI,35,41,26,1,0,68,43,34,0,0,77
2020,48053,Scarperia e San Piero,FI,36,27,18,0,0,45,34,39,2,0,75
2020,48053,Scarperia e San Piero,FI,37,36,34,1,0,71,31,34,0,0,65
2020,48053,Scarperia e San Piero,FI,38,39,34,1,0,74,31,25,2,0,58
2020,48053,Scarperia e San Piero,FI,39,37,33,1,0,71,32,31,2,0,65
2020,48053,Scarperia e San Piero,FI,40,27,39,1,0,67,34,43,2,0,79
2020,48053,Scarperia e San Piero,FI,41,35,40,2,0,77,29,46,5,0,80
2020,48053,Scarperia e San Piero,FI,42,37,38,1,0,76,20,42,6,1,69
2020,48053,Scarperia e San Piero,FI,43,37,46,2,0,85,31,59,5,0,95
2020,48053,Scarperia e San Piero,FI,44,47,43,4,0,94,26,71,6,0,103
2020,48053,Scarperia e San Piero,FI,45,38,63,3,0,104,25,69,5,0,99
2020,48053,Scarperia e San Piero,FI,46,37,70,6,0,113,34,60,4,1,99
2020,48053,Scarperia e San Piero,FI,47,35,59,4,0,98,30,58,5,1,94
2020,48053,Scarperia e San Piero,FI,48,23,49,3,0,75,25,51,9,0,85
2020,48053,Scarperia e San Piero,FI,49,38,63,3,0,104,18,62,7,2,89
2020,48053,Scarperia e San Piero,FI,50,24,61,5,1,91,18,67,6,2,93
2020,48053,Scarperia e San Piero,FI,51,26,58,6,1,91,16,64,12,1,93
2020,48053,Scarperia e San Piero,FI,52,25,54,8,0,87,10,73,11,0,94
2020,48053,Scarperia e San Piero,FI,53,23,63,6,1,93,13,64,5,2,84
2020,48053,Scarperia e San Piero,FI,54,27,79,8,1,115,17,70,9,3,99
2020,48053,Scarperia e San Piero,FI,55,14,57,8,2,81,11,71,9,1,92
2020,48053,Scarperia e San Piero,FI,56,19,59,8,0,86,18,86,9,6,119
2020,48053,Scarperia e San Piero,FI,57,19,73,9,1,102,12,78,11,3,104
2020,48053,Scarperia e San Piero,FI,58,11,70,5,0,86,10,79,7,3,99
2020,48053,Scarperia e San Piero,FI,59,23,77,14,0,114,10,74,15,7,106
2020,48053,Scarperia e San Piero,FI,60,10,76,11,3,100,8,64,4,7,83
2020,48053,Scarperia e San Piero,FI,61,16,56,8,2,82,10,61,13,11,95
2020,48053,Scarperia e San Piero,FI,62,12,70,2,4,88,4,67,13,3,87
2020,48053,Scarperia e San Piero,FI,63,5,75,7,1,88,4,88,3,6,101
2020,48053,Scarperia e San Piero,FI,64,8,62,5,1,76,4,49,2,13,68
2020,48053,Scarperia e San Piero,FI,65,8,69,5,2,84,1,57,4,12,74
2020,48053,Scarperia e San Piero,FI,66,2,57,1,1,61,8,64,4,7,83
2020,48053,Scarperia e San Piero,FI,67,8,59,2,2,71,2,61,4,12,79
2020,48053,Scarperia e San Piero,FI,68,8,67,5,1,81,3,64,4,9,80
2020,48053,Scarperia e San Piero,FI,69,5,62,6,1,74,5,47,3,12,67
2020,48053,Scarperia e San Piero,FI,70,5,57,7,4,73,3,46,6,8,63
2020,48053,Scarperia e San Piero,FI,71,5,56,2,4,67,4,50,2,16,72
2020,48053,Scarperia e San Piero,FI,72,4,64,1,3,72,2,40,3,10,55
2020,48053,Scarperia e San Piero,FI,73,8,52,1,7,68,3,56,1,19,79
2020,48053,Scarperia e San Piero,FI,74,4,67,2,3,76,0,44,3,21,68
2020,48053,Scarperia e San Piero,FI,75,4,32,0,5,41,3,35,2,21,61
2020,48053,Scarperia e San Piero,FI,76,3,30,4,4,41,4,32,3,19,58
2020,48053,Scarperia e San Piero,FI,77,4,33,0,5,42,0,34,2,31,67
2020,48053,Scarperia e San Piero,FI,78,6,36,1,4,47,3,22,0,22,47
2020,48053,Scarperia e San Piero,FI,79,5,32,1,3,41,3,25,0,24,52
2020,48053,Scarperia e San Piero,FI,80,4,42,2,4,52,3,21,1,24,49
2020,48053,Scarperia e San Piero,FI,81,4,21,1,8,34,3,22,0,36,61
2020,48053,Scarperia e San Piero,FI,82,1,36,0,11,48,2,29,2,40,73
2020,48053,Scarperia e San Piero,FI,83,5,23,1,8,37,1,10,0,20,31
2020,48053,Scarperia e San Piero,FI,84,2,22,0,10,34,0,12,0,19,31
2020,48053,Scarperia e San Piero,FI,85,4,18,0,6,28,1,12,2,22,37
2020,48053,Scarperia e San Piero,FI,86,1,14,0,2,17,1,10,0,30,41
2020,48053,Scarperia e San Piero,FI,87,0,13,1,1,15,1,6,1,24,32
2020,48053,Scarperia e San Piero,FI,88,1,14,0,8,23,2,4,0,24,30
2020,48053,Scarperia e San Piero,FI,89,2,9,0,3,14,2,5,0,20,27
2020,48053,Scarperia e San Piero,FI,90,0,9,0,3,12,2,2,1,25,30
2020,48053,Scarperia e San Piero,FI,91,2,8,0,1,11,0,3,1,24,28
2020,48053,Scarperia e San Piero,FI,92,0,4,0,0,4,1,0,1,26,28
2020,48053,Scarperia e San Piero,FI,93,0,6,0,2,8,0,2,0,15,17
2020,48053,Scarperia e San Piero,FI,94,0,0,0,2,2,1,1,0,13,15
2020,48053,Scarperia e San Piero,FI,95,1,0,0,0,1,0,0,0,6,6
2020,48053,Scarperia e San Piero,FI,96,0,3,0,2,5,1,0,0,6,7
2020,48053,Scarperia e San Piero,FI,97,0,0,0,1,1,0,0,0,5,5
2020,48053,Scarperia e San Piero,FI,98,0,0,0,2,2,0,0,0,8,8
2020,48053,Scarperia e San Piero,FI,99,0,0,0,1,1,0,0,0,2,2
2020,48053,Scarperia e San Piero,FI,100 e più,0,0,0,2,2,0,0,0,5,5
2020,48054,Barberino Tavarnelle,FI,0,49,0,0,0,49,32,0,0,0,32
2020,48054,Barberino Tavarnelle,FI,1,34,0,0,0,34,30,0,0,0,30
2020,48054,Barberino Tavarnelle,FI,2,32,0,0,0,32,45,0,0,0,45
2020,48054,Barberino Tavarnelle,FI,3,42,0,0,0,42,43,0,0,0,43
2020,48054,Barberino Tavarnelle,FI,4,39,0,0,0,39,38,0,0,0,38
2020,48054,Barberino Tavarnelle,FI,5,50,0,0,0,50,45,0,0,0,45
2020,48054,Barberino Tavarnelle,FI,6,45,0,0,0,45,42,0,0,0,42
2020,48054,Barberino Tavarnelle,FI,7,61,0,0,0,61,56,0,0,0,56
2020,48054,Barberino Tavarnelle,FI,8,61,0,0,0,61,56,0,0,0,56
2020,48054,Barberino Tavarnelle,FI,9,46,0,0,0,46,44,0,0,0,44
2020,48054,Barberino Tavarnelle,FI,10,70,0,0,0,70,55,0,0,0,55
2020,48054,Barberino Tavarnelle,FI,11,66,0,0,0,66,60,0,0,0,60
2020,48054,Barberino Tavarnelle,FI,12,54,0,0,0,54,70,0,0,0,70
2020,48054,Barberino Tavarnelle,FI,13,56,0,0,0,56,57,0,0,0,57
2020,48054,Barberino Tavarnelle,FI,14,66,0,0,0,66,53,0,0,0,53
2020,48054,Barberino Tavarnelle,FI,15,66,0,0,0,66,61,0,0,0,61
2020,48054,Barberino Tavarnelle,FI,16,77,0,0,0,77,58,0,0,0,58
2020,48054,Barberino Tavarnelle,FI,17,54,0,0,0,54,67,0,0,0,67
2020,48054,Barberino Tavarnelle,FI,18,51,0,0,0,51,60,0,0,0,60
2020,48054,Barberino Tavarnelle,FI,19,51,0,0,0,51,59,0,0,0,59
2020,48054,Barberino Tavarnelle,FI,20,49,0,0,0,49,50,1,0,0,51
2020,48054,Barberino Tavarnelle,FI,21,67,1,0,0,68,37,2,0,0,39
2020,48054,Barberino Tavarnelle,FI,22,67,0,0,0,67,51,1,0,0,52
2020,48054,Barberino Tavarnelle,FI,23,64,1,0,0,65,43,1,0,0,44
2020,48054,Barberino Tavarnelle,FI,24,49,1,0,0,50,56,3,0,0,59
2020,48054,Barberino Tavarnelle,FI,25,66,0,0,0,66,47,2,0,0,49
2020,48054,Barberino Tavarnelle,FI,26,61,0,0,0,61,44,3,0,0,47
2020,48054,Barberino Tavarnelle,FI,27,57,1,0,0,58,42,8,0,0,50
2020,48054,Barberino Tavarnelle,FI,28,53,0,0,0,53,41,7,0,0,48
2020,48054,Barberino Tavarnelle,FI,29,47,3,0,0,50,39,5,1,0,45
2020,48054,Barberino Tavarnelle,FI,30,45,7,1,0,53,35,13,1,0,49
2020,48054,Barberino Tavarnelle,FI,31,40,6,0,0,46,37,13,0,0,50
2020,48054,Barberino Tavarnelle,FI,32,47,15,0,0,62,50,16,1,0,67
2020,48054,Barberino Tavarnelle,FI,33,45,14,2,0,61,22,29,0,0,51
2020,48054,Barberino Tavarnelle,FI,34,36,17,0,0,53,19,24,0,0,43
2020,48054,Barberino Tavarnelle,FI,35,34,20,0,0,54,25,40,2,0,67
2020,48054,Barberino Tavarnelle,FI,36,38,26,0,0,64,24,29,1,0,54
2020,48054,Barberino Tavarnelle,FI,37,46,26,1,0,73,28,35,0,0,63
2020,48054,Barberino Tavarnelle,FI,38,48,26,2,0,76,26,27,4,0,57
2020,48054,Barberino Tavarnelle,FI,39,41,31,1,0,73,30,38,2,0,70
2020,48054,Barberino Tavarnelle,FI,40,34,34,3,0,71,23,40,3,0,66
2020,48054,Barberino Tavarnelle,FI,41,41,35,0,0,76,16,53,3,0,72
2020,48054,Barberino Tavarnelle,FI,42,31,47,5,0,83,30,50,2,0,82
2020,48054,Barberino Tavarnelle,FI,43,33,44,1,0,78,23,49,2,1,75
2020,48054,Barberino Tavarnelle,FI,44,38,53,3,0,94,28,66,5,1,100
2020,48054,Barberino Tavarnelle,FI,45,39,58,2,1,100,35,82,2,0,119
2020,48054,Barberino Tavarnelle,FI,46,31,61,1,0,93,15,65,2,2,84
2020,48054,Barberino Tavarnelle,FI,47,31,68,2,0,101,25,69,5,2,101
2020,48054,Barberino Tavarnelle,FI,48,33,75,6,1,115,18,65,3,2,88
2020,48054,Barberino Tavarnelle,FI,49,27,70,4,0,101,15,86,5,0,106
2020,48054,Barberino Tavarnelle,FI,50,20,70,5,0,95,21,47,2,0,70
2020,48054,Barberino Tavarnelle,FI,51,20,66,5,1,92,16,67,6,1,90
2020,48054,Barberino Tavarnelle,FI,52,23,69,5,0,97,14,56,7,1,78
2020,48054,Barberino Tavarnelle,FI,53,22,69,5,2,98,12,78,13,2,105
2020,48054,Barberino Tavarnelle,FI,54,16,57,5,1,79,15,75,5,3,98
2020,48054,Barberino Tavarnelle,FI,55,24,68,2,0,94,11,88,6,4,109
2020,48054,Barberino Tavarnelle,FI,56,18,82,4,4,108,5,91,3,0,99
2020,48054,Barberino Tavarnelle,FI,57,18,79,3,2,102,10,66,12,5,93
2020,48054,Barberino Tavarnelle,FI,58,8,58,8,2,76,5,85,7,5,102
2020,48054,Barberino Tavarnelle,FI,59,8,68,7,1,84,8,82,5,9,104
2020,48054,Barberino Tavarnelle,FI,60,10,79,4,3,96,8,73,3,4,88
2020,48054,Barberino Tavarnelle,FI,61,14,68,3,0,85,3,58,5,3,69
2020,48054,Barberino Tavarnelle,FI,62,9,77,4,1,91,7,60,5,5,77
2020,48054,Barberino Tavarnelle,FI,63,10,64,3,1,78,5,68,5,4,82
2020,48054,Barberino Tavarnelle,FI,64,14,72,3,2,91,5,76,8,8,97
2020,48054,Barberino Tavarnelle,FI,65,10,66,3,2,81,6,64,7,14,91
2020,48054,Barberino Tavarnelle,FI,66,12,61,6,2,81,10,72,3,10,95
2020,48054,Barberino Tavarnelle,FI,67,4,50,4,1,59,8,52,2,10,72
2020,48054,Barberino Tavarnelle,FI,68,12,53,2,4,71,5,67,3,13,88
2020,48054,Barberino Tavarnelle,FI,69,8,62,3,4,77,4,53,0,10,67
2020,48054,Barberino Tavarnelle,FI,70,5,55,3,0,63,1,54,2,11,68
2020,48054,Barberino Tavarnelle,FI,71,6,55,1,2,64,4,53,3,13,73
2020,48054,Barberino Tavarnelle,FI,72,2,65,3,6,76,1,58,2,23,84
2020,48054,Barberino Tavarnelle,FI,73,4,68,2,2,76,3,50,0,9,62
2020,48054,Barberino Tavarnelle,FI,74,1,61,2,7,71,2,48,2,16,68
2020,48054,Barberino Tavarnelle,FI,75,2,48,1,4,55,4,36,2,15,57
2020,48054,Barberino Tavarnelle,FI,76,3,47,1,9,60,1,24,0,19,44
2020,48054,Barberino Tavarnelle,FI,77,0,40,3,2,45,1,32,2,28,63
2020,48054,Barberino Tavarnelle,FI,78,2,44,3,5,54,1,36,2,24,63
2020,48054,Barberino Tavarnelle,FI,79,4,37,1,5,47,2,27,0,12,41
2020,48054,Barberino Tavarnelle,FI,80,5,43,0,9,57,3,43,0,38,84
2020,48054,Barberino Tavarnelle,FI,81,2,31,1,9,43,3,30,2,38,73
2020,48054,Barberino Tavarnelle,FI,82,5,31,2,5,43,3,23,2,36,64
2020,48054,Barberino Tavarnelle,FI,83,4,34,0,7,45,1,21,3,24,49
2020,48054,Barberino Tavarnelle,FI,84,2,23,1,7,33,2,16,2,23,43
2020,48054,Barberino Tavarnelle,FI,85,7,36,1,5,49,1,7,1,34,43
2020,48054,Barberino Tavarnelle,FI,86,2,25,1,3,31,2,9,1,22,34
2020,48054,Barberino Tavarnelle,FI,87,1,19,1,10,31,2,7,0,27,36
2020,48054,Barberino Tavarnelle,FI,88,1,12,0,8,21,2,8,3,34,47
2020,48054,Barberino Tavarnelle,FI,89,1,10,0,2,13,1,3,0,26,30
2020,48054,Barberino Tavarnelle,FI,90,2,13,0,6,21,1,3,0,20,24
2020,48054,Barberino Tavarnelle,FI,91,2,5,0,6,13,0,2,1,13,16
2020,48054,Barberino Tavarnelle,FI,92,0,3,0,3,6,2,0,0,14,16
2020,48054,Barberino Tavarnelle,FI,93,0,2,0,4,6,1,0,0,15,16
2020,48054,Barberino Tavarnelle,FI,94,2,3,0,5,10,0,1,0,14,15
2020,48054,Barberino Tavarnelle,FI,95,1,0,0,0,1,0,1,0,9,10
2020,48054,Barberino Tavarnelle,FI,96,1,0,0,2,3,1,0,0,3,4
2020,48054,Barberino Tavarnelle,FI,97,0,1,0,0,1,0,0,0,4,4
2020,48054,Barberino Tavarnelle,FI,98,0,0,0,1,1,0,0,0,2,2
2020,48054,Barberino Tavarnelle,FI,99,0,0,0,0,0,2,0,0,2,4
2020,48054,Barberino Tavarnelle,FI,100 e più,0,0,0,0,0,0,0,0,5,5
2020,53001,Arcidosso,GR,0,14,0,0,0,14,8,0,0,0,8
2020,53001,Arcidosso,GR,1,15,0,0,0,15,13,0,0,0,13
2020,53001,Arcidosso,GR,2,14,0,0,0,14,8,0,0,0,8
2020,53001,Arcidosso,GR,3,10,0,0,0,10,14,0,0,0,14
2020,53001,Arcidosso,GR,4,17,0,0,0,17,14,0,0,0,14
2020,53001,Arcidosso,GR,5,7,0,0,0,7,18,0,0,0,18
2020,53001,Arcidosso,GR,6,11,0,0,0,11,16,0,0,0,16
2020,53001,Arcidosso,GR,7,17,0,0,0,17,13,0,0,0,13
2020,53001,Arcidosso,GR,8,12,0,0,0,12,16,0,0,0,16
2020,53001,Arcidosso,GR,9,26,0,0,0,26,18,0,0,0,18
2020,53001,Arcidosso,GR,10,16,0,0,0,16,19,0,0,0,19
2020,53001,Arcidosso,GR,11,16,0,0,0,16,22,0,0,0,22
2020,53001,Arcidosso,GR,12,19,0,0,0,19,19,0,0,0,19
2020,53001,Arcidosso,GR,13,24,0,0,0,24,17,0,0,0,17
2020,53001,Arcidosso,GR,14,26,0,0,0,26,16,0,0,0,16
2020,53001,Arcidosso,GR,15,14,0,0,0,14,14,0,0,0,14
2020,53001,Arcidosso,GR,16,18,0,0,0,18,18,0,0,0,18
2020,53001,Arcidosso,GR,17,22,0,0,0,22,22,0,0,0,22
2020,53001,Arcidosso,GR,18,16,0,0,0,16,17,0,0,0,17
2020,53001,Arcidosso,GR,19,17,0,0,0,17,20,0,0,0,20
2020,53001,Arcidosso,GR,20,20,0,0,0,20,17,1,0,0,18
2020,53001,Arcidosso,GR,21,19,1,0,0,20,16,4,0,0,20
2020,53001,Arcidosso,GR,22,17,0,0,0,17,17,2,0,0,19
2020,53001,Arcidosso,GR,23,27,1,0,0,28,15,5,0,0,20
2020,53001,Arcidosso,GR,24,18,0,0,0,18,8,3,0,0,11
2020,53001,Arcidosso,GR,25,19,2,0,0,21,11,6,0,0,17
2020,53001,Arcidosso,GR,26,18,0,0,0,18,17,6,0,0,23
2020,53001,Arcidosso,GR,27,22,3,0,0,25,11,2,0,0,13
2020,53001,Arcidosso,GR,28,23,0,0,0,23,8,1,0,0,9
2020,53001,Arcidosso,GR,29,18,3,0,0,21,19,8,0,0,27
2020,53001,Arcidosso,GR,30,25,2,0,0,27,13,4,0,0,17
2020,53001,Arcidosso,GR,31,23,4,0,0,27,11,8,1,0,20
2020,53001,Arcidosso,GR,32,23,6,0,0,29,13,11,0,0,24
2020,53001,Arcidosso,GR,33,25,7,0,0,32,9,10,0,0,19
2020,53001,Arcidosso,GR,34,19,14,0,0,33,12,14,0,0,26
2020,53001,Arcidosso,GR,35,26,5,0,0,31,10,10,2,0,22
2020,53001,Arcidosso,GR,36,13,15,1,0,29,4,11,2,0,17
2020,53001,Arcidosso,GR,37,18,10,1,0,29,8,14,0,0,22
2020,53001,Arcidosso,GR,38,16,12,1,0,29,5,15,0,0,20
2020,53001,Arcidosso,GR,39,11,17,1,0,29,9,14,2,0,25
2020,53001,Arcidosso,GR,40,23,20,0,0,43,3,18,2,0,23
2020,53001,Arcidosso,GR,41,17,19,2,0,38,10,18,0,0,28
2020,53001,Arcidosso,GR,42,15,20,2,0,37,7,15,4,0,26
2020,53001,Arcidosso,GR,43,15,21,0,0,36,7,9,1,1,18
2020,53001,Arcidosso,GR,44,10,20,1,0,31,14,10,3,0,27
2020,53001,Arcidosso,GR,45,18,13,1,2,34,5,28,2,0,35
2020,53001,Arcidosso,GR,46,11,17,2,0,30,5,21,6,1,33
2020,53001,Arcidosso,GR,47,12,20,2,0,34,11,20,3,1,35
2020,53001,Arcidosso,GR,48,12,28,1,0,41,13,25,2,0,40
2020,53001,Arcidosso,GR,49,7,19,3,0,29,10,14,2,2,28
2020,53001,Arcidosso,GR,50,13,15,4,1,33,7,26,3,0,36
2020,53001,Arcidosso,GR,51,11,25,0,0,36,10,24,6,1,41
2020,53001,Arcidosso,GR,52,9,24,3,0,36,10,17,7,0,34
2020,53001,Arcidosso,GR,53,9,19,2,0,30,1,29,4,0,34
2020,53001,Arcidosso,GR,54,8,27,2,1,38,7,23,3,0,33
2020,53001,Arcidosso,GR,55,10,30,5,0,45,5,26,5,2,38
2020,53001,Arcidosso,GR,56,9,23,2,0,34,7,26,6,0,39
2020,53001,Arcidosso,GR,57,5,28,4,0,37,6,30,2,4,42
2020,53001,Arcidosso,GR,58,6,17,4,1,28,4,27,7,2,40
2020,53001,Arcidosso,GR,59,1,23,4,0,28,0,23,2,4,29
2020,53001,Arcidosso,GR,60,1,23,1,2,27,2,25,5,0,32
2020,53001,Arcidosso,GR,61,2,21,3,0,26,5,24,5,1,35
2020,53001,Arcidosso,GR,62,3,27,3,0,33,0,24,2,3,29
2020,53001,Arcidosso,GR,63,3,18,3,1,25,3,28,0,4,35
2020,53001,Arcidosso,GR,64,2,17,4,1,24,4,18,2,4,28
2020,53001,Arcidosso,GR,65,1,20,1,0,22,2,25,1,3,31
2020,53001,Arcidosso,GR,66,2,26,2,1,31,0,17,2,6,25
2020,53001,Arcidosso,GR,67,2,20,0,0,22,1,10,2,3,16
2020,53001,Arcidosso,GR,68,2,22,1,0,25,3,14,1,6,24
2020,53001,Arcidosso,GR,69,3,11,1,0,15,2,17,1,5,25
2020,53001,Arcidosso,GR,70,5,21,0,5,31,1,8,2,4,15
2020,53001,Arcidosso,GR,71,6,18,0,3,27,2,21,3,7,33
2020,53001,Arcidosso,GR,72,2,18,0,2,22,2,18,1,6,27
2020,53001,Arcidosso,GR,73,0,27,1,2,30,0,28,1,8,37
2020,53001,Arcidosso,GR,74,0,22,2,2,26,4,14,0,8,26
2020,53001,Arcidosso,GR,75,3,15,0,4,22,1,9,2,9,21
2020,53001,Arcidosso,GR,76,0,5,0,0,5,1,12,0,6,19
2020,53001,Arcidosso,GR,77,1,12,1,2,16,1,7,1,11,20
2020,53001,Arcidosso,GR,78,0,12,0,1,13,1,8,0,9,18
2020,53001,Arcidosso,GR,79,0,17,0,1,18,0,5,0,9,14
2020,53001,Arcidosso,GR,80,4,12,0,1,17,1,16,0,8,25
2020,53001,Arcidosso,GR,81,1,11,0,3,15,1,10,3,15,29
2020,53001,Arcidosso,GR,82,2,8,0,2,12,0,6,0,13,19
2020,53001,Arcidosso,GR,83,0,12,0,3,15,0,11,0,15,26
2020,53001,Arcidosso,GR,84,1,9,0,1,11,0,7,0,18,25
2020,53001,Arcidosso,GR,85,3,9,0,2,14,3,6,1,11,21
2020,53001,Arcidosso,GR,86,2,3,0,3,8,0,3,0,18,21
2020,53001,Arcidosso,GR,87,1,7,0,3,11,0,4,0,20,24
2020,53001,Arcidosso,GR,88,0,4,0,0,4,0,1,0,10,11
2020,53001,Arcidosso,GR,89,0,5,0,0,5,1,1,0,16,18
2020,53001,Arcidosso,GR,90,0,4,0,5,9,0,1,1,13,15
2020,53001,Arcidosso,GR,91,0,2,0,4,6,0,0,0,10,10
2020,53001,Arcidosso,GR,92,0,1,0,2,3,0,1,0,9,10
2020,53001,Arcidosso,GR,93,0,1,0,0,1,1,1,0,5,7
2020,53001,Arcidosso,GR,94,0,1,0,1,2,1,0,0,6,7
2020,53001,Arcidosso,GR,95,0,0,0,3,3,0,0,0,5,5
2020,53001,Arcidosso,GR,96,0,0,0,1,1,0,0,0,3,3
2020,53001,Arcidosso,GR,97,0,1,0,0,1,0,0,0,5,5
2020,53001,Arcidosso,GR,98,0,0,0,0,0,0,0,0,2,2
2020,53001,Arcidosso,GR,99,0,0,0,0,0,0,0,0,1,1
2020,53001,Arcidosso,GR,100 e più,0,0,0,0,0,0,0,0,5,5
2020,53002,Campagnatico,GR,0,7,0,0,0,7,8,0,0,0,8
2020,53002,Campagnatico,GR,1,9,0,0,0,9,5,0,0,0,5
2020,53002,Campagnatico,GR,2,3,0,0,0,3,8,0,0,0,8
2020,53002,Campagnatico,GR,3,5,0,0,0,5,10,0,0,0,10
2020,53002,Campagnatico,GR,4,12,0,0,0,12,7,0,0,0,7
2020,53002,Campagnatico,GR,5,15,0,0,0,15,2,0,0,0,2
2020,53002,Campagnatico,GR,6,6,0,0,0,6,6,0,0,0,6
2020,53002,Campagnatico,GR,7,7,0,0,0,7,6,0,0,0,6
2020,53002,Campagnatico,GR,8,13,0,0,0,13,9,0,0,0,9
2020,53002,Campagnatico,GR,9,7,0,0,0,7,5,0,0,0,5
2020,53002,Campagnatico,GR,10,10,0,0,0,10,12,0,0,0,12
2020,53002,Campagnatico,GR,11,11,0,0,0,11,6,0,0,0,6
2020,53002,Campagnatico,GR,12,10,0,0,0,10,7,0,0,0,7
2020,53002,Campagnatico,GR,13,10,0,0,0,10,9,0,0,0,9
2020,53002,Campagnatico,GR,14,7,0,0,0,7,5,0,0,0,5
2020,53002,Campagnatico,GR,15,4,0,0,0,4,9,0,0,0,9
2020,53002,Campagnatico,GR,16,14,0,0,0,14,10,0,0,0,10
2020,53002,Campagnatico,GR,17,8,0,0,0,8,6,0,0,0,6
2020,53002,Campagnatico,GR,18,11,0,0,0,11,8,0,0,0,8
2020,53002,Campagnatico,GR,19,6,0,0,0,6,7,0,0,0,7
2020,53002,Campagnatico,GR,20,14,0,0,0,14,6,0,0,0,6
2020,53002,Campagnatico,GR,21,14,0,0,0,14,6,0,0,0,6
2020,53002,Campagnatico,GR,22,7,0,0,0,7,3,1,0,0,4
2020,53002,Campagnatico,GR,23,10,0,0,0,10,9,0,0,0,9
2020,53002,Campagnatico,GR,24,12,0,0,0,12,6,1,0,0,7
2020,53002,Campagnatico,GR,25,12,0,0,0,12,9,2,0,0,11
2020,53002,Campagnatico,GR,26,17,1,0,0,18,8,2,0,0,10
2020,53002,Campagnatico,GR,27,10,2,0,0,12,10,2,0,0,12
2020,53002,Campagnatico,GR,28,15,2,0,0,17,8,4,0,0,12
2020,53002,Campagnatico,GR,29,5,0,0,0,5,9,3,0,0,12
2020,53002,Campagnatico,GR,30,14,4,0,0,18,10,1,0,0,11
2020,53002,Campagnatico,GR,31,13,3,0,0,16,5,2,0,0,7
2020,53002,Campagnatico,GR,32,6,2,0,0,8,7,7,0,0,14
2020,53002,Campagnatico,GR,33,9,4,1,0,14,3,1,0,0,4
2020,53002,Campagnatico,GR,34,10,5,0,0,15,3,4,0,0,7
2020,53002,Campagnatico,GR,35,5,5,0,0,10,7,2,0,0,9
2020,53002,Campagnatico,GR,36,12,4,0,0,16,6,7,0,0,13
2020,53002,Campagnatico,GR,37,8,4,0,0,12,5,6,1,0,12
2020,53002,Campagnatico,GR,38,9,3,3,0,15,7,8,0,0,15
2020,53002,Campagnatico,GR,39,8,10,0,0,18,4,5,0,0,9
2020,53002,Campagnatico,GR,40,11,9,2,0,22,6,7,3,0,16
2020,53002,Campagnatico,GR,41,8,1,0,0,9,4,6,0,0,10
2020,53002,Campagnatico,GR,42,9,10,0,0,19,5,12,1,0,18
2020,53002,Campagnatico,GR,43,8,13,2,1,24,8,9,1,0,18
2020,53002,Campagnatico,GR,44,9,8,2,0,19,8,10,0,1,19
2020,53002,Campagnatico,GR,45,12,6,0,0,18,3,8,2,0,13
2020,53002,Campagnatico,GR,46,7,8,0,0,15,2,13,4,1,20
2020,53002,Campagnatico,GR,47,3,11,2,0,16,8,8,1,0,17
2020,53002,Campagnatico,GR,48,11,11,1,0,23,2,13,1,0,16
2020,53002,Campagnatico,GR,49,10,19,2,0,31,6,10,3,0,19
2020,53002,Campagnatico,GR,50,6,4,2,0,12,4,10,1,0,15
2020,53002,Campagnatico,GR,51,6,16,1,0,23,2,16,1,0,19
2020,53002,Campagnatico,GR,52,6,17,1,0,24,9,15,3,1,28
2020,53002,Campagnatico,GR,53,5,15,2,0,22,3,15,0,0,18
2020,53002,Campagnatico,GR,54,4,9,3,1,17,0,12,2,1,15
2020,53002,Campagnatico,GR,55,3,15,0,0,18,3,11,0,3,17
2020,53002,Campagnatico,GR,56,3,12,0,0,15,3,15,3,0,21
2020,53002,Campagnatico,GR,57,4,18,3,0,25,0,9,0,2,11
2020,53002,Campagnatico,GR,58,4,13,2,0,19,2,12,2,1,17
2020,53002,Campagnatico,GR,59,2,10,1,0,13,1,20,2,1,24
2020,53002,Campagnatico,GR,60,1,12,0,1,14,3,13,0,4,20
2020,53002,Campagnatico,GR,61,1,17,2,0,20,2,10,0,4,16
2020,53002,Campagnatico,GR,62,1,13,0,0,14,3,20,2,1,26
2020,53002,Campagnatico,GR,63,3,13,9,0,25,0,11,2,3,16
2020,53002,Campagnatico,GR,64,2,19,1,0,22,1,10,1,1,13
2020,53002,Campagnatico,GR,65,2,13,1,1,17,1,8,2,3,14
2020,53002,Campagnatico,GR,66,4,18,1,0,23,3,10,1,3,17
2020,53002,Campagnatico,GR,67,3,5,0,0,8,2,12,1,3,18
2020,53002,Campagnatico,GR,68,1,10,0,1,12,1,9,0,2,12
2020,53002,Campagnatico,GR,69,1,16,0,1,18,0,12,1,3,16
2020,53002,Campagnatico,GR,70,2,13,2,1,18,4,15,1,2,22
2020,53002,Campagnatico,GR,71,3,15,1,3,22,1,13,0,2,16
2020,53002,Campagnatico,GR,72,1,12,2,1,16,0,11,2,9,22
2020,53002,Campagnatico,GR,73,0,13,1,1,15,0,16,0,2,18
2020,53002,Campagnatico,GR,74,1,15,0,4,20,1,11,0,5,17
2020,53002,Campagnatico,GR,75,1,16,1,0,18,2,10,0,6,18
2020,53002,Campagnatico,GR,76,3,9,0,1,13,1,11,0,6,18
2020,53002,Campagnatico,GR,77,1,3,1,2,7,0,8,0,6,14
2020,53002,Campagnatico,GR,78,0,8,1,1,10,0,5,0,1,6
2020,53002,Campagnatico,GR,79,0,10,0,3,13,0,4,0,6,10
2020,53002,Campagnatico,GR,80,0,14,0,2,16,1,6,0,9,16
2020,53002,Campagnatico,GR,81,0,3,0,1,4,0,8,0,7,15
2020,53002,Campagnatico,GR,82,0,5,0,1,6,0,4,0,4,8
2020,53002,Campagnatico,GR,83,1,4,0,2,7,0,6,0,8,14
2020,53002,Campagnatico,GR,84,1,12,0,2,15,0,1,0,11,12
2020,53002,Campagnatico,GR,85,1,7,0,1,9,0,2,0,9,11
2020,53002,Campagnatico,GR,86,1,3,0,1,5,0,0,0,6,6
2020,53002,Campagnatico,GR,87,0,1,0,1,2,0,0,0,11,11
2020,53002,Campagnatico,GR,88,2,0,0,2,4,0,2,0,5,7
2020,53002,Campagnatico,GR,89,0,3,0,0,3,0,1,0,4,5
2020,53002,Campagnatico,GR,90,1,2,0,0,3,0,1,0,6,7
2020,53002,Campagnatico,GR,91,0,3,0,2,5,0,0,0,3,3
2020,53002,Campagnatico,GR,92,0,0,0,2,2,0,1,0,4,5
2020,53002,Campagnatico,GR,93,0,2,0,1,3,0,0,0,3,3
2020,53002,Campagnatico,GR,94,0,0,0,1,1,0,0,0,1,1
2020,53002,Campagnatico,GR,95,0,1,0,0,1,0,0,0,0,0
2020,53002,Campagnatico,GR,96,1,0,0,0,1,1,0,0,2,3
2020,53002,Campagnatico,GR,97,0,0,0,0,0,0,0,0,1,1
2020,53002,Campagnatico,GR,98,0,0,0,0,0,0,0,0,0,0
2020,53002,Campagnatico,GR,99,0,0,0,0,0,0,0,0,1,1
2020,53002,Campagnatico,GR,100 e più,0,0,0,0,0,0,0,0,0,0
2020,53003,Capalbio,GR,0,7,0,0,0,7,11,0,0,0,11
2020,53003,Capalbio,GR,1,5,0,0,0,5,15,0,0,0,15
2020,53003,Capalbio,GR,2,8,0,0,0,8,16,0,0,0,16
2020,53003,Capalbio,GR,3,13,0,0,0,13,11,0,0,0,11
2020,53003,Capalbio,GR,4,17,0,0,0,17,8,0,0,0,8
2020,53003,Capalbio,GR,5,16,0,0,0,16,11,0,0,0,11
2020,53003,Capalbio,GR,6,11,0,0,0,11,9,0,0,0,9
2020,53003,Capalbio,GR,7,10,0,0,0,10,15,0,0,0,15
2020,53003,Capalbio,GR,8,12,0,0,0,12,15,0,0,0,15
2020,53003,Capalbio,GR,9,16,0,0,0,16,14,0,0,0,14
2020,53003,Capalbio,GR,10,17,0,0,0,17,19,0,0,0,19
2020,53003,Capalbio,GR,11,16,0,0,0,16,17,0,0,0,17
2020,53003,Capalbio,GR,12,12,0,0,0,12,12,0,0,0,12
2020,53003,Capalbio,GR,13,10,0,0,0,10,12,0,0,0,12
2020,53003,Capalbio,GR,14,13,0,0,0,13,12,0,0,0,12
2020,53003,Capalbio,GR,15,9,0,0,0,9,15,0,0,0,15
2020,53003,Capalbio,GR,16,12,0,0,0,12,14,0,0,0,14
2020,53003,Capalbio,GR,17,20,0,0,0,20,14,0,0,0,14
2020,53003,Capalbio,GR,18,7,0,0,0,7,16,0,0,0,16
2020,53003,Capalbio,GR,19,18,0,0,0,18,10,0,0,0,10
2020,53003,Capalbio,GR,20,14,0,0,0,14,18,0,0,0,18
2020,53003,Capalbio,GR,21,12,0,0,0,12,18,0,0,0,18
2020,53003,Capalbio,GR,22,11,0,0,0,11,20,0,0,0,20
2020,53003,Capalbio,GR,23,19,0,0,0,19,19,0,0,0,19
2020,53003,Capalbio,GR,24,13,2,0,0,15,11,1,0,0,12
2020,53003,Capalbio,GR,25,17,0,0,0,17,9,1,0,0,10
2020,53003,Capalbio,GR,26,17,0,0,0,17,21,2,0,0,23
2020,53003,Capalbio,GR,27,11,0,0,0,11,17,1,0,0,18
2020,53003,Capalbio,GR,28,20,1,0,0,21,15,1,1,0,17
2020,53003,Capalbio,GR,29,15,0,0,0,15,12,5,1,0,18
2020,53003,Capalbio,GR,30,17,2,0,0,19,15,4,0,0,19
2020,53003,Capalbio,GR,31,10,1,0,0,11,21,7,0,0,28
2020,53003,Capalbio,GR,32,16,9,0,0,25,17,4,0,0,21
2020,53003,Capalbio,GR,33,20,2,0,0,22,12,11,2,0,25
2020,53003,Capalbio,GR,34,25,5,0,0,30,7,12,1,0,20
2020,53003,Capalbio,GR,35,9,12,0,0,21,11,12,0,0,23
2020,53003,Capalbio,GR,36,12,11,0,0,23,12,16,1,0,29
2020,53003,Capalbio,GR,37,13,9,1,0,23,10,9,1,0,20
2020,53003,Capalbio,GR,38,9,9,0,0,18,9,11,2,0,22
2020,53003,Capalbio,GR,39,15,9,0,1,25,5,8,4,0,17
2020,53003,Capalbio,GR,40,16,13,0,0,29,7,12,0,0,19
2020,53003,Capalbio,GR,41,12,9,2,0,23,4,7,3,0,14
2020,53003,Capalbio,GR,42,11,13,3,0,27,6,16,2,0,24
2020,53003,Capalbio,GR,43,13,12,1,0,26,5,17,1,0,23
2020,53003,Capalbio,GR,44,4,24,1,0,29,8,16,2,1,27
2020,53003,Capalbio,GR,45,14,20,0,0,34,7,27,2,0,36
2020,53003,Capalbio,GR,46,7,11,2,0,20,9,18,1,0,28
2020,53003,Capalbio,GR,47,13,15,2,0,30,6,15,2,0,23
2020,53003,Capalbio,GR,48,7,11,2,0,20,4,25,2,0,31
2020,53003,Capalbio,GR,49,9,19,1,1,30,8,22,1,3,34
2020,53003,Capalbio,GR,50,9,21,0,0,30,3,18,1,0,22
2020,53003,Capalbio,GR,51,6,25,0,0,31,7,25,4,0,36
2020,53003,Capalbio,GR,52,8,27,1,0,36,3,31,2,2,38
2020,53003,Capalbio,GR,53,13,25,2,0,40,3,26,3,0,32
2020,53003,Capalbio,GR,54,9,19,2,0,30,7,35,1,2,45
2020,53003,Capalbio,GR,55,5,20,4,1,30,6,30,6,0,42
2020,53003,Capalbio,GR,56,5,37,2,0,44,7,24,3,1,35
2020,53003,Capalbio,GR,57,7,24,4,0,35,3,23,4,1,31
2020,53003,Capalbio,GR,58,3,23,1,0,27,2,33,0,1,36
2020,53003,Capalbio,GR,59,5,21,3,0,29,1,24,2,5,32
2020,53003,Capalbio,GR,60,0,32,2,0,34,2,24,1,6,33
2020,53003,Capalbio,GR,61,4,23,4,0,31,6,32,6,6,50
2020,53003,Capalbio,GR,62,3,27,1,3,34,4,23,3,6,36
2020,53003,Capalbio,GR,63,0,26,1,0,27,6,29,2,4,41
2020,53003,Capalbio,GR,64,0,23,3,1,27,0,23,2,4,29
2020,53003,Capalbio,GR,65,2,34,2,3,41,3,22,1,5,31
2020,53003,Capalbio,GR,66,2,37,6,2,47,1,27,2,5,35
2020,53003,Capalbio,GR,67,1,18,4,0,23,1,16,1,2,20
2020,53003,Capalbio,GR,68,1,21,1,0,23,0,14,1,7,22
2020,53003,Capalbio,GR,69,2,19,2,1,24,1,16,1,3,21
2020,53003,Capalbio,GR,70,4,21,1,3,29,0,16,1,6,23
2020,53003,Capalbio,GR,71,1,21,3,2,27,2,14,0,10,26
2020,53003,Capalbio,GR,72,1,23,0,2,26,1,16,2,9,28
2020,53003,Capalbio,GR,73,2,20,2,2,26,0,14,2,8,24
2020,53003,Capalbio,GR,74,3,20,1,2,26,1,11,0,7,19
2020,53003,Capalbio,GR,75,1,11,1,3,16,1,10,2,8,21
2020,53003,Capalbio,GR,76,1,16,0,2,19,0,10,0,3,13
2020,53003,Capalbio,GR,77,1,7,2,2,12,0,13,0,10,23
2020,53003,Capalbio,GR,78,0,12,1,0,13,0,12,0,6,18
2020,53003,Capalbio,GR,79,1,6,0,2,9,0,13,1,7,21
2020,53003,Capalbio,GR,80,0,23,0,3,26,0,13,0,12,25
2020,53003,Capalbio,GR,81,3,10,2,0,15,0,8,0,16,24
2020,53003,Capalbio,GR,82,2,10,0,2,14,1,4,0,13,18
2020,53003,Capalbio,GR,83,2,11,0,3,16,0,5,0,15,20
2020,53003,Capalbio,GR,84,1,9,0,6,16,0,5,0,9,14
2020,53003,Capalbio,GR,85,0,15,0,6,21,0,5,0,10,15
2020,53003,Capalbio,GR,86,1,7,0,1,9,1,2,0,16,19
2020,53003,Capalbio,GR,87,1,5,0,2,8,0,3,0,18,21
2020,53003,Capalbio,GR,88,0,1,0,1,2,0,1,0,10,11
2020,53003,Capalbio,GR,89,0,7,0,1,8,1,1,0,9,11
2020,53003,Capalbio,GR,90,0,2,0,3,5,0,3,0,6,9
2020,53003,Capalbio,GR,91,0,2,0,1,3,0,2,0,5,7
2020,53003,Capalbio,GR,92,0,1,0,2,3,0,0,0,4,4
2020,53003,Capalbio,GR,93,0,5,0,1,6,0,0,0,6,6
2020,53003,Capalbio,GR,94,0,1,0,1,2,0,0,0,4,4
2020,53003,Capalbio,GR,95,0,0,0,0,0,0,0,1,2,3
2020,53003,Capalbio,GR,96,0,0,0,2,2,1,0,0,4,5
2020,53003,Capalbio,GR,97,0,0,0,0,0,0,0,0,2,2
2020,53003,Capalbio,GR,98,0,0,0,0,0,0,0,0,1,1
2020,53003,Capalbio,GR,99,0,0,0,0,0,0,0,0,1,1
2020,53003,Capalbio,GR,100 e più,0,0,0,0,0,0,0,0,1,1
2020,53004,Castel del Piano,GR,0,17,0,0,0,17,12,0,0,0,12
2020,53004,Castel del Piano,GR,1,11,0,0,0,11,15,0,0,0,15
2020,53004,Castel del Piano,GR,2,24,0,0,0,24,12,0,0,0,12
2020,53004,Castel del Piano,GR,3,22,0,0,0,22,11,0,0,0,11
2020,53004,Castel del Piano,GR,4,22,0,0,0,22,17,0,0,0,17
2020,53004,Castel del Piano,GR,5,24,0,0,0,24,21,0,0,0,21
2020,53004,Castel del Piano,GR,6,18,0,0,0,18,12,0,0,0,12
2020,53004,Castel del Piano,GR,7,30,0,0,0,30,20,0,0,0,20
2020,53004,Castel del Piano,GR,8,28,0,0,0,28,16,0,0,0,16
2020,53004,Castel del Piano,GR,9,23,0,0,0,23,28,0,0,0,28
2020,53004,Castel del Piano,GR,10,22,0,0,0,22,14,0,0,0,14
2020,53004,Castel del Piano,GR,11,21,0,0,0,21,23,0,0,0,23
2020,53004,Castel del Piano,GR,12,28,0,0,0,28,20,0,0,0,20
2020,53004,Castel del Piano,GR,13,22,0,0,0,22,23,0,0,0,23
2020,53004,Castel del Piano,GR,14,26,0,0,0,26,18,0,0,0,18
2020,53004,Castel del Piano,GR,15,23,0,0,0,23,20,0,0,0,20
2020,53004,Castel del Piano,GR,16,18,0,0,0,18,18,0,0,0,18
2020,53004,Castel del Piano,GR,17,18,0,0,0,18,18,0,0,0,18
2020,53004,Castel del Piano,GR,18,19,0,0,0,19,17,0,0,0,17
2020,53004,Castel del Piano,GR,19,22,0,0,0,22,16,1,0,0,17
2020,53004,Castel del Piano,GR,20,17,0,0,0,17,27,1,0,0,28
2020,53004,Castel del Piano,GR,21,29,0,0,0,29,21,0,0,0,21
2020,53004,Castel del Piano,GR,22,23,0,0,0,23,15,0,0,0,15
2020,53004,Castel del Piano,GR,23,30,0,0,0,30,12,3,0,0,15
2020,53004,Castel del Piano,GR,24,19,1,0,0,20,15,3,0,0,18
2020,53004,Castel del Piano,GR,25,20,1,0,0,21,23,4,0,0,27
2020,53004,Castel del Piano,GR,26,27,4,0,0,31,18,7,0,0,25
2020,53004,Castel del Piano,GR,27,19,3,0,0,22,16,2,0,0,18
2020,53004,Castel del Piano,GR,28,22,0,0,0,22,11,5,0,0,16
2020,53004,Castel del Piano,GR,29,30,2,0,0,32,13,7,0,0,20
2020,53004,Castel del Piano,GR,30,32,4,0,0,36,17,10,0,0,27
2020,53004,Castel del Piano,GR,31,20,8,0,0,28,9,10,0,1,20
2020,53004,Castel del Piano,GR,32,33,8,0,0,41,17,10,0,0,27
2020,53004,Castel del Piano,GR,33,14,11,0,0,25,10,16,1,0,27
2020,53004,Castel del Piano,GR,34,20,9,0,0,29,19,6,0,0,25
2020,53004,Castel del Piano,GR,35,21,14,0,0,35,7,7,0,0,14
2020,53004,Castel del Piano,GR,36,13,11,1,0,25,9,14,0,0,23
2020,53004,Castel del Piano,GR,37,17,7,0,0,24,13,13,1,0,27
2020,53004,Castel del Piano,GR,38,19,14,1,0,34,8,26,1,0,35
2020,53004,Castel del Piano,GR,39,16,19,1,0,36,8,18,3,0,29
2020,53004,Castel del Piano,GR,40,19,22,0,0,41,7,15,1,0,23
2020,53004,Castel del Piano,GR,41,9,19,1,0,29,8,17,1,0,26
2020,53004,Castel del Piano,GR,42,16,16,0,0,32,13,16,1,0,30
2020,53004,Castel del Piano,GR,43,9,9,1,1,20,7,24,3,0,34
2020,53004,Castel del Piano,GR,44,13,17,2,0,32,5,31,1,0,37
2020,53004,Castel del Piano,GR,45,18,26,4,2,50,7,20,3,1,31
2020,53004,Castel del Piano,GR,46,12,18,1,0,31,7,18,1,0,26
2020,53004,Castel del Piano,GR,47,12,19,2,0,33,4,28,3,0,35
2020,53004,Castel del Piano,GR,48,18,20,6,0,44,10,31,5,0,46
2020,53004,Castel del Piano,GR,49,7,21,1,0,29,5,18,3,1,27
2020,53004,Castel del Piano,GR,50,12,25,4,0,41,6,18,4,0,28
2020,53004,Castel del Piano,GR,51,9,19,1,0,29,7,24,4,2,37
2020,53004,Castel del Piano,GR,52,16,22,2,0,40,6,25,2,2,35
2020,53004,Castel del Piano,GR,53,8,24,4,0,36,3,22,7,1,33
2020,53004,Castel del Piano,GR,54,7,25,3,1,36,6,24,2,1,33
2020,53004,Castel del Piano,GR,55,3,26,3,1,33,4,31,4,3,42
2020,53004,Castel del Piano,GR,56,2,33,4,0,39,6,37,2,1,46
2020,53004,Castel del Piano,GR,57,6,25,1,0,32,2,32,1,3,38
2020,53004,Castel del Piano,GR,58,7,23,2,0,32,0,26,0,3,29
2020,53004,Castel del Piano,GR,59,4,27,3,0,34,2,36,7,1,46
2020,53004,Castel del Piano,GR,60,6,31,5,0,42,1,32,4,3,40
2020,53004,Castel del Piano,GR,61,9,23,2,0,34,1,32,2,4,39
2020,53004,Castel del Piano,GR,62,4,28,2,0,34,5,20,3,3,31
2020,53004,Castel del Piano,GR,63,3,19,1,1,24,3,24,0,2,29
2020,53004,Castel del Piano,GR,64,2,18,3,1,24,1,21,3,3,28
2020,53004,Castel del Piano,GR,65,4,27,2,1,34,4,30,1,3,38
2020,53004,Castel del Piano,GR,66,4,26,1,1,32,3,21,0,7,31
2020,53004,Castel del Piano,GR,67,4,27,1,1,33,3,26,4,9,42
2020,53004,Castel del Piano,GR,68,0,23,0,3,26,1,18,0,4,23
2020,53004,Castel del Piano,GR,69,4,22,0,3,29,1,21,2,4,28
2020,53004,Castel del Piano,GR,70,1,27,1,1,30,4,19,3,6,32
2020,53004,Castel del Piano,GR,71,2,24,5,2,33,0,24,0,8,32
2020,53004,Castel del Piano,GR,72,1,19,4,3,27,2,12,3,2,19
2020,53004,Castel del Piano,GR,73,1,23,0,1,25,4,12,1,11,28
2020,53004,Castel del Piano,GR,74,1,24,1,1,27,1,23,0,9,33
2020,53004,Castel del Piano,GR,75,0,16,1,3,20,1,20,2,6,29
2020,53004,Castel del Piano,GR,76,2,14,2,0,18,1,17,2,13,33
2020,53004,Castel del Piano,GR,77,5,16,0,3,24,0,14,1,8,23
2020,53004,Castel del Piano,GR,78,1,20,2,3,26,1,7,2,11,21
2020,53004,Castel del Piano,GR,79,0,17,0,5,22,3,12,2,14,31
2020,53004,Castel del Piano,GR,80,3,15,1,1,20,1,10,0,13,24
2020,53004,Castel del Piano,GR,81,0,19,0,0,19,1,7,0,15,23
2020,53004,Castel del Piano,GR,82,4,11,0,6,21,0,13,1,11,25
2020,53004,Castel del Piano,GR,83,1,11,0,2,14,0,8,0,13,21
2020,53004,Castel del Piano,GR,84,1,11,0,4,16,1,7,0,15,23
2020,53004,Castel del Piano,GR,85,0,14,0,3,17,1,8,0,12,21
2020,53004,Castel del Piano,GR,86,2,6,0,3,11,0,4,0,17,21
2020,53004,Castel del Piano,GR,87,0,6,0,3,9,0,1,0,15,16
2020,53004,Castel del Piano,GR,88,0,8,0,2,10,0,1,2,12,15
2020,53004,Castel del Piano,GR,89,0,1,1,2,4,1,2,1,19,23
2020,53004,Castel del Piano,GR,90,0,0,0,3,3,1,1,0,5,7
2020,53004,Castel del Piano,GR,91,0,2,0,2,4,0,1,0,10,11
2020,53004,Castel del Piano,GR,92,1,0,0,2,3,0,2,1,13,16
2020,53004,Castel del Piano,GR,93,0,2,0,3,5,0,2,0,6,8
2020,53004,Castel del Piano,GR,94,1,1,0,3,5,0,0,0,6,6
2020,53004,Castel del Piano,GR,95,2,2,0,1,5,0,0,0,7,7
2020,53004,Castel del Piano,GR,96,0,0,0,2,2,0,0,0,11,11
2020,53004,Castel del Piano,GR,97,1,1,0,0,2,0,0,0,4,4
2020,53004,Castel del Piano,GR,98,0,0,0,0,0,1,0,0,2,3
2020,53004,Castel del Piano,GR,99,0,0,0,0,0,0,0,0,0,0
2020,53004,Castel del Piano,GR,100 e più,0,0,0,0,0,0,0,0,2,2
2020,53005,Castell'Azzara,GR,0,2,0,0,0,2,2,0,0,0,2
2020,53005,Castell'Azzara,GR,1,4,0,0,0,4,3,0,0,0,3
2020,53005,Castell'Azzara,GR,2,3,0,0,0,3,4,0,0,0,4
2020,53005,Castell'Azzara,GR,3,3,0,0,0,3,2,0,0,0,2
2020,53005,Castell'Azzara,GR,4,1,0,0,0,1,3,0,0,0,3
2020,53005,Castell'Azzara,GR,5,3,0,0,0,3,3,0,0,0,3
2020,53005,Castell'Azzara,GR,6,3,0,0,0,3,4,0,0,0,4
2020,53005,Castell'Azzara,GR,7,5,0,0,0,5,4,0,0,0,4
2020,53005,Castell'Azzara,GR,8,7,0,0,0,7,6,0,0,0,6
2020,53005,Castell'Azzara,GR,9,4,0,0,0,4,5,0,0,0,5
2020,53005,Castell'Azzara,GR,10,3,0,0,0,3,2,0,0,0,2
2020,53005,Castell'Azzara,GR,11,5,0,0,0,5,3,0,0,0,3
2020,53005,Castell'Azzara,GR,12,4,0,0,0,4,1,0,0,0,1
2020,53005,Castell'Azzara,GR,13,3,0,0,0,3,3,0,0,0,3
2020,53005,Castell'Azzara,GR,14,2,0,0,0,2,4,0,0,0,4
2020,53005,Castell'Azzara,GR,15,4,0,0,0,4,4,0,0,0,4
2020,53005,Castell'Azzara,GR,16,3,0,0,0,3,4,0,0,0,4
2020,53005,Castell'Azzara,GR,17,5,0,0,0,5,3,0,0,0,3
2020,53005,Castell'Azzara,GR,18,4,0,0,0,4,7,0,0,0,7
2020,53005,Castell'Azzara,GR,19,4,0,0,0,4,3,0,0,0,3
2020,53005,Castell'Azzara,GR,20,1,0,0,0,1,3,0,0,0,3
2020,53005,Castell'Azzara,GR,21,5,0,0,0,5,2,0,0,0,2
2020,53005,Castell'Azzara,GR,22,5,0,0,0,5,3,0,0,0,3
2020,53005,Castell'Azzara,GR,23,3,0,0,0,3,3,0,0,0,3
2020,53005,Castell'Azzara,GR,24,7,0,0,0,7,2,1,0,0,3
2020,53005,Castell'Azzara,GR,25,5,0,0,0,5,5,0,0,0,5
2020,53005,Castell'Azzara,GR,26,4,0,0,0,4,10,0,0,0,10
2020,53005,Castell'Azzara,GR,27,3,0,0,0,3,3,0,0,0,3
2020,53005,Castell'Azzara,GR,28,5,0,0,0,5,1,1,0,0,2
2020,53005,Castell'Azzara,GR,29,5,1,0,0,6,2,0,0,0,2
2020,53005,Castell'Azzara,GR,30,6,1,0,0,7,5,1,0,0,6
2020,53005,Castell'Azzara,GR,31,6,2,0,0,8,2,2,0,0,4
2020,53005,Castell'Azzara,GR,32,7,1,0,0,8,2,2,0,0,4
2020,53005,Castell'Azzara,GR,33,7,1,0,0,8,2,2,0,0,4
2020,53005,Castell'Azzara,GR,34,1,0,0,0,1,3,1,0,0,4
2020,53005,Castell'Azzara,GR,35,8,3,0,0,11,2,3,0,0,5
2020,53005,Castell'Azzara,GR,36,7,3,0,0,10,3,3,0,0,6
2020,53005,Castell'Azzara,GR,37,3,3,0,0,6,8,1,0,0,9
2020,53005,Castell'Azzara,GR,38,3,2,0,0,5,5,2,1,0,8
2020,53005,Castell'Azzara,GR,39,6,0,0,0,6,2,4,0,0,6
2020,53005,Castell'Azzara,GR,40,4,0,0,0,4,3,2,0,0,5
2020,53005,Castell'Azzara,GR,41,8,5,1,0,14,4,4,0,0,8
2020,53005,Castell'Azzara,GR,42,8,4,0,0,12,1,3,0,0,4
2020,53005,Castell'Azzara,GR,43,4,2,0,0,6,1,1,0,0,2
2020,53005,Castell'Azzara,GR,44,2,1,0,1,4,0,4,0,0,4
2020,53005,Castell'Azzara,GR,45,5,7,0,0,12,5,4,0,1,10
2020,53005,Castell'Azzara,GR,46,1,4,0,0,5,4,6,0,0,10
2020,53005,Castell'Azzara,GR,47,1,5,1,2,9,1,6,0,0,7
2020,53005,Castell'Azzara,GR,48,4,3,2,0,9,4,5,1,0,10
2020,53005,Castell'Azzara,GR,49,4,3,0,0,7,3,4,0,0,7
2020,53005,Castell'Azzara,GR,50,3,7,1,0,11,4,4,1,0,9
2020,53005,Castell'Azzara,GR,51,3,2,1,0,6,4,7,1,1,13
2020,53005,Castell'Azzara,GR,52,3,3,0,0,6,3,1,2,0,6
2020,53005,Castell'Azzara,GR,53,1,2,0,0,3,4,7,0,2,13
2020,53005,Castell'Azzara,GR,54,1,5,0,0,6,1,6,1,0,8
2020,53005,Castell'Azzara,GR,55,2,7,0,0,9,2,3,0,0,5
2020,53005,Castell'Azzara,GR,56,4,6,0,0,10,5,9,0,1,15
2020,53005,Castell'Azzara,GR,57,7,7,0,0,14,1,2,0,1,4
2020,53005,Castell'Azzara,GR,58,2,8,0,1,11,2,8,0,0,10
2020,53005,Castell'Azzara,GR,59,2,2,0,0,4,1,14,1,1,17
2020,53005,Castell'Azzara,GR,60,4,9,0,0,13,1,7,0,3,11
2020,53005,Castell'Azzara,GR,61,1,4,0,0,5,1,7,2,1,11
2020,53005,Castell'Azzara,GR,62,1,6,0,1,8,1,7,0,1,9
2020,53005,Castell'Azzara,GR,63,3,4,1,1,9,0,7,0,0,7
2020,53005,Castell'Azzara,GR,64,1,15,3,1,20,1,7,1,2,11
2020,53005,Castell'Azzara,GR,65,4,10,2,1,17,0,10,0,2,12
2020,53005,Castell'Azzara,GR,66,1,8,2,0,11,2,5,0,1,8
2020,53005,Castell'Azzara,GR,67,1,12,0,0,13,1,7,0,2,10
2020,53005,Castell'Azzara,GR,68,2,8,0,3,13,2,13,0,2,17
2020,53005,Castell'Azzara,GR,69,5,9,1,0,15,1,5,0,0,6
2020,53005,Castell'Azzara,GR,70,3,6,1,0,10,2,8,0,1,11
2020,53005,Castell'Azzara,GR,71,1,8,0,1,10,0,6,0,2,8
2020,53005,Castell'Azzara,GR,72,0,12,1,0,13,1,11,0,3,15
2020,53005,Castell'Azzara,GR,73,3,6,0,0,9,3,6,0,3,12
2020,53005,Castell'Azzara,GR,74,0,10,0,1,11,1,9,0,6,16
2020,53005,Castell'Azzara,GR,75,1,1,0,0,2,0,4,1,8,13
2020,53005,Castell'Azzara,GR,76,0,12,0,1,13,0,5,0,5,10
2020,53005,Castell'Azzara,GR,77,2,5,0,1,8,1,5,0,3,9
2020,53005,Castell'Azzara,GR,78,0,3,0,1,4,0,4,1,3,8
2020,53005,Castell'Azzara,GR,79,1,5,0,1,7,3,5,0,3,11
2020,53005,Castell'Azzara,GR,80,4,1,0,0,5,0,5,0,8,13
2020,53005,Castell'Azzara,GR,81,5,7,0,1,13,0,4,0,4,8
2020,53005,Castell'Azzara,GR,82,3,7,0,3,13,1,8,0,4,13
2020,53005,Castell'Azzara,GR,83,1,6,0,1,8,0,5,0,5,10
2020,53005,Castell'Azzara,GR,84,2,9,0,2,13,3,2,0,9,14
2020,53005,Castell'Azzara,GR,85,2,4,1,0,7,1,3,0,9,13
2020,53005,Castell'Azzara,GR,86,1,4,0,1,6,1,2,0,7,10
2020,53005,Castell'Azzara,GR,87,0,3,0,0,3,2,2,0,8,12
2020,53005,Castell'Azzara,GR,88,0,5,0,2,7,0,0,0,7,7
2020,53005,Castell'Azzara,GR,89,0,3,0,1,4,0,1,0,9,10
2020,53005,Castell'Azzara,GR,90,1,4,0,1,6,0,1,1,9,11
2020,53005,Castell'Azzara,GR,91,2,2,0,0,4,0,2,0,5,7
2020,53005,Castell'Azzara,GR,92,0,1,0,0,1,0,0,0,7,7
2020,53005,Castell'Azzara,GR,93,0,4,0,0,4,0,0,0,6,6
2020,53005,Castell'Azzara,GR,94,0,0,0,0,0,0,0,0,6,6
2020,53005,Castell'Azzara,GR,95,0,0,0,0,0,1,0,0,3,4
2020,53005,Castell'Azzara,GR,96,0,0,0,0,0,0,0,0,1,1
2020,53005,Castell'Azzara,GR,97,0,0,0,0,0,0,0,0,0,0
2020,53005,Castell'Azzara,GR,98,0,0,0,0,0,0,0,0,1,1
2020,53005,Castell'Azzara,GR,99,0,0,0,0,0,0,0,0,0,0
2020,53005,Castell'Azzara,GR,100 e più,0,0,0,0,0,0,0,0,0,0
2020,53006,Castiglione della Pescaia,GR,0,16,0,0,0,16,9,0,0,0,9
2020,53006,Castiglione della Pescaia,GR,1,20,0,0,0,20,10,0,0,0,10
2020,53006,Castiglione della Pescaia,GR,2,27,0,0,0,27,14,0,0,0,14
2020,53006,Castiglione della Pescaia,GR,3,17,0,0,0,17,18,0,0,0,18
2020,53006,Castiglione della Pescaia,GR,4,19,0,0,0,19,17,0,0,0,17
2020,53006,Castiglione della Pescaia,GR,5,23,0,0,0,23,17,0,0,0,17
2020,53006,Castiglione della Pescaia,GR,6,11,0,0,0,11,11,0,0,0,11
2020,53006,Castiglione della Pescaia,GR,7,18,0,0,0,18,19,0,0,0,19
2020,53006,Castiglione della Pescaia,GR,8,17,0,0,0,17,19,0,0,0,19
2020,53006,Castiglione della Pescaia,GR,9,34,0,0,0,34,12,0,0,0,12
2020,53006,Castiglione della Pescaia,GR,10,23,0,0,0,23,26,0,0,0,26
2020,53006,Castiglione della Pescaia,GR,11,23,0,0,0,23,19,0,0,0,19
2020,53006,Castiglione della Pescaia,GR,12,32,0,0,0,32,25,0,0,0,25
2020,53006,Castiglione della Pescaia,GR,13,28,0,0,0,28,17,0,0,0,17
2020,53006,Castiglione della Pescaia,GR,14,26,0,0,0,26,20,0,0,0,20
2020,53006,Castiglione della Pescaia,GR,15,20,0,0,0,20,23,0,0,0,23
2020,53006,Castiglione della Pescaia,GR,16,33,0,0,0,33,25,0,0,0,25
2020,53006,Castiglione della Pescaia,GR,17,31,0,0,0,31,17,0,0,0,17
2020,53006,Castiglione della Pescaia,GR,18,23,0,0,0,23,22,0,0,0,22
2020,53006,Castiglione della Pescaia,GR,19,35,0,0,0,35,30,0,0,0,30
2020,53006,Castiglione della Pescaia,GR,20,27,0,0,0,27,27,0,0,0,27
2020,53006,Castiglione della Pescaia,GR,21,20,0,0,0,20,27,1,0,0,28
2020,53006,Castiglione della Pescaia,GR,22,27,0,0,0,27,25,1,0,0,26
2020,53006,Castiglione della Pescaia,GR,23,23,0,0,0,23,31,0,0,0,31
2020,53006,Castiglione della Pescaia,GR,24,24,0,0,0,24,34,1,0,0,35
2020,53006,Castiglione della Pescaia,GR,25,31,0,0,0,31,22,0,0,0,22
2020,53006,Castiglione della Pescaia,GR,26,40,1,0,0,41,29,1,0,0,30
2020,53006,Castiglione della Pescaia,GR,27,39,1,0,0,40,24,3,0,0,27
2020,53006,Castiglione della Pescaia,GR,28,27,2,0,0,29,32,7,0,0,39
2020,53006,Castiglione della Pescaia,GR,29,31,0,0,0,31,21,9,0,0,30
2020,53006,Castiglione della Pescaia,GR,30,20,8,1,0,29,24,7,0,0,31
2020,53006,Castiglione della Pescaia,GR,31,29,5,0,0,34,9,9,1,0,19
2020,53006,Castiglione della Pescaia,GR,32,37,6,0,0,43,19,6,1,0,26
2020,53006,Castiglione della Pescaia,GR,33,37,6,1,0,44,20,10,0,0,30
2020,53006,Castiglione della Pescaia,GR,34,16,5,0,0,21,22,16,1,0,39
2020,53006,Castiglione della Pescaia,GR,35,22,11,0,0,33,23,8,0,0,31
2020,53006,Castiglione della Pescaia,GR,36,24,12,0,0,36,18,20,1,0,39
2020,53006,Castiglione della Pescaia,GR,37,20,12,0,0,32,22,12,1,0,35
2020,53006,Castiglione della Pescaia,GR,38,16,13,1,0,30,21,14,1,0,36
2020,53006,Castiglione della Pescaia,GR,39,20,20,0,0,40,21,18,3,0,42
2020,53006,Castiglione della Pescaia,GR,40,25,11,0,0,36,20,18,2,0,40
2020,53006,Castiglione della Pescaia,GR,41,21,22,4,0,47,15,15,0,1,31
2020,53006,Castiglione della Pescaia,GR,42,25,15,0,0,40,22,24,2,0,48
2020,53006,Castiglione della Pescaia,GR,43,32,20,2,0,54,17,25,3,0,45
2020,53006,Castiglione della Pescaia,GR,44,31,22,3,0,56,11,21,1,0,33
2020,53006,Castiglione della Pescaia,GR,45,27,35,1,0,63,17,24,7,0,48
2020,53006,Castiglione della Pescaia,GR,46,23,24,3,0,50,16,29,6,0,51
2020,53006,Castiglione della Pescaia,GR,47,20,30,2,0,52,18,21,4,0,43
2020,53006,Castiglione della Pescaia,GR,48,26,24,4,0,54,14,33,3,1,51
2020,53006,Castiglione della Pescaia,GR,49,8,34,4,0,46,13,36,6,0,55
2020,53006,Castiglione della Pescaia,GR,50,19,38,5,0,62,12,39,4,2,57
2020,53006,Castiglione della Pescaia,GR,51,21,41,7,0,69,14,48,9,2,73
2020,53006,Castiglione della Pescaia,GR,52,19,41,7,0,67,13,40,10,3,66
2020,53006,Castiglione della Pescaia,GR,53,13,33,6,1,53,20,44,8,4,76
2020,53006,Castiglione della Pescaia,GR,54,8,45,7,0,60,12,55,5,1,73
2020,53006,Castiglione della Pescaia,GR,55,21,46,10,0,77,11,44,10,1,66
2020,53006,Castiglione della Pescaia,GR,56,22,39,3,1,65,24,58,9,2,93
2020,53006,Castiglione della Pescaia,GR,57,15,39,8,2,64,7,71,8,4,90
2020,53006,Castiglione della Pescaia,GR,58,9,46,8,2,65,7,36,8,4,55
2020,53006,Castiglione della Pescaia,GR,59,9,35,4,0,48,6,31,6,5,48
2020,53006,Castiglione della Pescaia,GR,60,11,54,5,1,71,4,45,4,5,58
2020,53006,Castiglione della Pescaia,GR,61,6,42,9,0,57,6,40,6,9,61
2020,53006,Castiglione della Pescaia,GR,62,5,39,6,1,51,5,29,9,4,47
2020,53006,Castiglione della Pescaia,GR,63,4,35,2,3,44,5,38,8,4,55
2020,53006,Castiglione della Pescaia,GR,64,8,39,7,2,56,8,37,2,6,53
2020,53006,Castiglione della Pescaia,GR,65,1,38,6,1,46,8,40,8,5,61
2020,53006,Castiglione della Pescaia,GR,66,5,36,5,2,48,2,36,10,13,61
2020,53006,Castiglione della Pescaia,GR,67,5,35,4,1,45,3,31,8,11,53
2020,53006,Castiglione della Pescaia,GR,68,4,43,4,1,52,2,42,5,10,59
2020,53006,Castiglione della Pescaia,GR,69,3,25,2,8,38,5,31,3,3,42
2020,53006,Castiglione della Pescaia,GR,70,5,33,9,1,48,5,35,4,12,56
2020,53006,Castiglione della Pescaia,GR,71,3,51,3,1,58,1,46,2,14,63
2020,53006,Castiglione della Pescaia,GR,72,1,38,5,2,46,4,26,1,12,43
2020,53006,Castiglione della Pescaia,GR,73,3,39,5,5,52,0,31,1,15,47
2020,53006,Castiglione della Pescaia,GR,74,4,37,2,5,48,0,32,2,17,51
2020,53006,Castiglione della Pescaia,GR,75,1,28,2,3,34,2,29,1,13,45
2020,53006,Castiglione della Pescaia,GR,76,4,34,1,5,44,1,31,1,11,44
2020,53006,Castiglione della Pescaia,GR,77,3,29,3,5,40,2,32,2,18,54
2020,53006,Castiglione della Pescaia,GR,78,1,28,1,4,34,0,27,4,21,52
2020,53006,Castiglione della Pescaia,GR,79,1,24,1,4,30,2,24,1,25,52
2020,53006,Castiglione della Pescaia,GR,80,1,36,2,5,44,0,19,0,18,37
2020,53006,Castiglione della Pescaia,GR,81,3,27,0,5,35,1,28,1,29,59
2020,53006,Castiglione della Pescaia,GR,82,1,26,0,4,31,1,18,1,26,46
2020,53006,Castiglione della Pescaia,GR,83,1,31,0,5,37,5,13,1,26,45
2020,53006,Castiglione della Pescaia,GR,84,1,19,0,2,22,2,16,0,24,42
2020,53006,Castiglione della Pescaia,GR,85,1,28,2,6,37,1,9,0,20,30
2020,53006,Castiglione della Pescaia,GR,86,1,20,0,4,25,2,9,0,24,35
2020,53006,Castiglione della Pescaia,GR,87,1,13,1,2,17,1,6,0,23,30
2020,53006,Castiglione della Pescaia,GR,88,0,13,0,7,20,0,5,0,16,21
2020,53006,Castiglione della Pescaia,GR,89,2,7,1,6,16,2,1,0,11,14
2020,53006,Castiglione della Pescaia,GR,90,1,8,0,6,15,0,2,0,21,23
2020,53006,Castiglione della Pescaia,GR,91,3,3,0,4,10,0,2,0,10,12
2020,53006,Castiglione della Pescaia,GR,92,0,4,0,3,7,1,1,1,9,12
2020,53006,Castiglione della Pescaia,GR,93,0,5,0,1,6,0,1,0,7,8
2020,53006,Castiglione della Pescaia,GR,94,0,1,0,0,1,1,0,1,3,5
2020,53006,Castiglione della Pescaia,GR,95,0,1,0,0,1,0,0,0,4,4
2020,53006,Castiglione della Pescaia,GR,96,1,1,0,1,3,1,0,0,3,4
2020,53006,Castiglione della Pescaia,GR,97,0,0,0,0,0,0,0,0,3,3
2020,53006,Castiglione della Pescaia,GR,98,0,0,0,0,0,0,0,0,1,1
2020,53006,Castiglione della Pescaia,GR,99,0,0,0,0,0,0,0,0,1,1
2020,53006,Castiglione della Pescaia,GR,100 e più,1,0,0,0,1,0,0,0,1,1
2020,53007,Cinigiano,GR,0,5,0,0,0,5,3,0,0,0,3
2020,53007,Cinigiano,GR,1,8,0,0,0,8,4,0,0,0,4
2020,53007,Cinigiano,GR,2,6,0,0,0,6,5,0,0,0,5
2020,53007,Cinigiano,GR,3,12,0,0,0,12,3,0,0,0,3
2020,53007,Cinigiano,GR,4,8,0,0,0,8,7,0,0,0,7
2020,53007,Cinigiano,GR,5,9,0,0,0,9,14,0,0,0,14
2020,53007,Cinigiano,GR,6,7,0,0,0,7,8,0,0,0,8
2020,53007,Cinigiano,GR,7,10,0,0,0,10,13,0,0,0,13
2020,53007,Cinigiano,GR,8,8,0,0,0,8,7,0,0,0,7
2020,53007,Cinigiano,GR,9,4,0,0,0,4,9,0,0,0,9
2020,53007,Cinigiano,GR,10,13,0,0,0,13,13,0,0,0,13
2020,53007,Cinigiano,GR,11,12,0,0,0,12,9,0,0,0,9
2020,53007,Cinigiano,GR,12,11,0,0,0,11,9,0,0,0,9
2020,53007,Cinigiano,GR,13,10,0,0,0,10,9,0,0,0,9
2020,53007,Cinigiano,GR,14,8,0,0,0,8,8,0,0,0,8
2020,53007,Cinigiano,GR,15,5,0,0,0,5,9,0,0,0,9
2020,53007,Cinigiano,GR,16,8,0,0,0,8,10,0,0,0,10
2020,53007,Cinigiano,GR,17,12,0,0,0,12,9,0,0,0,9
2020,53007,Cinigiano,GR,18,4,0,0,0,4,6,0,0,0,6
2020,53007,Cinigiano,GR,19,7,0,0,0,7,8,0,0,0,8
2020,53007,Cinigiano,GR,20,12,0,0,0,12,8,0,0,0,8
2020,53007,Cinigiano,GR,21,7,0,0,0,7,10,0,0,0,10
2020,53007,Cinigiano,GR,22,12,0,0,0,12,3,0,0,0,3
2020,53007,Cinigiano,GR,23,8,0,0,0,8,10,1,0,0,11
2020,53007,Cinigiano,GR,24,6,0,0,0,6,7,1,0,0,8
2020,53007,Cinigiano,GR,25,10,0,0,0,10,7,3,0,0,10
2020,53007,Cinigiano,GR,26,8,0,0,0,8,11,4,0,0,15
2020,53007,Cinigiano,GR,27,13,0,0,0,13,4,3,0,0,7
2020,53007,Cinigiano,GR,28,14,1,0,0,15,5,2,0,0,7
2020,53007,Cinigiano,GR,29,14,3,0,0,17,5,3,1,0,9
2020,53007,Cinigiano,GR,30,7,2,0,0,9,9,3,0,0,12
2020,53007,Cinigiano,GR,31,16,1,0,0,17,8,3,0,0,11
2020,53007,Cinigiano,GR,32,18,0,0,0,18,6,4,0,0,10
2020,53007,Cinigiano,GR,33,8,3,0,0,11,5,3,0,0,8
2020,53007,Cinigiano,GR,34,7,5,0,0,12,8,5,0,0,13
2020,53007,Cinigiano,GR,35,9,6,0,0,15,8,6,0,0,14
2020,53007,Cinigiano,GR,36,12,4,0,0,16,7,4,0,0,11
2020,53007,Cinigiano,GR,37,10,3,0,0,13,6,7,0,0,13
2020,53007,Cinigiano,GR,38,14,7,0,0,21,3,3,1,0,7
2020,53007,Cinigiano,GR,39,8,7,0,0,15,6,9,1,0,16
2020,53007,Cinigiano,GR,40,10,7,0,0,17,5,9,1,0,15
2020,53007,Cinigiano,GR,41,12,9,0,0,21,4,8,0,0,12
2020,53007,Cinigiano,GR,42,7,6,1,0,14,6,11,0,0,17
2020,53007,Cinigiano,GR,43,9,15,0,1,25,4,8,1,0,13
2020,53007,Cinigiano,GR,44,7,9,0,1,17,11,11,3,0,25
2020,53007,Cinigiano,GR,45,6,7,0,0,13,3,10,1,1,15
2020,53007,Cinigiano,GR,46,7,8,1,0,16,3,11,0,0,14
2020,53007,Cinigiano,GR,47,7,7,2,0,16,2,7,4,0,13
2020,53007,Cinigiano,GR,48,5,12,2,0,19,7,12,2,0,21
2020,53007,Cinigiano,GR,49,5,9,0,0,14,1,14,2,1,18
2020,53007,Cinigiano,GR,50,14,10,1,0,25,3,8,2,0,13
2020,53007,Cinigiano,GR,51,2,17,2,0,21,5,13,0,0,18
2020,53007,Cinigiano,GR,52,2,13,1,0,16,2,18,1,0,21
2020,53007,Cinigiano,GR,53,10,8,1,3,22,0,12,2,0,14
2020,53007,Cinigiano,GR,54,6,16,4,0,26,3,14,1,0,18
2020,53007,Cinigiano,GR,55,3,21,3,0,27,2,15,1,3,21
2020,53007,Cinigiano,GR,56,1,11,1,0,13,0,21,4,0,25
2020,53007,Cinigiano,GR,57,2,11,2,0,15,2,14,1,2,19
2020,53007,Cinigiano,GR,58,1,11,0,0,12,2,14,3,1,20
2020,53007,Cinigiano,GR,59,3,11,0,2,16,1,8,0,2,11
2020,53007,Cinigiano,GR,60,3,21,0,0,24,1,16,2,1,20
2020,53007,Cinigiano,GR,61,2,12,1,0,15,2,9,0,0,11
2020,53007,Cinigiano,GR,62,8,15,2,0,25,0,18,1,5,24
2020,53007,Cinigiano,GR,63,1,16,1,1,19,0,7,2,3,12
2020,53007,Cinigiano,GR,64,1,19,1,0,21,1,9,0,0,10
2020,53007,Cinigiano,GR,65,2,15,0,0,17,0,16,2,4,22
2020,53007,Cinigiano,GR,66,1,10,1,1,13,1,8,0,2,11
2020,53007,Cinigiano,GR,67,5,11,1,0,17,2,13,1,3,19
2020,53007,Cinigiano,GR,68,2,5,0,2,9,0,7,0,4,11
2020,53007,Cinigiano,GR,69,3,13,2,0,18,3,9,0,5,17
2020,53007,Cinigiano,GR,70,3,5,2,0,10,0,13,1,6,20
2020,53007,Cinigiano,GR,71,2,16,0,2,20,2,18,2,6,28
2020,53007,Cinigiano,GR,72,3,16,2,4,25,2,15,0,1,18
2020,53007,Cinigiano,GR,73,1,19,1,1,22,0,11,0,2,13
2020,53007,Cinigiano,GR,74,3,16,1,2,22,0,14,0,3,17
2020,53007,Cinigiano,GR,75,0,10,0,2,12,0,5,0,6,11
2020,53007,Cinigiano,GR,76,2,7,1,2,12,0,12,0,6,18
2020,53007,Cinigiano,GR,77,1,8,0,1,10,0,5,0,3,8
2020,53007,Cinigiano,GR,78,1,6,0,2,9,0,4,0,3,7
2020,53007,Cinigiano,GR,79,1,8,0,1,10,0,4,0,6,10
2020,53007,Cinigiano,GR,80,1,17,0,2,20,0,6,0,12,18
2020,53007,Cinigiano,GR,81,1,9,0,1,11,0,7,0,12,19
2020,53007,Cinigiano,GR,82,1,7,0,4,12,0,2,0,7,9
2020,53007,Cinigiano,GR,83,2,4,1,0,7,0,5,0,8,13
2020,53007,Cinigiano,GR,84,2,8,1,3,14,0,3,0,9,12
2020,53007,Cinigiano,GR,85,2,1,0,4,7,0,2,0,10,12
2020,53007,Cinigiano,GR,86,0,7,1,2,10,1,1,1,9,12
2020,53007,Cinigiano,GR,87,0,6,0,1,7,0,3,0,6,9
2020,53007,Cinigiano,GR,88,0,6,0,3,9,0,2,0,7,9
2020,53007,Cinigiano,GR,89,1,1,0,0,2,0,0,0,9,9
2020,53007,Cinigiano,GR,90,0,0,0,0,0,0,1,0,11,12
2020,53007,Cinigiano,GR,91,1,1,0,0,2,1,1,1,2,5
2020,53007,Cinigiano,GR,92,0,5,0,1,6,1,0,0,4,5
2020,53007,Cinigiano,GR,93,1,0,0,0,1,0,0,0,6,6
2020,53007,Cinigiano,GR,94,0,1,0,1,2,0,1,0,4,5
2020,53007,Cinigiano,GR,95,0,0,0,0,0,0,0,0,2,2
2020,53007,Cinigiano,GR,96,1,1,0,0,2,0,0,0,5,5
2020,53007,Cinigiano,GR,97,0,0,0,0,0,0,0,0,2,2
2020,53007,Cinigiano,GR,98,0,0,0,0,0,1,0,0,2,3
2020,53007,Cinigiano,GR,99,0,0,0,1,1,0,0,0,0,0
2020,53007,Cinigiano,GR,100 e più,0,0,0,0,0,0,0,0,1,1
2020,53008,Civitella Paganico,GR,0,14,0,0,0,14,11,0,0,0,11
2020,53008,Civitella Paganico,GR,1,7,0,0,0,7,19,0,0,0,19
2020,53008,Civitella Paganico,GR,2,6,0,0,0,6,6,0,0,0,6
2020,53008,Civitella Paganico,GR,3,12,0,0,0,12,9,0,0,0,9
2020,53008,Civitella Paganico,GR,4,10,0,0,0,10,9,0,0,0,9
2020,53008,Civitella Paganico,GR,5,6,0,0,0,6,12,0,0,0,12
2020,53008,Civitella Paganico,GR,6,9,0,0,0,9,7,0,0,0,7
2020,53008,Civitella Paganico,GR,7,14,0,0,0,14,11,0,0,0,11
2020,53008,Civitella Paganico,GR,8,16,0,0,0,16,3,0,0,0,3
2020,53008,Civitella Paganico,GR,9,10,0,0,0,10,18,0,0,0,18
2020,53008,Civitella Paganico,GR,10,17,0,0,0,17,13,0,0,0,13
2020,53008,Civitella Paganico,GR,11,15,0,0,0,15,14,0,0,0,14
2020,53008,Civitella Paganico,GR,12,16,0,0,0,16,10,0,0,0,10
2020,53008,Civitella Paganico,GR,13,13,0,0,0,13,14,0,0,0,14
2020,53008,Civitella Paganico,GR,14,9,0,0,0,9,6,0,0,0,6
2020,53008,Civitella Paganico,GR,15,11,0,0,0,11,15,0,0,0,15
2020,53008,Civitella Paganico,GR,16,10,0,0,0,10,11,0,0,0,11
2020,53008,Civitella Paganico,GR,17,16,0,0,0,16,12,0,0,0,12
2020,53008,Civitella Paganico,GR,18,10,0,0,0,10,16,0,0,0,16
2020,53008,Civitella Paganico,GR,19,9,0,0,0,9,18,0,0,0,18
2020,53008,Civitella Paganico,GR,20,16,0,0,0,16,5,0,0,0,5
2020,53008,Civitella Paganico,GR,21,15,0,0,0,15,14,0,0,0,14
2020,53008,Civitella Paganico,GR,22,12,0,0,0,12,9,0,0,0,9
2020,53008,Civitella Paganico,GR,23,14,0,0,0,14,11,1,0,0,12
2020,53008,Civitella Paganico,GR,24,30,0,0,0,30,12,1,0,0,13
2020,53008,Civitella Paganico,GR,25,14,0,0,0,14,6,1,0,0,7
2020,53008,Civitella Paganico,GR,26,13,2,0,0,15,11,3,0,0,14
2020,53008,Civitella Paganico,GR,27,19,1,0,0,20,9,4,0,0,13
2020,53008,Civitella Paganico,GR,28,16,1,0,0,17,9,8,0,0,17
2020,53008,Civitella Paganico,GR,29,24,4,0,0,28,7,4,0,0,11
2020,53008,Civitella Paganico,GR,30,12,2,0,0,14,8,7,0,0,15
2020,53008,Civitella Paganico,GR,31,18,7,0,0,25,10,9,0,0,19
2020,53008,Civitella Paganico,GR,32,12,3,0,0,15,9,6,1,1,17
2020,53008,Civitella Paganico,GR,33,13,8,1,0,22,4,3,1,0,8
2020,53008,Civitella Paganico,GR,34,12,6,0,0,18,4,6,0,0,10
2020,53008,Civitella Paganico,GR,35,20,5,0,0,25,6,9,0,0,15
2020,53008,Civitella Paganico,GR,36,11,10,0,0,21,7,3,0,0,10
2020,53008,Civitella Paganico,GR,37,13,8,0,0,21,7,11,1,0,19
2020,53008,Civitella Paganico,GR,38,10,9,0,0,19,13,7,0,0,20
2020,53008,Civitella Paganico,GR,39,7,8,0,0,15,8,13,0,0,21
2020,53008,Civitella Paganico,GR,40,11,8,0,0,19,4,11,0,0,15
2020,53008,Civitella Paganico,GR,41,12,10,1,0,23,6,15,2,0,23
2020,53008,Civitella Paganico,GR,42,6,7,1,0,14,4,8,2,0,14
2020,53008,Civitella Paganico,GR,43,7,7,0,0,14,6,11,0,0,17
2020,53008,Civitella Paganico,GR,44,10,22,0,0,32,5,8,3,0,16
2020,53008,Civitella Paganico,GR,45,11,7,0,0,18,4,19,1,0,24
2020,53008,Civitella Paganico,GR,46,12,10,0,0,22,5,7,2,0,14
2020,53008,Civitella Paganico,GR,47,14,19,1,0,34,5,21,1,0,27
2020,53008,Civitella Paganico,GR,48,9,11,2,0,22,7,13,2,0,22
2020,53008,Civitella Paganico,GR,49,3,15,1,0,19,5,10,2,0,17
2020,53008,Civitella Paganico,GR,50,8,24,1,1,34,2,12,3,0,17
2020,53008,Civitella Paganico,GR,51,7,20,3,0,30,6,17,3,1,27
2020,53008,Civitella Paganico,GR,52,7,12,1,0,20,3,22,0,0,25
2020,53008,Civitella Paganico,GR,53,2,11,2,0,15,2,15,1,1,19
2020,53008,Civitella Paganico,GR,54,3,21,1,0,25,3,17,3,0,23
2020,53008,Civitella Paganico,GR,55,4,18,5,0,27,1,17,2,1,21
2020,53008,Civitella Paganico,GR,56,5,15,2,1,23,3,20,3,1,27
2020,53008,Civitella Paganico,GR,57,4,14,4,0,22,3,22,9,2,36
2020,53008,Civitella Paganico,GR,58,5,12,1,0,18,3,10,3,2,18
2020,53008,Civitella Paganico,GR,59,1,12,2,0,15,4,11,3,2,20
2020,53008,Civitella Paganico,GR,60,2,22,0,0,24,2,15,2,1,20
2020,53008,Civitella Paganico,GR,61,3,18,2,0,23,1,11,1,1,14
2020,53008,Civitella Paganico,GR,62,0,15,0,2,17,0,16,2,0,18
2020,53008,Civitella Paganico,GR,63,3,13,2,0,18,1,18,0,3,22
2020,53008,Civitella Paganico,GR,64,5,19,0,0,24,0,18,1,4,23
2020,53008,Civitella Paganico,GR,65,3,11,1,0,15,3,24,0,3,30
2020,53008,Civitella Paganico,GR,66,3,17,2,0,22,1,12,0,2,15
2020,53008,Civitella Paganico,GR,67,4,17,1,1,23,0,10,1,2,13
2020,53008,Civitella Paganico,GR,68,1,12,6,0,19,1,10,0,2,13
2020,53008,Civitella Paganico,GR,69,2,13,1,1,17,2,10,2,4,18
2020,53008,Civitella Paganico,GR,70,0,15,0,0,15,3,10,0,5,18
2020,53008,Civitella Paganico,GR,71,3,12,0,1,16,0,16,1,6,23
2020,53008,Civitella Paganico,GR,72,0,15,1,3,19,0,18,0,5,23
2020,53008,Civitella Paganico,GR,73,3,9,1,1,14,2,21,0,7,30
2020,53008,Civitella Paganico,GR,74,5,12,1,2,20,0,18,0,2,20
2020,53008,Civitella Paganico,GR,75,0,7,0,1,8,0,9,0,8,17
2020,53008,Civitella Paganico,GR,76,1,14,0,0,15,1,8,1,7,17
2020,53008,Civitella Paganico,GR,77,1,19,0,4,24,0,8,1,2,11
2020,53008,Civitella Paganico,GR,78,0,12,0,0,12,1,4,0,4,9
2020,53008,Civitella Paganico,GR,79,3,17,2,1,23,0,8,0,10,18
2020,53008,Civitella Paganico,GR,80,0,10,0,0,10,0,6,0,14,20
2020,53008,Civitella Paganico,GR,81,0,8,0,2,10,0,1,0,9,10
2020,53008,Civitella Paganico,GR,82,2,11,0,4,17,0,1,0,12,13
2020,53008,Civitella Paganico,GR,83,4,4,2,1,11,0,8,0,8,16
2020,53008,Civitella Paganico,GR,84,1,12,1,1,15,0,4,0,5,9
2020,53008,Civitella Paganico,GR,85,1,5,0,4,10,2,4,0,14,20
2020,53008,Civitella Paganico,GR,86,1,6,0,2,9,0,3,0,14,17
2020,53008,Civitella Paganico,GR,87,2,3,0,3,8,1,1,0,10,12
2020,53008,Civitella Paganico,GR,88,0,5,0,3,8,0,1,0,8,9
2020,53008,Civitella Paganico,GR,89,2,4,0,2,8,1,1,0,8,10
2020,53008,Civitella Paganico,GR,90,1,1,0,2,4,0,1,0,9,10
2020,53008,Civitella Paganico,GR,91,0,1,0,0,1,1,0,0,6,7
2020,53008,Civitella Paganico,GR,92,0,3,0,3,6,0,0,0,3,3
2020,53008,Civitella Paganico,GR,93,0,0,0,2,2,0,0,0,6,6
2020,53008,Civitella Paganico,GR,94,0,0,0,1,1,0,0,0,3,3
2020,53008,Civitella Paganico,GR,95,0,1,0,0,1,0,0,0,1,1
2020,53008,Civitella Paganico,GR,96,0,0,0,1,1,1,0,0,0,1
2020,53008,Civitella Paganico,GR,97,0,0,0,2,2,0,0,0,2,2
2020,53008,Civitella Paganico,GR,98,0,0,0,0,0,0,0,0,1,1
2020,53008,Civitella Paganico,GR,99,0,0,0,0,0,0,0,0,4,4
2020,53008,Civitella Paganico,GR,100 e più,0,0,0,0,0,0,0,0,5,5
2020,53009,Follonica,GR,0,53,0,0,0,53,39,0,0,0,39
2020,53009,Follonica,GR,1,58,0,0,0,58,59,0,0,0,59
2020,53009,Follonica,GR,2,72,0,0,0,72,54,0,0,0,54
2020,53009,Follonica,GR,3,52,0,0,0,52,56,0,0,0,56
2020,53009,Follonica,GR,4,60,0,0,0,60,51,0,0,0,51
2020,53009,Follonica,GR,5,60,0,0,0,60,72,0,0,0,72
2020,53009,Follonica,GR,6,71,0,0,0,71,74,0,0,0,74
2020,53009,Follonica,GR,7,68,0,0,0,68,72,0,0,0,72
2020,53009,Follonica,GR,8,72,0,0,0,72,65,0,0,0,65
2020,53009,Follonica,GR,9,82,0,0,0,82,78,0,0,0,78
2020,53009,Follonica,GR,10,74,0,0,0,74,81,0,0,0,81
2020,53009,Follonica,GR,11,83,0,0,0,83,72,0,0,0,72
2020,53009,Follonica,GR,12,97,0,0,0,97,84,0,0,0,84
2020,53009,Follonica,GR,13,100,0,0,0,100,88,0,0,0,88
2020,53009,Follonica,GR,14,97,0,0,0,97,97,0,0,0,97
2020,53009,Follonica,GR,15,73,0,0,0,73,84,0,0,0,84
2020,53009,Follonica,GR,16,96,0,0,0,96,82,0,0,0,82
2020,53009,Follonica,GR,17,93,0,0,0,93,83,0,0,0,83
2020,53009,Follonica,GR,18,86,0,0,0,86,88,0,0,0,88
2020,53009,Follonica,GR,19,83,0,0,0,83,104,1,0,0,105
2020,53009,Follonica,GR,20,81,0,0,0,81,77,0,0,0,77
2020,53009,Follonica,GR,21,75,0,0,0,75,89,0,0,0,89
2020,53009,Follonica,GR,22,95,0,0,0,95,86,1,0,0,87
2020,53009,Follonica,GR,23,78,0,0,0,78,87,4,0,0,91
2020,53009,Follonica,GR,24,92,2,0,0,94,76,1,0,0,77
2020,53009,Follonica,GR,25,85,5,0,0,90,70,6,0,0,76
2020,53009,Follonica,GR,26,93,2,0,0,95,67,6,0,0,73
2020,53009,Follonica,GR,27,81,4,0,0,85,62,10,0,0,72
2020,53009,Follonica,GR,28,97,6,0,0,103,79,5,0,0,84
2020,53009,Follonica,GR,29,89,4,0,0,93,67,19,0,0,86
2020,53009,Follonica,GR,30,90,14,0,0,104,62,29,0,1,92
2020,53009,Follonica,GR,31,60,9,0,0,69,68,15,0,0,83
2020,53009,Follonica,GR,32,82,12,2,0,96,61,39,1,1,102
2020,53009,Follonica,GR,33,57,29,0,0,86,44,36,2,0,82
2020,53009,Follonica,GR,34,61,20,0,0,81,49,47,3,0,99
2020,53009,Follonica,GR,35,45,22,0,0,67,57,37,3,0,97
2020,53009,Follonica,GR,36,56,33,1,0,90,45,41,3,1,90
2020,53009,Follonica,GR,37,53,37,2,0,92,45,48,6,0,99
2020,53009,Follonica,GR,38,67,35,2,0,104,39,40,4,0,83
2020,53009,Follonica,GR,39,64,38,2,0,106,52,60,9,0,121
2020,53009,Follonica,GR,40,56,62,4,0,122,37,83,5,0,125
2020,53009,Follonica,GR,41,73,42,6,0,121,41,60,4,0,105
2020,53009,Follonica,GR,42,58,58,4,0,120,53,76,5,3,137
2020,53009,Follonica,GR,43,74,74,3,0,151,40,90,11,1,143
2020,53009,Follonica,GR,44,54,68,7,0,129,44,98,9,1,152
2020,53009,Follonica,GR,45,52,77,4,0,133,41,96,11,1,149
2020,53009,Follonica,GR,46,63,90,8,0,161,36,101,13,1,151
2020,53009,Follonica,GR,47,60,90,10,0,160,37,109,16,3,165
2020,53009,Follonica,GR,48,40,90,13,0,143,43,108,16,5,172
2020,53009,Follonica,GR,49,67,101,12,0,180,44,115,18,7,184
2020,53009,Follonica,GR,50,48,104,14,3,169,42,123,14,2,181
2020,53009,Follonica,GR,51,38,121,14,1,174,28,127,20,4,179
2020,53009,Follonica,GR,52,36,108,20,2,166,19,117,21,2,159
2020,53009,Follonica,GR,53,24,113,12,0,150,45,105,18,2,170
2020,53009,Follonica,GR,54,31,120,16,3,170,30,125,22,13,190
2020,53009,Follonica,GR,55,33,115,19,0,167,27,126,12,5,170
2020,53009,Follonica,GR,56,24,112,11,6,153,23,132,18,5,178
2020,53009,Follonica,GR,57,19,101,16,4,140,31,112,25,9,177
2020,53009,Follonica,GR,58,22,121,12,0,155,13,124,25,12,174
2020,53009,Follonica,GR,59,15,112,12,3,142,9,140,20,7,176
2020,53009,Follonica,GR,60,17,130,11,0,158,13,129,11,9,162
2020,53009,Follonica,GR,61,14,87,11,5,117,8,124,11,14,157
2020,53009,Follonica,GR,62,14,102,17,1,134,8,106,13,13,140
2020,53009,Follonica,GR,63,8,95,10,2,115,13,112,16,11,152
2020,53009,Follonica,GR,64,11,111,9,5,136,7,114,19,18,158
2020,53009,Follonica,GR,65,11,100,10,6,127,12,129,20,15,176
2020,53009,Follonica,GR,66,8,120,7,7,142,14,103,16,24,157
2020,53009,Follonica,GR,67,11,103,8,3,125,4,118,17,29,168
2020,53009,Follonica,GR,68,6,114,9,5,134,8,110,11,15,144
2020,53009,Follonica,GR,69,6,94,8,10,118,5,104,12,26,147
2020,53009,Follonica,GR,70,4,124,7,4,139,2,114,13,33,162
2020,53009,Follonica,GR,71,4,117,7,5,133,2,107,10,41,160
2020,53009,Follonica,GR,72,4,133,3,11,151,4,130,10,46,190
2020,53009,Follonica,GR,73,10,119,5,8,142,7,130,10,42,189
2020,53009,Follonica,GR,74,13,123,3,14,153,4,114,7,42,167
2020,53009,Follonica,GR,75,2,91,2,19,114,3,77,10,56,146
2020,53009,Follonica,GR,76,1,116,6,9,132,3,80,5,52,140
2020,53009,Follonica,GR,77,5,88,3,10,106,9,70,4,45,128
2020,53009,Follonica,GR,78,3,90,4,8,105,2,76,4,64,146
2020,53009,Follonica,GR,79,6,92,1,11,110,2,85,4,51,142
2020,53009,Follonica,GR,80,4,97,1,12,114,3,69,3,74,149
2020,53009,Follonica,GR,81,6,83,0,15,104,4,64,4,73,145
2020,53009,Follonica,GR,82,3,74,2,15,94,9,63,2,62,136
2020,53009,Follonica,GR,83,1,77,1,12,91,4,48,1,63,116
2020,53009,Follonica,GR,84,1,54,2,7,64,4,30,0,56,90
2020,53009,Follonica,GR,85,2,52,0,11,65,4,28,3,68,103
2020,53009,Follonica,GR,86,4,44,0,9,57,2,15,4,68,89
2020,53009,Follonica,GR,87,4,33,0,12,49,2,14,1,69,86
2020,53009,Follonica,GR,88,0,25,1,10,36,3,11,1,54,69
2020,53009,Follonica,GR,89,0,28,0,10,38,2,6,0,58,66
2020,53009,Follonica,GR,90,2,14,0,12,28,1,3,1,56,61
2020,53009,Follonica,GR,91,1,7,1,6,15,3,4,0,44,51
2020,53009,Follonica,GR,92,1,11,0,7,19,2,3,0,40,45
2020,53009,Follonica,GR,93,0,4,0,7,11,3,0,0,23,26
2020,53009,Follonica,GR,94,1,4,0,5,10,4,1,1,22,28
2020,53009,Follonica,GR,95,0,2,0,4,6,0,2,0,23,25
2020,53009,Follonica,GR,96,0,0,0,2,2,0,0,0,12,12
2020,53009,Follonica,GR,97,0,1,0,2,3,0,0,0,6,6
2020,53009,Follonica,GR,98,0,0,0,1,1,1,0,0,3,4
2020,53009,Follonica,GR,99,0,0,0,2,2,0,0,0,3,3
2020,53009,Follonica,GR,100 e più,0,1,0,0,1,0,0,0,5,5
2020,53010,Gavorrano,GR,0,22,0,0,0,22,24,0,0,0,24
2020,53010,Gavorrano,GR,1,24,0,0,0,24,17,0,0,0,17
2020,53010,Gavorrano,GR,2,35,0,0,0,35,31,0,0,0,31
2020,53010,Gavorrano,GR,3,27,0,0,0,27,21,0,0,0,21
2020,53010,Gavorrano,GR,4,26,0,0,0,26,18,0,0,0,18
2020,53010,Gavorrano,GR,5,46,0,0,0,46,30,0,0,0,30
2020,53010,Gavorrano,GR,6,38,0,0,0,38,30,0,0,0,30
2020,53010,Gavorrano,GR,7,32,0,0,0,32,37,0,0,0,37
2020,53010,Gavorrano,GR,8,34,0,0,0,34,26,0,0,0,26
2020,53010,Gavorrano,GR,9,28,0,0,0,28,41,0,0,0,41
2020,53010,Gavorrano,GR,10,41,0,0,0,41,35,0,0,0,35
2020,53010,Gavorrano,GR,11,35,0,0,0,35,27,0,0,0,27
2020,53010,Gavorrano,GR,12,36,0,0,0,36,41,0,0,0,41
2020,53010,Gavorrano,GR,13,42,0,0,0,42,30,0,0,0,30
2020,53010,Gavorrano,GR,14,31,0,0,0,31,32,0,0,0,32
2020,53010,Gavorrano,GR,15,34,0,0,0,34,48,0,0,0,48
2020,53010,Gavorrano,GR,16,31,0,0,0,31,30,0,0,0,30
2020,53010,Gavorrano,GR,17,31,0,0,0,31,27,0,0,0,27
2020,53010,Gavorrano,GR,18,40,0,0,0,40,35,0,0,0,35
2020,53010,Gavorrano,GR,19,44,0,0,0,44,36,0,0,0,36
2020,53010,Gavorrano,GR,20,39,1,0,0,40,25,0,0,0,25
2020,53010,Gavorrano,GR,21,41,0,0,0,41,38,1,0,0,39
2020,53010,Gavorrano,GR,22,39,0,0,0,39,34,4,0,0,38
2020,53010,Gavorrano,GR,23,34,0,0,0,34,30,1,0,0,31
2020,53010,Gavorrano,GR,24,34,0,0,0,34,27,3,0,0,30
2020,53010,Gavorrano,GR,25,40,1,0,0,41,25,1,0,0,26
2020,53010,Gavorrano,GR,26,37,4,0,0,41,34,4,0,0,38
2020,53010,Gavorrano,GR,27,35,0,1,0,36,29,5,0,0,34
2020,53010,Gavorrano,GR,28,24,3,0,0,27,28,11,1,0,40
2020,53010,Gavorrano,GR,29,35,3,0,0,38,28,5,1,0,34
2020,53010,Gavorrano,GR,30,29,5,0,0,34,28,7,0,0,35
2020,53010,Gavorrano,GR,31,27,4,0,0,31,26,11,1,0,38
2020,53010,Gavorrano,GR,32,34,9,1,0,44,28,11,0,0,39
2020,53010,Gavorrano,GR,33,32,10,0,0,42,26,16,0,0,42
2020,53010,Gavorrano,GR,34,34,5,1,0,40,26,14,1,0,41
2020,53010,Gavorrano,GR,35,28,15,0,0,43,13,12,1,0,26
2020,53010,Gavorrano,GR,36,36,14,2,0,52,11,19,1,0,31
2020,53010,Gavorrano,GR,37,32,17,0,0,49,18,38,1,0,57
2020,53010,Gavorrano,GR,38,35,17,1,0,53,20,29,1,1,51
2020,53010,Gavorrano,GR,39,29,20,0,0,49,30,28,1,1,60
2020,53010,Gavorrano,GR,40,23,29,1,0,53,14,23,1,0,38
2020,53010,Gavorrano,GR,41,27,28,1,0,56,29,34,5,0,68
2020,53010,Gavorrano,GR,42,40,24,1,1,66,21,28,5,0,54
2020,53010,Gavorrano,GR,43,26,36,3,0,65,22,33,3,0,58
2020,53010,Gavorrano,GR,44,29,26,4,0,59,16,36,1,0,53
2020,53010,Gavorrano,GR,45,26,31,1,0,58,12,36,3,0,51
2020,53010,Gavorrano,GR,46,26,33,4,0,63,26,40,3,0,69
2020,53010,Gavorrano,GR,47,30,37,1,1,69,13,31,4,0,48
2020,53010,Gavorrano,GR,48,24,34,3,0,61,27,41,7,2,77
2020,53010,Gavorrano,GR,49,16,38,6,0,60,14,46,6,1,67
2020,53010,Gavorrano,GR,50,15,43,4,0,62,11,58,3,4,76
2020,53010,Gavorrano,GR,51,18,45,7,0,70,15,52,12,1,80
2020,53010,Gavorrano,GR,52,28,43,5,2,78,14,39,9,2,64
2020,53010,Gavorrano,GR,53,17,45,7,0,69,11,44,6,1,62
2020,53010,Gavorrano,GR,54,16,43,3,1,63,9,41,8,1,59
2020,53010,Gavorrano,GR,55,11,49,6,1,67,11,52,5,4,72
2020,53010,Gavorrano,GR,56,10,42,5,1,58,14,47,7,7,75
2020,53010,Gavorrano,GR,57,15,42,4,0,61,10,47,3,3,63
2020,53010,Gavorrano,GR,58,8,51,13,1,73,8,43,6,3,60
2020,53010,Gavorrano,GR,59,13,52,7,2,74,3,53,8,11,75
2020,53010,Gavorrano,GR,60,4,40,3,1,48,7,53,13,3,76
2020,53010,Gavorrano,GR,61,9,50,4,1,64,6,39,5,6,56
2020,53010,Gavorrano,GR,62,8,47,4,1,60,10,49,5,6,70
2020,53010,Gavorrano,GR,63,8,45,8,1,62,3,49,4,11,67
2020,53010,Gavorrano,GR,64,13,56,10,4,83,3,43,5,6,57
2020,53010,Gavorrano,GR,65,7,48,1,1,57,6,55,4,7,72
2020,53010,Gavorrano,GR,66,6,42,4,5,57,6,36,7,9,58
2020,53010,Gavorrano,GR,67,5,46,2,0,53,5,45,5,10,65
2020,53010,Gavorrano,GR,68,4,49,7,3,63,4,44,3,7,58
2020,53010,Gavorrano,GR,69,8,46,1,7,62,2,41,1,14,58
2020,53010,Gavorrano,GR,70,12,51,3,0,66,2,41,6,13,62
2020,53010,Gavorrano,GR,71,5,41,6,5,57,2,37,6,16,61
2020,53010,Gavorrano,GR,72,3,42,1,4,50,3,35,2,9,49
2020,53010,Gavorrano,GR,73,3,48,5,4,60,1,27,2,23,53
2020,53010,Gavorrano,GR,74,1,54,2,3,60,3,27,3,20,53
2020,53010,Gavorrano,GR,75,6,26,5,1,38,3,15,2,10,30
2020,53010,Gavorrano,GR,76,2,26,5,3,36,2,24,1,13,40
2020,53010,Gavorrano,GR,77,5,28,1,2,36,1,23,1,21,46
2020,53010,Gavorrano,GR,78,2,21,0,1,24,2,15,3,9,29
2020,53010,Gavorrano,GR,79,1,18,0,1,20,3,11,1,27,42
2020,53010,Gavorrano,GR,80,2,27,3,7,39,1,17,0,38,56
2020,53010,Gavorrano,GR,81,3,10,0,8,21,1,16,1,22,40
2020,53010,Gavorrano,GR,82,6,15,2,1,24,2,9,1,33,45
2020,53010,Gavorrano,GR,83,0,19,0,5,24,2,15,0,36,53
2020,53010,Gavorrano,GR,84,0,20,1,3,24,2,11,1,27,41
2020,53010,Gavorrano,GR,85,2,12,0,4,18,2,4,1,15,22
2020,53010,Gavorrano,GR,86,0,8,0,3,11,0,6,0,26,32
2020,53010,Gavorrano,GR,87,1,10,0,3,14,0,7,2,24,33
2020,53010,Gavorrano,GR,88,1,6,0,2,9,3,1,2,16,22
2020,53010,Gavorrano,GR,89,1,8,0,5,14,0,4,0,21,25
2020,53010,Gavorrano,GR,90,1,5,0,5,11,0,1,0,17,18
2020,53010,Gavorrano,GR,91,0,4,0,1,5,0,0,0,13,13
2020,53010,Gavorrano,GR,92,0,2,0,3,5,1,0,0,19,20
2020,53010,Gavorrano,GR,93,0,4,0,2,6,0,0,0,13,13
2020,53010,Gavorrano,GR,94,0,1,0,6,7,1,1,0,4,6
2020,53010,Gavorrano,GR,95,0,0,0,0,0,0,0,0,6,6
2020,53010,Gavorrano,GR,96,0,2,0,0,2,0,0,0,4,4
2020,53010,Gavorrano,GR,97,0,1,0,3,4,0,0,0,3,3
2020,53010,Gavorrano,GR,98,1,0,0,0,1,1,0,0,1,2
2020,53010,Gavorrano,GR,99,0,0,0,0,0,0,0,0,1,1
2020,53010,Gavorrano,GR,100 e più,0,0,0,0,0,0,0,0,2,2
2020,53011,Grosseto,GR,0,258,0,0,0,258,248,0,0,0,248
2020,53011,Grosseto,GR,1,254,0,0,0,254,232,0,0,0,232
2020,53011,Grosseto,GR,2,294,0,0,0,294,262,0,0,0,262
2020,53011,Grosseto,GR,3,300,0,0,0,300,259,0,0,0,259
2020,53011,Grosseto,GR,4,307,0,0,0,307,289,0,0,0,289
2020,53011,Grosseto,GR,5,306,0,0,0,306,311,0,0,0,311
2020,53011,Grosseto,GR,6,312,0,0,0,312,297,0,0,0,297
2020,53011,Grosseto,GR,7,322,0,0,0,322,299,0,0,0,299
2020,53011,Grosseto,GR,8,360,0,0,0,360,310,0,0,0,310
2020,53011,Grosseto,GR,9,382,0,0,0,382,338,0,0,0,338
2020,53011,Grosseto,GR,10,367,0,0,0,367,371,0,0,0,371
2020,53011,Grosseto,GR,11,395,0,0,0,395,365,0,0,0,365
2020,53011,Grosseto,GR,12,388,0,0,0,388,387,0,0,0,387
2020,53011,Grosseto,GR,13,396,0,0,0,396,375,0,0,0,375
2020,53011,Grosseto,GR,14,430,0,0,0,430,337,0,0,0,337
2020,53011,Grosseto,GR,15,411,0,0,0,411,362,0,0,0,362
2020,53011,Grosseto,GR,16,396,0,0,0,396,369,0,0,0,369
2020,53011,Grosseto,GR,17,382,0,0,0,382,356,0,0,0,356
2020,53011,Grosseto,GR,18,371,0,0,0,371,345,0,0,0,345
2020,53011,Grosseto,GR,19,367,0,0,0,367,326,0,0,0,326
2020,53011,Grosseto,GR,20,372,0,0,0,372,324,3,0,0,327
2020,53011,Grosseto,GR,21,397,2,0,0,399,358,6,0,0,364
2020,53011,Grosseto,GR,22,435,3,0,0,438,348,11,0,0,359
2020,53011,Grosseto,GR,23,387,3,0,0,390,343,13,0,0,356
2020,53011,Grosseto,GR,24,422,2,0,0,424,335,31,1,0,367
2020,53011,Grosseto,GR,25,390,9,0,0,399,310,23,0,0,333
2020,53011,Grosseto,GR,26,410,19,0,0,429,319,32,2,0,354
2020,53011,Grosseto,GR,27,409,16,0,0,425,298,56,1,0,355
2020,53011,Grosseto,GR,28,399,30,2,0,433,269,68,2,2,341
2020,53011,Grosseto,GR,29,379,26,0,0,406,308,67,2,1,378
2020,53011,Grosseto,GR,30,355,60,1,0,416,264,87,4,0,355
2020,53011,Grosseto,GR,31,374,68,1,0,443,270,130,5,1,406
2020,53011,Grosseto,GR,32,341,92,6,0,440,267,141,5,0,413
2020,53011,Grosseto,GR,33,286,116,3,0,406,229,148,6,0,384
2020,53011,Grosseto,GR,34,278,119,4,0,401,207,198,9,0,414
2020,53011,Grosseto,GR,35,295,136,4,1,437,194,197,7,1,399
2020,53011,Grosseto,GR,36,297,162,5,0,465,218,198,12,0,428
2020,53011,Grosseto,GR,37,292,170,2,0,466,209,211,9,1,430
2020,53011,Grosseto,GR,38,262,184,4,1,451,221,248,23,1,493
2020,53011,Grosseto,GR,39,249,201,8,2,460,206,263,19,2,490
2020,53011,Grosseto,GR,40,266,206,10,0,482,185,273,24,1,483
2020,53011,Grosseto,GR,41,241,236,15,0,492,217,312,18,1,548
2020,53011,Grosseto,GR,42,240,291,17,0,549,222,322,39,2,587
2020,53011,Grosseto,GR,43,258,275,17,0,550,225,356,42,5,628
2020,53011,Grosseto,GR,44,253,292,20,3,569,237,352,45,4,638
2020,53011,Grosseto,GR,45,237,355,38,1,634,201,421,42,6,670
2020,53011,Grosseto,GR,46,240,359,35,1,636,234,443,52,3,734
2020,53011,Grosseto,GR,47,242,396,36,0,675,212,444,63,3,722
2020,53011,Grosseto,GR,48,222,397,34,1,655,188,513,53,7,761
2020,53011,Grosseto,GR,49,199,415,43,2,659,173,459,72,18,722
2020,53011,Grosseto,GR,50,185,395,49,5,634,140,442,74,17,673
2020,53011,Grosseto,GR,51,184,440,40,0,664,184,457,73,6,720
2020,53011,Grosseto,GR,52,165,460,55,1,683,155,463,73,15,706
2020,53011,Grosseto,GR,53,154,425,47,3,629,156,452,64,20,692
2020,53011,Grosseto,GR,54,150,472,54,2,678,123,471,88,29,711
2020,53011,Grosseto,GR,55,126,452,68,7,654,153,469,82,25,729
2020,53011,Grosseto,GR,56,130,446,65,9,653,133,488,83,27,731
2020,53011,Grosseto,GR,57,126,452,52,7,638,118,451,104,33,706
2020,53011,Grosseto,GR,58,85,410,51,5,551,103,417,64,37,621
2020,53011,Grosseto,GR,59,88,390,45,11,534,111,423,70,27,631
2020,53011,Grosseto,GR,60,75,380,54,12,521,93,401,65,47,606
2020,53011,Grosseto,GR,61,71,391,58,9,529,84,397,60,44,585
2020,53011,Grosseto,GR,62,61,377,43,13,495,88,403,70,53,615
2020,53011,Grosseto,GR,63,59,430,39,7,536,79,404,62,61,606
2020,53011,Grosseto,GR,64,55,423,41,14,533,85,412,65,54,616
2020,53011,Grosseto,GR,65,46,406,40,18,510,74,352,55,56,537
2020,53011,Grosseto,GR,66,42,353,43,16,454,58,380,61,58,557
2020,53011,Grosseto,GR,67,51,357,33,11,452,40,369,53,61,523
2020,53011,Grosseto,GR,68,27,390,34,15,466,40,326,40,86,492
2020,53011,Grosseto,GR,69,33,353,24,17,428,51,341,48,78,518
2020,53011,Grosseto,GR,70,35,384,22,27,468,54,385,38,82,559
2020,53011,Grosseto,GR,71,21,430,24,22,498,43,356,37,118,554
2020,53011,Grosseto,GR,72,27,415,28,29,499,40,375,40,126,581
2020,53011,Grosseto,GR,73,14,397,28,29,469,41,381,37,146,605
2020,53011,Grosseto,GR,74,31,409,17,54,513,33,347,22,157,559
2020,53011,Grosseto,GR,75,12,291,12,42,357,28,253,22,139,442
2020,53011,Grosseto,GR,76,22,257,21,45,345,19,237,17,144,417
2020,53011,Grosseto,GR,77,17,265,7,20,309,14,231,16,138,399
2020,53011,Grosseto,GR,78,14,263,7,28,312,25,228,15,157,425
2020,53011,Grosseto,GR,79,10,255,6,38,309,22,199,15,176,413
2020,53011,Grosseto,GR,80,17,256,13,35,321,21,208,18,217,464
2020,53011,Grosseto,GR,81,21,255,8,50,334,23,166,8,231,428
2020,53011,Grosseto,GR,82,19,233,9,41,302,32,152,13,229,426
2020,53011,Grosseto,GR,83,10,190,2,47,249,23,125,8,209,365
2020,53011,Grosseto,GR,84,5,157,3,48,213,20,95,6,202,323
2020,53011,Grosseto,GR,85,8,148,1,41,198,16,71,9,233,329
2020,53011,Grosseto,GR,86,5,141,3,45,194,12,63,7,214,296
2020,53011,Grosseto,GR,87,8,98,2,44,152,17,37,8,201,263
2020,53011,Grosseto,GR,88,8,94,2,31,135,13,34,6,154,207
2020,53011,Grosseto,GR,89,1,66,2,27,96,10,25,5,176,216
2020,53011,Grosseto,GR,90,4,52,2,30,88,6,17,4,147,174
2020,53011,Grosseto,GR,91,2,40,0,20,62,2,9,1,111,123
2020,53011,Grosseto,GR,92,2,32,1,29,64,4,8,1,120,133
2020,53011,Grosseto,GR,93,0,20,1,12,33,3,11,1,106,121
2020,53011,Grosseto,GR,94,3,13,0,15,31,7,3,0,104,114
2020,53011,Grosseto,GR,95,4,8,0,15,27,3,2,0,55,60
2020,53011,Grosseto,GR,96,0,4,0,9,13,3,0,0,29,32
2020,53011,Grosseto,GR,97,0,2,0,9,11,0,1,0,31,32
2020,53011,Grosseto,GR,98,0,2,0,8,10,1,0,0,30,31
2020,53011,Grosseto,GR,99,0,1,0,5,6,0,0,0,14,14
2020,53011,Grosseto,GR,100 e più,0,0,0,6,6,0,0,0,21,21
2020,53012,Isola del Giglio,GR,0,2,0,0,0,2,4,0,0,0,4
2020,53012,Isola del Giglio,GR,1,0,0,0,0,0,2,0,0,0,2
2020,53012,Isola del Giglio,GR,2,5,0,0,0,5,4,0,0,0,4
2020,53012,Isola del Giglio,GR,3,5,0,0,0,5,4,0,0,0,4
2020,53012,Isola del Giglio,GR,4,3,0,0,0,3,3,0,0,0,3
2020,53012,Isola del Giglio,GR,5,5,0,0,0,5,5,0,0,0,5
2020,53012,Isola del Giglio,GR,6,3,0,0,0,3,3,0,0,0,3
2020,53012,Isola del Giglio,GR,7,3,0,0,0,3,6,0,0,0,6
2020,53012,Isola del Giglio,GR,8,3,0,0,0,3,7,0,0,0,7
2020,53012,Isola del Giglio,GR,9,6,0,0,0,6,2,0,0,0,2
2020,53012,Isola del Giglio,GR,10,3,0,0,0,3,2,0,0,0,2
2020,53012,Isola del Giglio,GR,11,6,0,0,0,6,5,0,0,0,5
2020,53012,Isola del Giglio,GR,12,3,0,0,0,3,7,0,0,0,7
2020,53012,Isola del Giglio,GR,13,2,0,0,0,2,5,0,0,0,5
2020,53012,Isola del Giglio,GR,14,5,0,0,0,5,4,0,0,0,4
2020,53012,Isola del Giglio,GR,15,3,0,0,0,3,1,0,0,0,1
2020,53012,Isola del Giglio,GR,16,6,0,0,0,6,2,0,0,0,2
2020,53012,Isola del Giglio,GR,17,3,0,0,0,3,3,0,0,0,3
2020,53012,Isola del Giglio,GR,18,4,0,0,0,4,3,0,0,0,3
2020,53012,Isola del Giglio,GR,19,3,0,0,0,3,4,0,0,0,4
2020,53012,Isola del Giglio,GR,20,6,0,0,0,6,6,0,0,0,6
2020,53012,Isola del Giglio,GR,21,5,0,0,0,5,3,0,0,0,3
2020,53012,Isola del Giglio,GR,22,7,0,0,0,7,4,0,0,0,4
2020,53012,Isola del Giglio,GR,23,3,0,0,0,3,0,0,0,0,0
2020,53012,Isola del Giglio,GR,24,7,0,0,0,7,5,0,0,0,5
2020,53012,Isola del Giglio,GR,25,4,0,0,0,4,3,0,0,0,3
2020,53012,Isola del Giglio,GR,26,9,0,0,0,9,4,1,0,0,5
2020,53012,Isola del Giglio,GR,27,4,0,0,0,4,1,3,0,0,4
2020,53012,Isola del Giglio,GR,28,9,0,0,0,9,6,1,0,0,7
2020,53012,Isola del Giglio,GR,29,5,1,0,0,6,7,1,0,0,8
2020,53012,Isola del Giglio,GR,30,7,3,0,0,10,1,0,0,0,1
2020,53012,Isola del Giglio,GR,31,2,1,0,0,3,9,0,0,0,9
2020,53012,Isola del Giglio,GR,32,7,1,0,0,8,2,2,0,0,4
2020,53012,Isola del Giglio,GR,33,4,2,0,0,6,5,2,0,0,7
2020,53012,Isola del Giglio,GR,34,2,3,0,0,5,5,3,0,0,8
2020,53012,Isola del Giglio,GR,35,9,2,0,0,11,5,3,1,0,9
2020,53012,Isola del Giglio,GR,36,5,3,0,0,8,3,3,0,0,6
2020,53012,Isola del Giglio,GR,37,6,2,0,0,8,3,1,0,0,4
2020,53012,Isola del Giglio,GR,38,6,2,0,0,8,2,2,0,0,4
2020,53012,Isola del Giglio,GR,39,5,1,0,0,6,3,3,0,0,6
2020,53012,Isola del Giglio,GR,40,2,5,0,0,7,3,4,0,0,7
2020,53012,Isola del Giglio,GR,41,12,4,0,0,16,3,7,0,0,10
2020,53012,Isola del Giglio,GR,42,3,6,0,0,9,5,4,0,0,9
2020,53012,Isola del Giglio,GR,43,6,3,0,0,9,3,6,0,0,9
2020,53012,Isola del Giglio,GR,44,7,5,1,0,13,3,5,0,0,8
2020,53012,Isola del Giglio,GR,45,8,5,0,0,13,3,8,0,0,11
2020,53012,Isola del Giglio,GR,46,12,10,0,0,22,6,4,0,1,11
2020,53012,Isola del Giglio,GR,47,4,5,0,0,9,2,5,1,0,8
2020,53012,Isola del Giglio,GR,48,4,3,2,0,9,3,3,0,0,6
2020,53012,Isola del Giglio,GR,49,3,6,1,0,10,4,4,2,1,11
2020,53012,Isola del Giglio,GR,50,2,10,2,0,14,1,9,0,0,10
2020,53012,Isola del Giglio,GR,51,2,16,0,0,18,2,4,1,0,7
2020,53012,Isola del Giglio,GR,52,1,3,2,0,6,1,6,0,0,7
2020,53012,Isola del Giglio,GR,53,3,12,1,0,16,2,4,2,1,9
2020,53012,Isola del Giglio,GR,54,5,7,0,0,12,2,4,0,0,6
2020,53012,Isola del Giglio,GR,55,6,7,3,1,17,1,7,3,0,11
2020,53012,Isola del Giglio,GR,56,0,8,1,0,9,0,10,1,0,11
2020,53012,Isola del Giglio,GR,57,3,7,1,0,11,0,3,0,0,3
2020,53012,Isola del Giglio,GR,58,2,5,0,0,7,2,5,1,0,8
2020,53012,Isola del Giglio,GR,59,3,14,0,0,17,4,5,0,0,9
2020,53012,Isola del Giglio,GR,60,1,3,0,0,4,2,7,1,1,11
2020,53012,Isola del Giglio,GR,61,3,7,0,0,10,1,5,0,0,6
2020,53012,Isola del Giglio,GR,62,2,9,0,0,11,1,11,2,1,15
2020,53012,Isola del Giglio,GR,63,3,5,0,0,8,1,12,0,1,14
2020,53012,Isola del Giglio,GR,64,0,9,2,0,11,0,9,1,1,11
2020,53012,Isola del Giglio,GR,65,2,5,0,0,7,3,10,1,2,16
2020,53012,Isola del Giglio,GR,66,3,7,1,0,11,0,3,1,1,5
2020,53012,Isola del Giglio,GR,67,0,11,3,0,14,0,5,0,1,6
2020,53012,Isola del Giglio,GR,68,3,7,0,0,10,0,7,1,3,11
2020,53012,Isola del Giglio,GR,69,1,13,1,1,16,1,2,1,1,5
2020,53012,Isola del Giglio,GR,70,1,8,2,0,11,1,6,0,2,9
2020,53012,Isola del Giglio,GR,71,3,9,1,0,13,2,6,1,0,9
2020,53012,Isola del Giglio,GR,72,1,4,2,0,7,3,4,0,0,7
2020,53012,Isola del Giglio,GR,73,0,9,0,1,10,1,14,0,5,20
2020,53012,Isola del Giglio,GR,74,1,9,0,0,10,0,9,0,1,10
2020,53012,Isola del Giglio,GR,75,1,11,0,2,14,2,6,1,1,10
2020,53012,Isola del Giglio,GR,76,1,5,0,0,6,1,5,0,3,9
2020,53012,Isola del Giglio,GR,77,0,9,1,3,13,2,7,0,4,13
2020,53012,Isola del Giglio,GR,78,1,9,1,0,11,1,2,0,4,7
2020,53012,Isola del Giglio,GR,79,0,6,0,0,6,0,3,0,4,7
2020,53012,Isola del Giglio,GR,80,1,5,0,1,7,1,3,0,5,9
2020,53012,Isola del Giglio,GR,81,4,6,0,1,11,1,4,0,2,7
2020,53012,Isola del Giglio,GR,82,0,4,0,2,6,1,4,0,2,7
2020,53012,Isola del Giglio,GR,83,0,5,0,1,6,1,2,0,9,12
2020,53012,Isola del Giglio,GR,84,0,2,2,2,6,0,1,0,4,5
2020,53012,Isola del Giglio,GR,85,0,1,0,2,3,0,1,0,7,8
2020,53012,Isola del Giglio,GR,86,0,5,0,0,5,0,2,0,3,5
2020,53012,Isola del Giglio,GR,87,2,2,0,0,4,0,0,0,4,4
2020,53012,Isola del Giglio,GR,88,0,3,0,1,4,0,0,0,5,5
2020,53012,Isola del Giglio,GR,89,0,2,0,1,3,0,1,0,0,1
2020,53012,Isola del Giglio,GR,90,0,2,0,1,3,0,0,0,4,4
2020,53012,Isola del Giglio,GR,91,0,0,0,0,0,0,0,0,2,2
2020,53012,Isola del Giglio,GR,92,0,0,0,0,0,0,0,0,1,1
2020,53012,Isola del Giglio,GR,93,1,1,0,0,2,0,0,0,5,5
2020,53012,Isola del Giglio,GR,94,0,0,0,0,0,0,0,0,2,2
2020,53012,Isola del Giglio,GR,95,0,0,0,1,1,0,1,0,1,2
2020,53012,Isola del Giglio,GR,96,0,0,0,0,0,0,0,0,0,0
2020,53012,Isola del Giglio,GR,97,0,0,0,0,0,0,0,0,0,0
2020,53012,Isola del Giglio,GR,98,0,0,0,0,0,0,0,0,0,0
2020,53012,Isola del Giglio,GR,99,0,0,0,0,0,0,0,0,0,0
2020,53012,Isola del Giglio,GR,100 e più,0,0,0,0,0,0,0,0,1,1
2020,53013,Magliano in Toscana,GR,0,4,0,0,0,4,12,0,0,0,12
2020,53013,Magliano in Toscana,GR,1,7,0,0,0,7,6,0,0,0,6
2020,53013,Magliano in Toscana,GR,2,8,0,0,0,8,15,0,0,0,15
2020,53013,Magliano in Toscana,GR,3,6,0,0,0,6,12,0,0,0,12
2020,53013,Magliano in Toscana,GR,4,5,0,0,0,5,10,0,0,0,10
2020,53013,Magliano in Toscana,GR,5,6,0,0,0,6,8,0,0,0,8
2020,53013,Magliano in Toscana,GR,6,11,0,0,0,11,4,0,0,0,4
2020,53013,Magliano in Toscana,GR,7,9,0,0,0,9,15,0,0,0,15
2020,53013,Magliano in Toscana,GR,8,11,0,0,0,11,17,0,0,0,17
2020,53013,Magliano in Toscana,GR,9,10,0,0,0,10,18,0,0,0,18
2020,53013,Magliano in Toscana,GR,10,14,0,0,0,14,12,0,0,0,12
2020,53013,Magliano in Toscana,GR,11,13,0,0,0,13,9,0,0,0,9
2020,53013,Magliano in Toscana,GR,12,18,0,0,0,18,13,0,0,0,13
2020,53013,Magliano in Toscana,GR,13,16,0,0,0,16,12,0,0,0,12
2020,53013,Magliano in Toscana,GR,14,11,0,0,0,11,9,0,0,0,9
2020,53013,Magliano in Toscana,GR,15,11,0,0,0,11,13,0,0,0,13
2020,53013,Magliano in Toscana,GR,16,16,0,0,0,16,14,0,0,0,14
2020,53013,Magliano in Toscana,GR,17,10,0,0,0,10,9,0,0,0,9
2020,53013,Magliano in Toscana,GR,18,11,0,0,0,11,8,0,0,0,8
2020,53013,Magliano in Toscana,GR,19,12,0,0,0,12,11,0,0,0,11
2020,53013,Magliano in Toscana,GR,20,10,0,0,0,10,14,0,0,0,14
2020,53013,Magliano in Toscana,GR,21,9,0,0,0,9,17,0,0,0,17
2020,53013,Magliano in Toscana,GR,22,11,0,0,0,11,19,1,0,0,20
2020,53013,Magliano in Toscana,GR,23,9,0,0,0,9,9,0,0,0,9
2020,53013,Magliano in Toscana,GR,24,13,0,0,0,13,13,1,0,0,14
2020,53013,Magliano in Toscana,GR,25,6,0,0,0,6,9,0,0,0,9
2020,53013,Magliano in Toscana,GR,26,13,0,0,0,13,14,1,0,0,15
2020,53013,Magliano in Toscana,GR,27,10,0,0,0,10,10,1,0,0,11
2020,53013,Magliano in Toscana,GR,28,12,1,0,0,13,6,0,0,0,6
2020,53013,Magliano in Toscana,GR,29,16,0,0,0,16,11,2,0,0,13
2020,53013,Magliano in Toscana,GR,30,11,3,0,0,14,11,5,0,0,16
2020,53013,Magliano in Toscana,GR,31,16,2,0,0,18,21,4,0,0,25
2020,53013,Magliano in Toscana,GR,32,22,1,0,0,23,4,2,0,0,6
2020,53013,Magliano in Toscana,GR,33,12,5,0,0,17,6,3,0,0,9
2020,53013,Magliano in Toscana,GR,34,11,1,1,0,13,7,3,0,0,10
2020,53013,Magliano in Toscana,GR,35,11,3,0,0,14,12,8,1,0,21
2020,53013,Magliano in Toscana,GR,36,12,6,0,0,18,3,10,1,0,14
2020,53013,Magliano in Toscana,GR,37,8,6,0,0,14,5,5,0,0,10
2020,53013,Magliano in Toscana,GR,38,11,8,1,0,20,11,4,0,0,15
2020,53013,Magliano in Toscana,GR,39,10,7,1,0,18,5,15,2,0,22
2020,53013,Magliano in Toscana,GR,40,14,12,0,0,26,6,10,0,0,16
2020,53013,Magliano in Toscana,GR,41,14,8,0,0,22,5,13,0,0,18
2020,53013,Magliano in Toscana,GR,42,12,9,0,0,21,6,9,0,0,15
2020,53013,Magliano in Toscana,GR,43,11,10,0,0,21,16,13,0,0,29
2020,53013,Magliano in Toscana,GR,44,10,14,1,0,25,8,13,1,0,22
2020,53013,Magliano in Toscana,GR,45,9,15,1,0,25,4,19,1,1,25
2020,53013,Magliano in Toscana,GR,46,11,18,1,0,30,10,18,2,0,30
2020,53013,Magliano in Toscana,GR,47,11,7,4,0,22,5,21,2,1,29
2020,53013,Magliano in Toscana,GR,48,8,18,0,0,26,6,25,4,0,35
2020,53013,Magliano in Toscana,GR,49,10,14,0,0,24,5,22,0,0,27
2020,53013,Magliano in Toscana,GR,50,12,14,0,0,26,7,14,4,1,26
2020,53013,Magliano in Toscana,GR,51,10,16,1,0,27,4,20,4,1,29
2020,53013,Magliano in Toscana,GR,52,7,16,2,0,25,3,25,0,0,28
2020,53013,Magliano in Toscana,GR,53,5,23,2,0,30,6,15,1,0,22
2020,53013,Magliano in Toscana,GR,54,5,23,5,0,33,1,23,3,1,28
2020,53013,Magliano in Toscana,GR,55,1,20,0,0,21,0,18,0,0,18
2020,53013,Magliano in Toscana,GR,56,6,14,5,0,25,2,15,3,1,21
2020,53013,Magliano in Toscana,GR,57,6,18,4,0,28,4,19,1,2,26
2020,53013,Magliano in Toscana,GR,58,5,21,2,0,28,3,20,2,1,26
2020,53013,Magliano in Toscana,GR,59,6,21,2,1,30,2,24,3,1,30
2020,53013,Magliano in Toscana,GR,60,3,23,0,1,27,4,29,3,2,38
2020,53013,Magliano in Toscana,GR,61,6,22,2,0,30,2,18,2,0,22
2020,53013,Magliano in Toscana,GR,62,2,16,0,0,18,2,29,3,3,37
2020,53013,Magliano in Toscana,GR,63,1,18,4,0,23,1,26,2,2,31
2020,53013,Magliano in Toscana,GR,64,3,19,0,1,23,2,20,1,6,29
2020,53013,Magliano in Toscana,GR,65,4,27,1,1,33,1,22,6,2,31
2020,53013,Magliano in Toscana,GR,66,1,23,0,1,25,2,30,1,7,40
2020,53013,Magliano in Toscana,GR,67,3,20,3,5,31,1,19,0,2,22
2020,53013,Magliano in Toscana,GR,68,1,18,1,1,21,2,16,1,5,24
2020,53013,Magliano in Toscana,GR,69,2,18,1,0,21,0,23,0,2,25
2020,53013,Magliano in Toscana,GR,70,0,26,3,1,30,0,15,0,6,21
2020,53013,Magliano in Toscana,GR,71,4,31,0,0,35,1,10,0,9,20
2020,53013,Magliano in Toscana,GR,72,5,21,0,3,29,1,12,1,9,23
2020,53013,Magliano in Toscana,GR,73,1,22,3,2,28,0,17,1,8,26
2020,53013,Magliano in Toscana,GR,74,2,23,1,3,29,1,21,2,8,32
2020,53013,Magliano in Toscana,GR,75,0,12,0,3,15,1,11,1,9,22
2020,53013,Magliano in Toscana,GR,76,2,18,1,2,23,1,7,1,1,10
2020,53013,Magliano in Toscana,GR,77,1,11,0,0,12,3,12,1,9,25
2020,53013,Magliano in Toscana,GR,78,2,8,1,3,14,0,15,0,9,24
2020,53013,Magliano in Toscana,GR,79,2,13,2,1,18,0,9,0,8,17
2020,53013,Magliano in Toscana,GR,80,1,10,0,3,14,1,11,0,17,29
2020,53013,Magliano in Toscana,GR,81,1,11,0,3,15,0,6,0,12,18
2020,53013,Magliano in Toscana,GR,82,4,9,0,2,15,1,6,1,8,16
2020,53013,Magliano in Toscana,GR,83,1,6,0,1,8,2,6,1,12,21
2020,53013,Magliano in Toscana,GR,84,1,11,1,4,17,0,7,0,12,19
2020,53013,Magliano in Toscana,GR,85,2,13,0,0,15,1,6,0,19,26
2020,53013,Magliano in Toscana,GR,86,0,5,0,2,7,1,5,0,10,16
2020,53013,Magliano in Toscana,GR,87,0,6,0,0,6,1,5,0,10,16
2020,53013,Magliano in Toscana,GR,88,1,8,0,5,14,0,1,0,7,8
2020,53013,Magliano in Toscana,GR,89,0,8,1,1,10,0,3,0,13,16
2020,53013,Magliano in Toscana,GR,90,0,1,0,0,1,0,1,0,7,8
2020,53013,Magliano in Toscana,GR,91,0,3,0,2,5,1,0,0,10,11
2020,53013,Magliano in Toscana,GR,92,0,3,0,2,5,1,0,0,7,8
2020,53013,Magliano in Toscana,GR,93,0,1,0,2,3,0,0,0,3,3
2020,53013,Magliano in Toscana,GR,94,0,2,0,0,2,0,0,0,2,2
2020,53013,Magliano in Toscana,GR,95,1,0,0,0,1,0,0,0,3,3
2020,53013,Magliano in Toscana,GR,96,0,0,0,0,0,0,0,0,1,1
2020,53013,Magliano in Toscana,GR,97,0,0,0,0,0,0,0,0,0,0
2020,53013,Magliano in Toscana,GR,98,0,0,0,0,0,0,0,0,1,1
2020,53013,Magliano in Toscana,GR,99,0,0,0,0,0,0,0,0,2,2
2020,53013,Magliano in Toscana,GR,100 e più,0,0,0,0,0,0,0,0,1,1
2020,53014,Manciano,GR,0,33,0,0,0,33,22,0,0,0,22
2020,53014,Manciano,GR,1,17,0,0,0,17,16,0,0,0,16
2020,53014,Manciano,GR,2,19,0,0,0,19,32,0,0,0,32
2020,53014,Manciano,GR,3,13,0,0,0,13,16,0,0,0,16
2020,53014,Manciano,GR,4,29,0,0,0,29,34,0,0,0,34
2020,53014,Manciano,GR,5,30,0,0,0,30,21,0,0,0,21
2020,53014,Manciano,GR,6,20,0,0,0,20,28,0,0,0,28
2020,53014,Manciano,GR,7,17,0,0,0,17,25,0,0,0,25
2020,53014,Manciano,GR,8,25,0,0,0,25,27,0,0,0,27
2020,53014,Manciano,GR,9,40,0,0,0,40,20,0,0,0,20
2020,53014,Manciano,GR,10,25,0,0,0,25,23,0,0,0,23
2020,53014,Manciano,GR,11,21,0,0,0,21,31,0,0,0,31
2020,53014,Manciano,GR,12,40,0,0,0,40,30,0,0,0,30
2020,53014,Manciano,GR,13,32,0,0,0,32,13,0,0,0,13
2020,53014,Manciano,GR,14,33,0,0,0,33,33,0,0,0,33
2020,53014,Manciano,GR,15,33,0,0,0,33,26,0,0,0,26
2020,53014,Manciano,GR,16,26,0,0,0,26,15,0,0,0,15
2020,53014,Manciano,GR,17,22,0,0,0,22,37,0,0,0,37
2020,53014,Manciano,GR,18,32,0,0,0,32,22,0,0,0,22
2020,53014,Manciano,GR,19,22,0,0,0,22,20,0,0,0,20
2020,53014,Manciano,GR,20,34,0,0,0,34,25,1,0,0,26
2020,53014,Manciano,GR,21,29,0,0,0,29,18,0,0,0,18
2020,53014,Manciano,GR,22,22,0,0,0,22,22,1,0,0,23
2020,53014,Manciano,GR,23,28,0,0,0,28,27,1,0,0,28
2020,53014,Manciano,GR,24,31,0,0,0,31,26,5,0,0,31
2020,53014,Manciano,GR,25,29,2,0,0,31,19,3,0,0,22
2020,53014,Manciano,GR,26,18,1,0,0,19,22,3,0,0,25
2020,53014,Manciano,GR,27,30,3,0,0,33,21,4,0,0,25
2020,53014,Manciano,GR,28,23,3,0,0,26,30,8,0,0,38
2020,53014,Manciano,GR,29,31,3,0,0,34,23,8,1,0,32
2020,53014,Manciano,GR,30,31,3,0,0,34,22,7,0,0,29
2020,53014,Manciano,GR,31,27,5,0,0,32,23,11,0,0,34
2020,53014,Manciano,GR,32,24,8,0,0,32,14,17,1,0,32
2020,53014,Manciano,GR,33,23,14,0,0,37,13,14,0,0,27
2020,53014,Manciano,GR,34,17,14,1,0,32,20,20,2,0,42
2020,53014,Manciano,GR,35,16,8,0,0,24,17,20,0,0,37
2020,53014,Manciano,GR,36,26,20,0,0,46,17,16,1,0,34
2020,53014,Manciano,GR,37,22,17,2,0,41,17,14,0,0,31
2020,53014,Manciano,GR,38,25,21,0,0,46,11,15,2,0,28
2020,53014,Manciano,GR,39,18,13,0,0,31,15,21,3,0,39
2020,53014,Manciano,GR,40,25,15,0,0,40,12,21,2,0,35
2020,53014,Manciano,GR,41,18,27,4,0,49,18,29,2,0,49
2020,53014,Manciano,GR,42,17,25,2,0,44,21,19,3,0,43
2020,53014,Manciano,GR,43,18,20,0,0,38,20,31,2,0,53
2020,53014,Manciano,GR,44,24,25,4,0,53,14,39,6,0,59
2020,53014,Manciano,GR,45,18,37,3,0,58,16,34,5,1,56
2020,53014,Manciano,GR,46,20,38,5,0,63,16,35,6,0,57
2020,53014,Manciano,GR,47,15,33,4,0,52,18,34,6,1,59
2020,53014,Manciano,GR,48,24,39,3,1,67,8,35,3,6,52
2020,53014,Manciano,GR,49,19,43,3,0,65,12,41,12,0,65
2020,53014,Manciano,GR,50,18,40,4,0,62,13,34,7,1,55
2020,53014,Manciano,GR,51,16,31,5,0,52,10,39,6,5,60
2020,53014,Manciano,GR,52,8,23,5,0,36,16,52,7,3,78
2020,53014,Manciano,GR,53,9,47,5,2,63,5,34,8,1,48
2020,53014,Manciano,GR,54,11,41,8,0,60,10,37,4,4,55
2020,53014,Manciano,GR,55,9,53,11,2,75,10,40,12,2,64
2020,53014,Manciano,GR,56,17,40,3,0,60,9,46,4,3,62
2020,53014,Manciano,GR,57,10,40,11,0,61,7,46,4,2,59
2020,53014,Manciano,GR,58,10,37,6,1,54,6,32,7,7,52
2020,53014,Manciano,GR,59,6,33,2,1,42,6,41,6,3,56
2020,53014,Manciano,GR,60,6,36,3,0,45,5,37,5,5,52
2020,53014,Manciano,GR,61,6,24,2,2,34,11,40,6,6,63
2020,53014,Manciano,GR,62,8,39,2,1,50,3,44,2,1,50
2020,53014,Manciano,GR,63,12,49,4,0,65,7,32,10,0,49
2020,53014,Manciano,GR,64,6,35,7,1,49,2,54,6,8,70
2020,53014,Manciano,GR,65,8,35,5,0,48,2,40,7,6,55
2020,53014,Manciano,GR,66,6,33,2,2,43,3,35,3,8,49
2020,53014,Manciano,GR,67,6,41,3,2,52,4,40,4,6,54
2020,53014,Manciano,GR,68,4,40,5,6,55,3,35,3,7,48
2020,53014,Manciano,GR,69,4,46,4,0,54,3,39,2,7,51
2020,53014,Manciano,GR,70,6,43,4,0,53,0,30,3,6,39
2020,53014,Manciano,GR,71,6,44,2,3,55,7,34,1,10,52
2020,53014,Manciano,GR,72,3,38,3,4,48,1,33,0,22,56
2020,53014,Manciano,GR,73,2,36,4,3,45,2,36,3,16,57
2020,53014,Manciano,GR,74,3,37,2,1,43,4,45,0,19,68
2020,53014,Manciano,GR,75,3,32,1,6,42,1,21,1,21,44
2020,53014,Manciano,GR,76,2,28,0,3,33,2,15,1,17,35
2020,53014,Manciano,GR,77,1,20,0,4,25,2,20,1,14,37
2020,53014,Manciano,GR,78,1,31,0,0,32,2,19,2,12,35
2020,53014,Manciano,GR,79,3,30,2,6,41,0,19,1,17,37
2020,53014,Manciano,GR,80,1,24,0,2,27,3,17,2,25,47
2020,53014,Manciano,GR,81,3,31,0,3,37,2,12,0,29,43
2020,53014,Manciano,GR,82,2,21,1,3,27,1,18,0,36,55
2020,53014,Manciano,GR,83,5,17,0,4,26,1,14,0,17,32
2020,53014,Manciano,GR,84,0,15,1,3,19,2,17,0,15,34
2020,53014,Manciano,GR,85,1,15,1,3,20,1,8,0,17,26
2020,53014,Manciano,GR,86,2,13,0,5,20,1,5,0,21,27
2020,53014,Manciano,GR,87,1,12,0,2,15,1,6,1,26,34
2020,53014,Manciano,GR,88,1,15,0,3,19,0,4,0,28,32
2020,53014,Manciano,GR,89,2,8,0,5,15,1,2,0,17,20
2020,53014,Manciano,GR,90,0,8,0,1,9,0,2,0,24,26
2020,53014,Manciano,GR,91,0,14,0,1,15,0,0,0,14,14
2020,53014,Manciano,GR,92,0,2,0,2,4,1,1,0,6,8
2020,53014,Manciano,GR,93,0,1,0,3,4,0,1,0,11,12
2020,53014,Manciano,GR,94,1,3,0,1,5,1,1,0,13,15
2020,53014,Manciano,GR,95,0,1,0,2,3,0,0,0,8,8
2020,53014,Manciano,GR,96,0,0,0,0,0,1,0,0,8,9
2020,53014,Manciano,GR,97,1,0,0,2,3,0,0,0,3,3
2020,53014,Manciano,GR,98,0,1,0,0,1,0,0,0,3,3
2020,53014,Manciano,GR,99,0,0,0,0,0,0,0,0,1,1
2020,53014,Manciano,GR,100 e più,0,0,0,0,0,0,0,0,0,0
2020,53015,Massa Marittima,GR,0,26,0,0,0,26,28,0,0,0,28
2020,53015,Massa Marittima,GR,1,20,0,0,0,20,19,0,0,0,19
2020,53015,Massa Marittima,GR,2,29,0,0,0,29,25,0,0,0,25
2020,53015,Massa Marittima,GR,3,23,0,0,0,23,21,0,0,0,21
2020,53015,Massa Marittima,GR,4,27,0,0,0,27,32,0,0,0,32
2020,53015,Massa Marittima,GR,5,28,0,0,0,28,18,0,0,0,18
2020,53015,Massa Marittima,GR,6,26,0,0,0,26,19,0,0,0,19
2020,53015,Massa Marittima,GR,7,38,0,0,0,38,27,0,0,0,27
2020,53015,Massa Marittima,GR,8,27,0,0,0,27,36,0,0,0,36
2020,53015,Massa Marittima,GR,9,45,0,0,0,45,31,0,0,0,31
2020,53015,Massa Marittima,GR,10,34,0,0,0,34,37,0,0,0,37
2020,53015,Massa Marittima,GR,11,38,0,0,0,38,37,0,0,0,37
2020,53015,Massa Marittima,GR,12,35,0,0,0,35,37,0,0,0,37
2020,53015,Massa Marittima,GR,13,29,0,0,0,29,27,0,0,0,27
2020,53015,Massa Marittima,GR,14,31,0,0,0,31,34,0,0,0,34
2020,53015,Massa Marittima,GR,15,36,0,0,0,36,35,0,0,0,35
2020,53015,Massa Marittima,GR,16,27,0,0,0,27,34,0,0,0,34
2020,53015,Massa Marittima,GR,17,32,0,0,0,32,25,0,0,0,25
2020,53015,Massa Marittima,GR,18,34,0,0,0,34,27,2,0,0,29
2020,53015,Massa Marittima,GR,19,34,0,0,0,34,30,0,0,0,30
2020,53015,Massa Marittima,GR,20,46,1,0,0,47,34,1,0,0,35
2020,53015,Massa Marittima,GR,21,36,1,0,0,37,30,4,0,0,34
2020,53015,Massa Marittima,GR,22,28,1,0,0,29,25,1,0,0,26
2020,53015,Massa Marittima,GR,23,34,2,0,0,36,28,5,0,0,33
2020,53015,Massa Marittima,GR,24,22,3,0,0,25,29,4,0,0,33
2020,53015,Massa Marittima,GR,25,35,2,0,0,37,31,3,0,0,34
2020,53015,Massa Marittima,GR,26,31,4,0,0,35,25,9,0,0,34
2020,53015,Massa Marittima,GR,27,28,3,0,0,31,33,7,0,0,40
2020,53015,Massa Marittima,GR,28,22,2,0,0,24,35,2,0,0,37
2020,53015,Massa Marittima,GR,29,35,6,1,0,42,22,14,0,0,36
2020,53015,Massa Marittima,GR,30,28,7,0,0,35,32,9,0,0,41
2020,53015,Massa Marittima,GR,31,26,7,0,0,33,22,11,0,0,33
2020,53015,Massa Marittima,GR,32,42,10,0,0,52,17,13,0,0,30
2020,53015,Massa Marittima,GR,33,38,10,0,0,48,22,17,0,0,39
2020,53015,Massa Marittima,GR,34,20,7,0,0,27,20,13,2,0,35
2020,53015,Massa Marittima,GR,35,29,14,1,0,44,19,23,0,0,42
2020,53015,Massa Marittima,GR,36,14,14,1,0,29,13,17,1,0,31
2020,53015,Massa Marittima,GR,37,19,14,1,0,34,23,21,4,0,48
2020,53015,Massa Marittima,GR,38,14,13,0,0,27,26,19,3,0,48
2020,53015,Massa Marittima,GR,39,28,16,0,0,44,15,11,1,0,27
2020,53015,Massa Marittima,GR,40,30,14,2,0,46,16,12,2,0,30
2020,53015,Massa Marittima,GR,41,34,20,2,1,57,19,23,4,0,46
2020,53015,Massa Marittima,GR,42,20,22,3,0,45,19,29,0,0,48
2020,53015,Massa Marittima,GR,43,31,27,3,0,61,23,31,2,0,56
2020,53015,Massa Marittima,GR,44,23,27,2,0,52,26,40,4,0,70
2020,53015,Massa Marittima,GR,45,21,36,1,0,58,25,34,7,0,66
2020,53015,Massa Marittima,GR,46,21,38,4,1,64,19,39,8,1,67
2020,53015,Massa Marittima,GR,47,20,33,5,1,59,10,46,5,1,62
2020,53015,Massa Marittima,GR,48,15,40,4,0,59,20,35,8,2,65
2020,53015,Massa Marittima,GR,49,15,46,4,0,65,12,56,3,2,73
2020,53015,Massa Marittima,GR,50,23,28,10,0,61,8,33,6,3,50
2020,53015,Massa Marittima,GR,51,22,44,2,0,68,8,49,10,1,68
2020,53015,Massa Marittima,GR,52,22,53,2,1,78,8,47,5,0,60
2020,53015,Massa Marittima,GR,53,18,50,5,0,73,8,43,7,1,59
2020,53015,Massa Marittima,GR,54,10,31,7,1,49,8,41,3,2,54
2020,53015,Massa Marittima,GR,55,16,47,7,0,70,9,51,6,1,67
2020,53015,Massa Marittima,GR,56,5,46,6,1,58,5,60,8,2,75
2020,53015,Massa Marittima,GR,57,16,44,8,1,69,6,49,7,2,64
2020,53015,Massa Marittima,GR,58,6,44,7,0,57,6,42,5,2,55
2020,53015,Massa Marittima,GR,59,7,47,6,1,61,6,43,11,4,64
2020,53015,Massa Marittima,GR,60,7,42,6,3,58,3,49,6,2,60
2020,53015,Massa Marittima,GR,61,3,46,7,1,57,7,57,6,3,73
2020,53015,Massa Marittima,GR,62,4,42,4,0,50,8,59,6,2,75
2020,53015,Massa Marittima,GR,63,3,49,10,4,66,5,45,5,8,63
2020,53015,Massa Marittima,GR,64,7,43,2,3,55,5,48,6,6,65
2020,53015,Massa Marittima,GR,65,6,34,2,2,44,2,50,2,13,67
2020,53015,Massa Marittima,GR,66,6,51,3,1,61,2,43,8,14,67
2020,53015,Massa Marittima,GR,67,4,47,2,3,56,2,46,4,9,61
2020,53015,Massa Marittima,GR,68,3,47,6,0,56,4,38,4,9,55
2020,53015,Massa Marittima,GR,69,7,39,4,2,52,4,34,6,11,55
2020,53015,Massa Marittima,GR,70,3,39,2,3,47,6,42,1,13,62
2020,53015,Massa Marittima,GR,71,7,42,5,3,57,2,47,2,23,74
2020,53015,Massa Marittima,GR,72,1,56,2,6,65,4,50,2,19,75
2020,53015,Massa Marittima,GR,73,0,50,3,6,59,7,31,2,17,57
2020,53015,Massa Marittima,GR,74,3,54,2,5,64,3,34,3,18,58
2020,53015,Massa Marittima,GR,75,3,33,3,4,43,1,26,4,19,50
2020,53015,Massa Marittima,GR,76,3,32,2,4,41,1,22,0,26,49
2020,53015,Massa Marittima,GR,77,6,30,2,4,42,3,28,2,19,52
2020,53015,Massa Marittima,GR,78,4,26,0,8,38,2,18,2,16,38
2020,53015,Massa Marittima,GR,79,2,26,2,3,33,1,23,2,20,46
2020,53015,Massa Marittima,GR,80,1,26,2,6,35,1,19,1,22,43
2020,53015,Massa Marittima,GR,81,6,31,1,4,42,1,26,2,34,63
2020,53015,Massa Marittima,GR,82,4,27,1,10,42,2,23,1,33,59
2020,53015,Massa Marittima,GR,83,5,35,0,8,48,3,16,3,35,57
2020,53015,Massa Marittima,GR,84,4,18,1,5,28,1,7,0,31,39
2020,53015,Massa Marittima,GR,85,2,22,0,1,25,1,5,0,32,38
2020,53015,Massa Marittima,GR,86,1,9,0,4,14,2,4,0,22,28
2020,53015,Massa Marittima,GR,87,1,9,0,5,15,1,5,0,34,40
2020,53015,Massa Marittima,GR,88,1,13,0,4,18,0,3,1,28,32
2020,53015,Massa Marittima,GR,89,1,11,0,3,15,2,5,0,33,40
2020,53015,Massa Marittima,GR,90,0,4,0,4,8,0,0,2,33,35
2020,53015,Massa Marittima,GR,91,1,1,0,1,3,0,0,0,10,10
2020,53015,Massa Marittima,GR,92,0,1,0,4,5,1,1,0,20,22
2020,53015,Massa Marittima,GR,93,1,6,0,5,12,0,0,0,13,13
2020,53015,Massa Marittima,GR,94,0,0,0,6,6,1,1,0,7,9
2020,53015,Massa Marittima,GR,95,1,1,0,1,3,0,0,0,8,8
2020,53015,Massa Marittima,GR,96,0,0,0,0,0,0,0,0,9,9
2020,53015,Massa Marittima,GR,97,0,0,0,1,1,0,0,0,5,5
2020,53015,Massa Marittima,GR,98,0,0,0,0,0,1,1,0,4,6
2020,53015,Massa Marittima,GR,99,0,0,0,1,1,0,0,0,3,3
2020,53015,Massa Marittima,GR,100 e più,0,1,0,0,1,0,0,0,1,1
2020,53016,Monte Argentario,GR,0,29,0,0,0,29,34,0,0,0,34
2020,53016,Monte Argentario,GR,1,33,0,0,0,33,30,0,0,0,30
2020,53016,Monte Argentario,GR,2,45,0,0,0,45,31,0,0,0,31
2020,53016,Monte Argentario,GR,3,38,0,0,0,38,45,0,0,0,45
2020,53016,Monte Argentario,GR,4,43,0,0,0,43,44,0,0,0,44
2020,53016,Monte Argentario,GR,5,34,0,0,0,34,39,0,0,0,39
2020,53016,Monte Argentario,GR,6,34,0,0,0,34,37,0,0,0,37
2020,53016,Monte Argentario,GR,7,45,0,0,0,45,38,0,0,0,38
2020,53016,Monte Argentario,GR,8,46,0,0,0,46,46,0,0,0,46
2020,53016,Monte Argentario,GR,9,48,0,0,0,48,35,0,0,0,35
2020,53016,Monte Argentario,GR,10,43,0,0,0,43,42,0,0,0,42
2020,53016,Monte Argentario,GR,11,49,0,0,0,49,44,0,0,0,44
2020,53016,Monte Argentario,GR,12,62,0,0,0,62,56,0,0,0,56
2020,53016,Monte Argentario,GR,13,41,0,0,0,41,48,0,0,0,48
2020,53016,Monte Argentario,GR,14,60,0,0,0,60,55,0,0,0,55
2020,53016,Monte Argentario,GR,15,55,0,0,0,55,57,0,0,0,57
2020,53016,Monte Argentario,GR,16,58,0,0,0,58,43,0,0,0,43
2020,53016,Monte Argentario,GR,17,61,0,0,0,61,51,0,0,0,51
2020,53016,Monte Argentario,GR,18,65,0,0,0,65,44,0,0,0,44
2020,53016,Monte Argentario,GR,19,53,0,0,0,53,52,0,0,0,52
2020,53016,Monte Argentario,GR,20,57,0,0,0,57,72,1,0,0,73
2020,53016,Monte Argentario,GR,21,44,0,0,0,44,41,2,0,0,43
2020,53016,Monte Argentario,GR,22,54,0,0,0,54,56,1,0,0,57
2020,53016,Monte Argentario,GR,23,65,0,0,0,65,59,1,0,0,60
2020,53016,Monte Argentario,GR,24,58,1,0,0,59,57,2,0,0,59
2020,53016,Monte Argentario,GR,25,50,1,0,0,51,40,4,0,0,44
2020,53016,Monte Argentario,GR,26,61,3,0,0,64,55,3,1,0,59
2020,53016,Monte Argentario,GR,27,44,3,0,0,47,44,4,0,0,48
2020,53016,Monte Argentario,GR,28,62,4,0,0,66,45,12,0,0,57
2020,53016,Monte Argentario,GR,29,50,1,0,0,51,40,12,1,0,53
2020,53016,Monte Argentario,GR,30,59,8,0,0,67,35,19,0,0,54
2020,53016,Monte Argentario,GR,31,40,10,0,0,50,29,13,0,0,42
2020,53016,Monte Argentario,GR,32,37,8,1,0,46,35,20,0,0,55
2020,53016,Monte Argentario,GR,33,41,15,0,0,56,31,21,0,0,52
2020,53016,Monte Argentario,GR,34,38,14,3,0,55,27,18,0,0,45
2020,53016,Monte Argentario,GR,35,40,16,1,0,57,31,15,1,0,47
2020,53016,Monte Argentario,GR,36,29,19,1,0,49,26,26,4,1,57
2020,53016,Monte Argentario,GR,37,31,17,1,0,49,32,24,2,0,58
2020,53016,Monte Argentario,GR,38,24,17,0,0,41,28,38,1,0,67
2020,53016,Monte Argentario,GR,39,33,24,0,0,57,16,29,0,1,46
2020,53016,Monte Argentario,GR,40,31,28,1,0,60,27,39,1,0,67
2020,53016,Monte Argentario,GR,41,31,34,1,0,66,25,44,4,0,73
2020,53016,Monte Argentario,GR,42,38,36,1,0,75,27,39,2,0,68
2020,53016,Monte Argentario,GR,43,31,37,3,0,71,18,41,4,0,63
2020,53016,Monte Argentario,GR,44,30,45,3,0,78,17,59,7,3,86
2020,53016,Monte Argentario,GR,45,48,47,4,0,99,14,64,10,0,88
2020,53016,Monte Argentario,GR,46,35,59,3,2,99,17,53,4,0,74
2020,53016,Monte Argentario,GR,47,34,57,2,0,93,23,74,9,2,108
2020,53016,Monte Argentario,GR,48,30,49,6,3,88,22,59,10,3,94
2020,53016,Monte Argentario,GR,49,30,60,3,0,93,18,69,9,0,96
2020,53016,Monte Argentario,GR,50,37,80,5,0,122,19,68,4,5,96
2020,53016,Monte Argentario,GR,51,22,73,5,1,101,14,81,12,5,112
2020,53016,Monte Argentario,GR,52,22,63,3,0,88,22,62,14,7,105
2020,53016,Monte Argentario,GR,53,15,86,2,0,103,22,83,13,4,122
2020,53016,Monte Argentario,GR,54,23,81,7,0,111,24,90,11,6,131
2020,53016,Monte Argentario,GR,55,23,63,10,1,97,15,80,11,1,107
2020,53016,Monte Argentario,GR,56,12,79,6,0,97,10,76,12,4,102
2020,53016,Monte Argentario,GR,57,14,82,11,1,108,14,74,9,4,101
2020,53016,Monte Argentario,GR,58,15,76,8,0,99,17,68,6,4,95
2020,53016,Monte Argentario,GR,59,15,66,11,1,93,12,70,3,4,89
2020,53016,Monte Argentario,GR,60,12,70,11,2,95,9,45,3,3,60
2020,53016,Monte Argentario,GR,61,11,65,9,1,86,9,61,7,8,85
2020,53016,Monte Argentario,GR,62,15,49,10,0,74,12,70,8,6,96
2020,53016,Monte Argentario,GR,63,10,55,5,4,74,8,67,7,8,90
2020,53016,Monte Argentario,GR,64,12,77,1,1,91,8,88,9,5,110
2020,53016,Monte Argentario,GR,65,13,63,4,2,82,6,63,8,6,83
2020,53016,Monte Argentario,GR,66,11,53,6,1,71,8,63,6,14,91
2020,53016,Monte Argentario,GR,67,10,65,1,3,79,4,43,3,8,58
2020,53016,Monte Argentario,GR,68,2,57,4,3,66,8,60,2,18,88
2020,53016,Monte Argentario,GR,69,6,50,3,2,61,4,53,2,14,73
2020,53016,Monte Argentario,GR,70,9,78,3,2,92,10,59,5,13,87
2020,53016,Monte Argentario,GR,71,6,66,3,6,81,7,71,1,20,99
2020,53016,Monte Argentario,GR,72,10,76,8,3,97,5,73,3,22,103
2020,53016,Monte Argentario,GR,73,6,72,4,5,87,6,52,1,31,90
2020,53016,Monte Argentario,GR,74,3,63,5,4,75,9,73,1,28,111
2020,53016,Monte Argentario,GR,75,4,65,4,7,80,5,66,1,25,97
2020,53016,Monte Argentario,GR,76,3,43,0,7,53,5,45,0,22,72
2020,53016,Monte Argentario,GR,77,3,49,1,10,63,5,39,0,30,74
2020,53016,Monte Argentario,GR,78,5,53,1,6,65,4,45,1,32,82
2020,53016,Monte Argentario,GR,79,3,62,1,9,75,4,35,3,29,71
2020,53016,Monte Argentario,GR,80,3,57,1,5,66,6,30,1,36,73
2020,53016,Monte Argentario,GR,81,4,41,2,6,53,6,24,4,38,72
2020,53016,Monte Argentario,GR,82,4,45,0,11,60,4,23,0,42,69
2020,53016,Monte Argentario,GR,83,1,31,0,0,32,8,27,1,44,80
2020,53016,Monte Argentario,GR,84,1,26,0,11,38,4,17,0,26,47
2020,53016,Monte Argentario,GR,85,2,30,0,6,38,4,15,0,35,54
2020,53016,Monte Argentario,GR,86,2,24,0,8,34,1,9,0,35,45
2020,53016,Monte Argentario,GR,87,0,15,1,4,20,0,9,0,34,43
2020,53016,Monte Argentario,GR,88,1,11,0,4,16,1,4,0,26,31
2020,53016,Monte Argentario,GR,89,1,23,0,4,28,2,3,1,19,25
2020,53016,Monte Argentario,GR,90,1,12,0,4,17,3,4,0,20,27
2020,53016,Monte Argentario,GR,91,1,4,0,2,7,1,3,0,17,21
2020,53016,Monte Argentario,GR,92,0,7,0,5,12,0,0,0,14,14
2020,53016,Monte Argentario,GR,93,0,6,0,4,10,0,0,0,13,13
2020,53016,Monte Argentario,GR,94,0,2,0,2,4,2,1,0,16,19
2020,53016,Monte Argentario,GR,95,0,0,0,1,1,0,0,0,6,6
2020,53016,Monte Argentario,GR,96,0,1,0,0,1,0,0,0,11,11
2020,53016,Monte Argentario,GR,97,0,0,0,0,0,0,0,0,7,7
2020,53016,Monte Argentario,GR,98,0,0,0,1,1,1,0,1,0,2
2020,53016,Monte Argentario,GR,99,0,0,0,1,1,0,0,0,2,2
2020,53016,Monte Argentario,GR,100 e più,0,0,0,1,1,0,0,0,4,4
2020,53017,Montieri,GR,0,2,0,0,0,2,2,0,0,0,2
2020,53017,Montieri,GR,1,5,0,0,0,5,4,0,0,0,4
2020,53017,Montieri,GR,2,3,0,0,0,3,0,0,0,0,0
2020,53017,Montieri,GR,3,4,0,0,0,4,4,0,0,0,4
2020,53017,Montieri,GR,4,6,0,0,0,6,9,0,0,0,9
2020,53017,Montieri,GR,5,2,0,0,0,2,1,0,0,0,1
2020,53017,Montieri,GR,6,5,0,0,0,5,5,0,0,0,5
2020,53017,Montieri,GR,7,6,0,0,0,6,4,0,0,0,4
2020,53017,Montieri,GR,8,5,0,0,0,5,4,0,0,0,4
2020,53017,Montieri,GR,9,3,0,0,0,3,5,0,0,0,5
2020,53017,Montieri,GR,10,2,0,0,0,2,6,0,0,0,6
2020,53017,Montieri,GR,11,6,0,0,0,6,8,0,0,0,8
2020,53017,Montieri,GR,12,9,0,0,0,9,7,0,0,0,7
2020,53017,Montieri,GR,13,4,0,0,0,4,2,0,0,0,2
2020,53017,Montieri,GR,14,6,0,0,0,6,7,0,0,0,7
2020,53017,Montieri,GR,15,5,0,0,0,5,7,0,0,0,7
2020,53017,Montieri,GR,16,10,0,0,0,10,7,0,0,0,7
2020,53017,Montieri,GR,17,9,0,0,0,9,1,0,0,0,1
2020,53017,Montieri,GR,18,4,0,0,0,4,7,0,0,0,7
2020,53017,Montieri,GR,19,4,0,0,0,4,2,0,0,0,2
2020,53017,Montieri,GR,20,3,1,0,0,4,3,1,0,0,4
2020,53017,Montieri,GR,21,3,0,0,0,3,6,0,0,0,6
2020,53017,Montieri,GR,22,4,0,0,0,4,2,0,0,0,2
2020,53017,Montieri,GR,23,4,0,0,0,4,3,0,0,0,3
2020,53017,Montieri,GR,24,5,0,0,0,5,2,1,0,0,3
2020,53017,Montieri,GR,25,8,0,0,0,8,1,2,0,0,3
2020,53017,Montieri,GR,26,6,0,0,0,6,5,0,0,0,5
2020,53017,Montieri,GR,27,4,1,0,0,5,2,1,0,0,3
2020,53017,Montieri,GR,28,5,0,0,0,5,2,2,0,0,4
2020,53017,Montieri,GR,29,5,0,0,0,5,5,1,0,0,6
2020,53017,Montieri,GR,30,3,2,0,0,5,3,2,0,0,5
2020,53017,Montieri,GR,31,3,0,0,0,3,0,2,0,0,2
2020,53017,Montieri,GR,32,3,1,0,0,4,1,2,0,0,3
2020,53017,Montieri,GR,33,5,3,0,0,8,4,2,0,0,6
2020,53017,Montieri,GR,34,4,3,0,0,7,4,2,0,0,6
2020,53017,Montieri,GR,35,4,5,0,0,9,3,1,0,0,4
2020,53017,Montieri,GR,36,2,1,0,0,3,3,2,0,0,5
2020,53017,Montieri,GR,37,4,3,0,0,7,2,4,0,0,6
2020,53017,Montieri,GR,38,3,6,0,0,9,2,6,0,0,8
2020,53017,Montieri,GR,39,2,4,1,0,7,2,8,0,0,10
2020,53017,Montieri,GR,40,4,5,0,0,9,3,4,0,0,7
2020,53017,Montieri,GR,41,2,5,2,0,9,1,6,0,0,7
2020,53017,Montieri,GR,42,5,4,1,0,10,1,4,0,0,5
2020,53017,Montieri,GR,43,2,9,0,0,11,3,4,0,0,7
2020,53017,Montieri,GR,44,3,4,1,0,8,2,4,0,0,6
2020,53017,Montieri,GR,45,5,6,0,0,11,5,5,0,0,10
2020,53017,Montieri,GR,46,1,5,0,0,6,2,5,0,0,7
2020,53017,Montieri,GR,47,1,8,0,0,9,3,4,0,0,7
2020,53017,Montieri,GR,48,1,7,1,0,9,2,6,0,0,8
2020,53017,Montieri,GR,49,1,3,0,0,4,0,8,0,0,8
2020,53017,Montieri,GR,50,1,9,0,0,10,0,4,1,0,5
2020,53017,Montieri,GR,51,5,9,1,0,15,1,5,0,0,6
2020,53017,Montieri,GR,52,2,5,1,0,8,1,6,0,0,7
2020,53017,Montieri,GR,53,4,5,0,0,9,1,6,0,0,7
2020,53017,Montieri,GR,54,2,3,2,0,7,1,4,0,0,5
2020,53017,Montieri,GR,55,2,5,0,2,9,0,3,0,0,3
2020,53017,Montieri,GR,56,1,7,0,2,10,3,6,0,0,9
2020,53017,Montieri,GR,57,3,4,1,0,8,1,5,1,1,8
2020,53017,Montieri,GR,58,1,5,0,0,6,2,3,0,1,6
2020,53017,Montieri,GR,59,2,8,0,0,10,0,5,0,1,6
2020,53017,Montieri,GR,60,2,8,1,0,11,1,8,1,1,11
2020,53017,Montieri,GR,61,0,6,0,0,6,0,5,0,0,5
2020,53017,Montieri,GR,62,5,5,0,1,11,1,7,2,1,11
2020,53017,Montieri,GR,63,3,7,1,0,11,0,10,4,2,16
2020,53017,Montieri,GR,64,3,10,1,0,14,0,0,0,1,1
2020,53017,Montieri,GR,65,0,6,0,0,6,1,4,0,1,6
2020,53017,Montieri,GR,66,0,9,2,0,11,1,3,0,3,7
2020,53017,Montieri,GR,67,0,3,0,1,4,0,6,1,0,7
2020,53017,Montieri,GR,68,0,2,1,0,3,0,5,0,1,6
2020,53017,Montieri,GR,69,1,4,1,0,6,0,4,1,2,7
2020,53017,Montieri,GR,70,0,4,0,0,4,0,3,1,3,7
2020,53017,Montieri,GR,71,1,5,0,1,7,1,6,0,1,8
2020,53017,Montieri,GR,72,0,4,0,0,4,0,8,0,4,12
2020,53017,Montieri,GR,73,1,9,0,1,11,0,8,0,4,12
2020,53017,Montieri,GR,74,0,6,0,1,7,0,8,1,2,11
2020,53017,Montieri,GR,75,0,8,0,1,9,0,2,0,1,3
2020,53017,Montieri,GR,76,0,6,1,1,8,1,5,0,0,6
2020,53017,Montieri,GR,77,1,10,1,0,12,0,1,0,4,5
2020,53017,Montieri,GR,78,0,5,0,0,5,2,4,0,3,9
2020,53017,Montieri,GR,79,0,1,0,0,1,2,2,0,2,6
2020,53017,Montieri,GR,80,1,5,1,0,7,1,2,0,5,8
2020,53017,Montieri,GR,81,0,4,0,0,4,0,1,0,3,4
2020,53017,Montieri,GR,82,3,3,0,1,7,2,0,1,6,9
2020,53017,Montieri,GR,83,1,4,1,0,6,0,1,0,3,4
2020,53017,Montieri,GR,84,0,2,0,3,5,0,0,0,6,6
2020,53017,Montieri,GR,85,1,2,0,1,4,1,4,0,3,8
2020,53017,Montieri,GR,86,0,1,0,2,3,0,1,0,1,2
2020,53017,Montieri,GR,87,0,3,0,1,4,0,0,0,4,4
2020,53017,Montieri,GR,88,1,2,0,1,4,0,1,0,2,3
2020,53017,Montieri,GR,89,0,0,0,3,3,1,0,0,7,8
2020,53017,Montieri,GR,90,0,1,0,0,1,0,1,1,5,7
2020,53017,Montieri,GR,91,0,0,0,0,0,1,0,0,4,5
2020,53017,Montieri,GR,92,0,0,0,0,0,0,0,0,4,4
2020,53017,Montieri,GR,93,0,0,0,1,1,0,0,0,3,3
2020,53017,Montieri,GR,94,0,0,0,0,0,0,0,0,1,1
2020,53017,Montieri,GR,95,0,1,0,0,1,0,0,0,0,0
2020,53017,Montieri,GR,96,0,0,0,0,0,0,0,0,3,3
2020,53017,Montieri,GR,97,0,0,0,0,0,0,0,0,1,1
2020,53017,Montieri,GR,98,0,0,0,0,0,0,0,0,0,0
2020,53017,Montieri,GR,99,0,0,0,0,0,0,0,0,1,1
2020,53017,Montieri,GR,100 e più,0,0,0,0,0,0,0,0,1,1
2020,53018,Orbetello,GR,0,39,0,0,0,39,26,0,0,0,26
2020,53018,Orbetello,GR,1,32,0,0,0,32,41,0,0,0,41
2020,53018,Orbetello,GR,2,45,0,0,0,45,40,0,0,0,40
2020,53018,Orbetello,GR,3,49,0,0,0,49,40,0,0,0,40
2020,53018,Orbetello,GR,4,57,0,0,0,57,49,0,0,0,49
2020,53018,Orbetello,GR,5,49,0,0,0,49,46,0,0,0,46
2020,53018,Orbetello,GR,6,43,0,0,0,43,40,0,0,0,40
2020,53018,Orbetello,GR,7,50,0,0,0,50,48,0,0,0,48
2020,53018,Orbetello,GR,8,60,0,0,0,60,53,0,0,0,53
2020,53018,Orbetello,GR,9,58,0,0,0,58,53,0,0,0,53
2020,53018,Orbetello,GR,10,49,0,0,0,49,55,0,0,0,55
2020,53018,Orbetello,GR,11,60,0,0,0,60,49,0,0,0,49
2020,53018,Orbetello,GR,12,42,0,0,0,42,49,0,0,0,49
2020,53018,Orbetello,GR,13,54,0,0,0,54,49,0,0,0,49
2020,53018,Orbetello,GR,14,55,0,0,0,55,59,0,0,0,59
2020,53018,Orbetello,GR,15,66,0,0,0,66,61,0,0,0,61
2020,53018,Orbetello,GR,16,58,0,0,0,58,64,0,0,0,64
2020,53018,Orbetello,GR,17,61,0,0,0,61,53,0,0,0,53
2020,53018,Orbetello,GR,18,57,0,0,0,57,67,0,0,0,67
2020,53018,Orbetello,GR,19,58,1,0,0,59,62,0,0,0,62
2020,53018,Orbetello,GR,20,62,1,0,0,63,63,1,0,0,64
2020,53018,Orbetello,GR,21,68,0,0,0,68,54,1,0,0,55
2020,53018,Orbetello,GR,22,51,0,0,0,51,61,2,0,0,63
2020,53018,Orbetello,GR,23,54,0,0,0,54,39,2,0,0,41
2020,53018,Orbetello,GR,24,65,2,0,0,67,59,3,0,0,62
2020,53018,Orbetello,GR,25,56,3,0,0,59,48,4,0,0,52
2020,53018,Orbetello,GR,26,71,2,0,0,73,56,1,1,0,58
2020,53018,Orbetello,GR,27,71,2,0,0,73,60,6,0,0,66
2020,53018,Orbetello,GR,28,58,1,0,0,59,55,6,1,0,62
2020,53018,Orbetello,GR,29,66,0,0,0,66,64,9,0,0,73
2020,53018,Orbetello,GR,30,63,11,0,0,74,53,8,0,0,61
2020,53018,Orbetello,GR,31,64,8,0,0,72,49,18,0,1,68
2020,53018,Orbetello,GR,32,57,12,1,0,70,55,20,0,0,75
2020,53018,Orbetello,GR,33,49,11,0,0,60,40,21,0,0,61
2020,53018,Orbetello,GR,34,32,17,1,0,50,48,20,0,0,68
2020,53018,Orbetello,GR,35,58,15,1,0,74,33,29,2,0,64
2020,53018,Orbetello,GR,36,55,20,0,0,75,31,31,2,0,64
2020,53018,Orbetello,GR,37,52,26,0,0,78,33,42,2,0,77
2020,53018,Orbetello,GR,38,45,24,0,0,69,28,33,0,0,61
2020,53018,Orbetello,GR,39,39,29,2,0,70,33,46,5,0,84
2020,53018,Orbetello,GR,40,51,20,4,0,75,35,38,6,0,79
2020,53018,Orbetello,GR,41,42,26,3,0,71,36,39,6,1,82
2020,53018,Orbetello,GR,42,40,36,2,0,78,33,48,8,0,89
2020,53018,Orbetello,GR,43,29,54,1,1,85,35,66,4,5,110
2020,53018,Orbetello,GR,44,37,48,1,0,86,46,64,10,3,123
2020,53018,Orbetello,GR,45,45,47,2,0,94,43,38,2,1,84
2020,53018,Orbetello,GR,46,45,55,5,0,105,50,66,10,2,128
2020,53018,Orbetello,GR,47,44,64,5,0,113,34,71,11,2,118
2020,53018,Orbetello,GR,48,41,53,5,0,99,30,88,8,4,130
2020,53018,Orbetello,GR,49,29,65,6,1,101,27,78,12,3,120
2020,53018,Orbetello,GR,50,35,61,3,0,99,31,76,7,3,117
2020,53018,Orbetello,GR,51,33,78,9,0,120,28,81,10,2,121
2020,53018,Orbetello,GR,52,37,89,13,0,139,26,77,13,5,121
2020,53018,Orbetello,GR,53,45,83,7,1,136,29,72,10,1,112
2020,53018,Orbetello,GR,54,22,74,19,0,115,18,83,17,4,122
2020,53018,Orbetello,GR,55,24,72,8,1,105,12,103,13,3,131
2020,53018,Orbetello,GR,56,21,97,10,0,128,17,100,17,7,141
2020,53018,Orbetello,GR,57,21,91,7,5,124,16,102,13,6,137
2020,53018,Orbetello,GR,58,21,89,10,3,123,11,87,9,8,115
2020,53018,Orbetello,GR,59,18,99,17,0,134,15,77,15,5,112
2020,53018,Orbetello,GR,60,13,78,13,2,106,12,94,18,4,128
2020,53018,Orbetello,GR,61,12,81,9,1,103,8,85,13,7,113
2020,53018,Orbetello,GR,62,12,70,13,3,98,15,74,9,19,117
2020,53018,Orbetello,GR,63,13,81,11,4,109,15,85,12,12,124
2020,53018,Orbetello,GR,64,9,72,10,1,92,20,84,10,14,128
2020,53018,Orbetello,GR,65,14,83,3,6,106,7,88,10,18,123
2020,53018,Orbetello,GR,66,10,78,11,3,102,10,81,9,13,113
2020,53018,Orbetello,GR,67,6,73,2,0,81,6,64,6,10,86
2020,53018,Orbetello,GR,68,8,86,6,5,105,9,61,9,12,91
2020,53018,Orbetello,GR,69,4,76,6,5,91,13,59,9,14,95
2020,53018,Orbetello,GR,70,12,84,3,4,103,13,74,8,15,110
2020,53018,Orbetello,GR,71,3,72,8,6,89,9,77,3,28,117
2020,53018,Orbetello,GR,72,5,91,3,6,105,9,84,7,22,122
2020,53018,Orbetello,GR,73,2,80,1,6,89,6,68,4,30,108
2020,53018,Orbetello,GR,74,10,92,2,5,109,3,55,3,28,89
2020,53018,Orbetello,GR,75,1,69,1,8,79,2,55,3,38,98
2020,53018,Orbetello,GR,76,5,55,4,7,71,3,47,2,30,82
2020,53018,Orbetello,GR,77,1,55,3,4,63,7,53,2,34,96
2020,53018,Orbetello,GR,78,5,47,1,9,62,2,40,3,36,81
2020,53018,Orbetello,GR,79,3,52,3,10,68,3,42,4,29,78
2020,53018,Orbetello,GR,80,2,53,5,8,68,7,53,4,61,125
2020,53018,Orbetello,GR,81,3,53,2,15,73,3,43,0,46,92
2020,53018,Orbetello,GR,82,2,56,2,10,70,3,35,1,47,86
2020,53018,Orbetello,GR,83,3,35,0,5,43,1,23,1,44,69
2020,53018,Orbetello,GR,84,0,34,1,9,44,1,18,3,53,75
2020,53018,Orbetello,GR,85,2,40,0,7,49,6,11,1,34,52
2020,53018,Orbetello,GR,86,2,26,0,12,40,1,15,1,31,48
2020,53018,Orbetello,GR,87,2,27,1,14,44,1,9,0,36,46
2020,53018,Orbetello,GR,88,3,17,1,7,28,2,14,0,40,56
2020,53018,Orbetello,GR,89,2,20,0,4,26,0,4,0,39,43
2020,53018,Orbetello,GR,90,0,9,0,4,13,3,4,0,35,42
2020,53018,Orbetello,GR,91,0,11,0,5,16,1,3,0,32,36
2020,53018,Orbetello,GR,92,0,6,0,5,11,1,3,0,23,27
2020,53018,Orbetello,GR,93,0,6,0,4,10,1,1,0,19,21
2020,53018,Orbetello,GR,94,0,4,0,2,6,1,3,0,15,19
2020,53018,Orbetello,GR,95,0,2,0,4,6,0,0,0,16,16
2020,53018,Orbetello,GR,96,0,0,0,4,4,2,0,0,10,12
2020,53018,Orbetello,GR,97,1,0,0,3,4,0,0,0,10,10
2020,53018,Orbetello,GR,98,0,1,0,0,1,0,1,0,8,9
2020,53018,Orbetello,GR,99,0,0,0,1,1,1,0,0,3,4
2020,53018,Orbetello,GR,100 e più,0,0,0,0,0,0,0,0,2,2
2020,53019,Pitigliano,GR,0,6,0,0,0,6,9,0,0,0,9
2020,53019,Pitigliano,GR,1,9,0,0,0,9,3,0,0,0,3
2020,53019,Pitigliano,GR,2,8,0,0,0,8,8,0,0,0,8
2020,53019,Pitigliano,GR,3,6,0,0,0,6,4,0,0,0,4
2020,53019,Pitigliano,GR,4,18,0,0,0,18,8,0,0,0,8
2020,53019,Pitigliano,GR,5,5,0,0,0,5,17,0,0,0,17
2020,53019,Pitigliano,GR,6,20,0,0,0,20,10,0,0,0,10
2020,53019,Pitigliano,GR,7,9,0,0,0,9,9,0,0,0,9
2020,53019,Pitigliano,GR,8,8,0,0,0,8,8,0,0,0,8
2020,53019,Pitigliano,GR,9,16,0,0,0,16,13,0,0,0,13
2020,53019,Pitigliano,GR,10,11,0,0,0,11,17,0,0,0,17
2020,53019,Pitigliano,GR,11,18,0,0,0,18,14,0,0,0,14
2020,53019,Pitigliano,GR,12,15,0,0,0,15,15,0,0,0,15
2020,53019,Pitigliano,GR,13,17,0,0,0,17,13,0,0,0,13
2020,53019,Pitigliano,GR,14,11,0,0,0,11,22,0,0,0,22
2020,53019,Pitigliano,GR,15,23,0,0,0,23,10,0,0,0,10
2020,53019,Pitigliano,GR,16,10,0,0,0,10,13,0,0,0,13
2020,53019,Pitigliano,GR,17,17,0,0,0,17,12,0,0,0,12
2020,53019,Pitigliano,GR,18,16,0,0,0,16,11,0,0,0,11
2020,53019,Pitigliano,GR,19,14,0,0,0,14,14,0,0,0,14
2020,53019,Pitigliano,GR,20,14,0,0,0,14,13,0,0,0,13
2020,53019,Pitigliano,GR,21,22,0,0,0,22,8,0,0,0,8
2020,53019,Pitigliano,GR,22,26,0,0,0,26,18,0,0,0,18
2020,53019,Pitigliano,GR,23,12,0,0,0,12,16,0,0,0,16
2020,53019,Pitigliano,GR,24,11,0,0,0,11,14,0,0,0,14
2020,53019,Pitigliano,GR,25,15,0,0,0,15,16,1,0,0,17
2020,53019,Pitigliano,GR,26,18,0,0,0,18,11,0,0,0,11
2020,53019,Pitigliano,GR,27,16,0,0,0,16,13,0,0,0,13
2020,53019,Pitigliano,GR,28,18,0,0,0,18,19,2,0,0,21
2020,53019,Pitigliano,GR,29,21,0,0,0,21,15,2,0,0,17
2020,53019,Pitigliano,GR,30,13,1,0,0,14,15,0,0,0,15
2020,53019,Pitigliano,GR,31,19,0,0,0,19,16,2,0,0,18
2020,53019,Pitigliano,GR,32,11,2,0,0,13,19,6,0,1,26
2020,53019,Pitigliano,GR,33,13,4,0,0,17,11,6,0,0,17
2020,53019,Pitigliano,GR,34,11,3,0,0,14,7,3,0,0,10
2020,53019,Pitigliano,GR,35,9,5,0,0,14,6,4,1,0,11
2020,53019,Pitigliano,GR,36,11,4,0,0,15,10,6,0,0,16
2020,53019,Pitigliano,GR,37,14,3,0,0,17,8,7,1,0,16
2020,53019,Pitigliano,GR,38,10,4,0,0,14,14,8,4,0,26
2020,53019,Pitigliano,GR,39,13,4,0,0,17,7,12,0,0,19
2020,53019,Pitigliano,GR,40,6,5,1,0,12,6,11,1,0,18
2020,53019,Pitigliano,GR,41,11,8,0,0,19,9,15,1,1,26
2020,53019,Pitigliano,GR,42,14,13,0,0,27,6,14,2,0,22
2020,53019,Pitigliano,GR,43,12,14,0,0,26,5,15,0,0,20
2020,53019,Pitigliano,GR,44,6,19,1,0,26,5,15,3,0,23
2020,53019,Pitigliano,GR,45,9,13,3,0,25,8,20,3,0,31
2020,53019,Pitigliano,GR,46,11,16,1,0,28,6,13,1,0,20
2020,53019,Pitigliano,GR,47,11,18,1,0,30,14,28,5,1,48
2020,53019,Pitigliano,GR,48,15,12,2,0,29,4,25,2,0,31
2020,53019,Pitigliano,GR,49,4,19,0,0,23,3,20,0,0,23
2020,53019,Pitigliano,GR,50,7,19,2,0,28,10,18,5,0,33
2020,53019,Pitigliano,GR,51,11,15,1,0,27,6,22,2,0,30
2020,53019,Pitigliano,GR,52,4,19,1,0,24,7,17,2,2,28
2020,53019,Pitigliano,GR,53,8,15,2,1,26,3,27,2,1,33
2020,53019,Pitigliano,GR,54,7,17,1,0,25,2,23,4,2,31
2020,53019,Pitigliano,GR,55,5,18,3,0,26,7,22,1,2,32
2020,53019,Pitigliano,GR,56,7,18,6,0,31,1,33,2,1,37
2020,53019,Pitigliano,GR,57,1,22,2,1,26,3,23,3,1,30
2020,53019,Pitigliano,GR,58,3,31,1,0,35,1,20,4,3,28
2020,53019,Pitigliano,GR,59,3,23,1,2,29,3,22,2,1,28
2020,53019,Pitigliano,GR,60,3,20,1,0,24,0,24,4,2,30
2020,53019,Pitigliano,GR,61,4,23,1,0,28,0,23,1,0,24
2020,53019,Pitigliano,GR,62,6,20,2,0,28,3,24,4,4,35
2020,53019,Pitigliano,GR,63,3,23,0,0,26,1,16,3,1,21
2020,53019,Pitigliano,GR,64,2,26,3,0,31,4,15,3,2,24
2020,53019,Pitigliano,GR,65,0,12,6,0,18,0,23,1,4,28
2020,53019,Pitigliano,GR,66,0,21,2,0,23,5,17,2,3,27
2020,53019,Pitigliano,GR,67,2,14,2,1,19,4,20,2,6,32
2020,53019,Pitigliano,GR,68,2,19,1,1,23,1,18,0,2,21
2020,53019,Pitigliano,GR,69,6,33,0,0,39,1,21,0,2,24
2020,53019,Pitigliano,GR,70,0,18,1,1,20,1,7,1,4,13
2020,53019,Pitigliano,GR,71,4,19,0,1,24,4,16,1,2,23
2020,53019,Pitigliano,GR,72,2,25,2,0,29,2,21,0,6,29
2020,53019,Pitigliano,GR,73,4,23,1,2,30,1,23,2,11,37
2020,53019,Pitigliano,GR,74,0,12,3,2,17,2,22,2,10,36
2020,53019,Pitigliano,GR,75,2,12,0,2,16,3,22,0,8,33
2020,53019,Pitigliano,GR,76,0,13,2,1,16,0,12,0,7,19
2020,53019,Pitigliano,GR,77,0,14,1,2,17,1,15,0,7,23
2020,53019,Pitigliano,GR,78,1,13,0,0,14,2,12,0,5,19
2020,53019,Pitigliano,GR,79,3,18,1,0,22,3,6,0,8,17
2020,53019,Pitigliano,GR,80,0,14,0,1,15,1,13,1,15,30
2020,53019,Pitigliano,GR,81,1,15,0,4,20,0,8,1,5,14
2020,53019,Pitigliano,GR,82,1,16,0,2,19,2,9,1,8,20
2020,53019,Pitigliano,GR,83,2,15,1,2,20,4,7,0,11,22
2020,53019,Pitigliano,GR,84,2,7,0,3,12,3,7,1,12,23
2020,53019,Pitigliano,GR,85,2,12,0,3,17,1,8,0,16,25
2020,53019,Pitigliano,GR,86,0,7,0,5,12,1,3,0,9,13
2020,53019,Pitigliano,GR,87,0,8,0,2,10,3,3,0,13,19
2020,53019,Pitigliano,GR,88,0,10,0,0,10,0,3,0,10,13
2020,53019,Pitigliano,GR,89,1,7,0,2,10,0,4,0,17,21
2020,53019,Pitigliano,GR,90,1,2,0,2,5,0,1,0,11,12
2020,53019,Pitigliano,GR,91,0,2,0,3,5,0,0,0,7,7
2020,53019,Pitigliano,GR,92,0,2,0,3,5,0,0,0,10,10
2020,53019,Pitigliano,GR,93,0,2,0,3,5,0,0,0,9,9
2020,53019,Pitigliano,GR,94,0,0,0,0,0,0,0,0,8,8
2020,53019,Pitigliano,GR,95,0,0,0,1,1,0,1,0,3,4
2020,53019,Pitigliano,GR,96,0,1,0,0,1,0,0,0,4,4
2020,53019,Pitigliano,GR,97,0,0,0,0,0,0,0,0,3,3
2020,53019,Pitigliano,GR,98,0,0,0,0,0,1,0,0,4,5
2020,53019,Pitigliano,GR,99,0,1,0,0,1,0,0,0,1,1
2020,53019,Pitigliano,GR,100 e più,0,0,0,0,0,0,0,0,1,1
2020,53020,Roccalbegna,GR,0,1,0,0,0,1,0,0,0,0,0
2020,53020,Roccalbegna,GR,1,0,0,0,0,0,4,0,0,0,4
2020,53020,Roccalbegna,GR,2,3,0,0,0,3,2,0,0,0,2
2020,53020,Roccalbegna,GR,3,3,0,0,0,3,0,0,0,0,0
2020,53020,Roccalbegna,GR,4,4,0,0,0,4,3,0,0,0,3
2020,53020,Roccalbegna,GR,5,1,0,0,0,1,1,0,0,0,1
2020,53020,Roccalbegna,GR,6,4,0,0,0,4,2,0,0,0,2
2020,53020,Roccalbegna,GR,7,2,0,0,0,2,2,0,0,0,2
2020,53020,Roccalbegna,GR,8,4,0,0,0,4,3,0,0,0,3
2020,53020,Roccalbegna,GR,9,5,0,0,0,5,1,0,0,0,1
2020,53020,Roccalbegna,GR,10,1,0,0,0,1,3,0,0,0,3
2020,53020,Roccalbegna,GR,11,4,0,0,0,4,5,0,0,0,5
2020,53020,Roccalbegna,GR,12,3,0,0,0,3,4,0,0,0,4
2020,53020,Roccalbegna,GR,13,7,0,0,0,7,1,0,0,0,1
2020,53020,Roccalbegna,GR,14,2,0,0,0,2,4,0,0,0,4
2020,53020,Roccalbegna,GR,15,2,0,0,0,2,4,0,0,0,4
2020,53020,Roccalbegna,GR,16,7,0,0,0,7,6,0,0,0,6
2020,53020,Roccalbegna,GR,17,3,0,0,0,3,2,0,0,0,2
2020,53020,Roccalbegna,GR,18,2,0,0,0,2,1,0,0,0,1
2020,53020,Roccalbegna,GR,19,4,0,0,0,4,5,0,0,0,5
2020,53020,Roccalbegna,GR,20,3,0,0,0,3,2,0,0,0,2
2020,53020,Roccalbegna,GR,21,9,0,0,0,9,2,0,0,0,2
2020,53020,Roccalbegna,GR,22,2,0,0,0,2,5,0,0,0,5
2020,53020,Roccalbegna,GR,23,3,0,0,0,3,0,0,0,0,0
2020,53020,Roccalbegna,GR,24,3,0,0,0,3,0,0,0,0,0
2020,53020,Roccalbegna,GR,25,1,0,0,0,1,2,1,0,0,3
2020,53020,Roccalbegna,GR,26,4,0,0,0,4,4,1,0,0,5
2020,53020,Roccalbegna,GR,27,6,0,0,0,6,2,0,0,0,2
2020,53020,Roccalbegna,GR,28,3,0,0,0,3,4,0,0,0,4
2020,53020,Roccalbegna,GR,29,2,0,0,0,2,3,0,0,0,3
2020,53020,Roccalbegna,GR,30,5,0,0,0,5,0,0,0,0,0
2020,53020,Roccalbegna,GR,31,3,0,0,0,3,2,1,0,0,3
2020,53020,Roccalbegna,GR,32,0,0,0,0,0,1,1,0,0,2
2020,53020,Roccalbegna,GR,33,2,2,0,0,4,3,1,0,0,4
2020,53020,Roccalbegna,GR,34,1,3,0,0,4,3,1,0,0,4
2020,53020,Roccalbegna,GR,35,4,1,0,0,5,3,1,0,0,4
2020,53020,Roccalbegna,GR,36,1,1,0,0,2,1,2,0,0,3
2020,53020,Roccalbegna,GR,37,3,3,0,0,6,2,3,0,0,5
2020,53020,Roccalbegna,GR,38,3,0,0,0,3,4,2,0,0,6
2020,53020,Roccalbegna,GR,39,2,1,0,0,3,2,1,0,0,3
2020,53020,Roccalbegna,GR,40,3,1,0,0,4,3,0,1,0,4
2020,53020,Roccalbegna,GR,41,3,1,0,0,4,3,2,0,0,5
2020,53020,Roccalbegna,GR,42,4,6,0,0,10,3,3,1,0,7
2020,53020,Roccalbegna,GR,43,1,2,1,0,4,2,3,1,0,6
2020,53020,Roccalbegna,GR,44,8,0,0,0,8,2,4,1,0,7
2020,53020,Roccalbegna,GR,45,2,2,0,0,4,2,8,1,0,11
2020,53020,Roccalbegna,GR,46,7,2,0,0,9,1,2,0,0,3
2020,53020,Roccalbegna,GR,47,1,2,2,0,5,2,4,0,0,6
2020,53020,Roccalbegna,GR,48,5,5,0,0,10,0,2,0,0,2
2020,53020,Roccalbegna,GR,49,0,3,0,0,3,4,5,2,1,12
2020,53020,Roccalbegna,GR,50,2,7,2,0,11,1,5,0,0,6
2020,53020,Roccalbegna,GR,51,6,4,0,0,10,2,7,0,0,9
2020,53020,Roccalbegna,GR,52,4,3,1,0,8,1,10,0,0,11
2020,53020,Roccalbegna,GR,53,6,1,1,0,8,3,12,0,0,15
2020,53020,Roccalbegna,GR,54,1,5,0,0,6,1,3,1,1,6
2020,53020,Roccalbegna,GR,55,4,8,1,1,14,1,3,1,1,6
2020,53020,Roccalbegna,GR,56,1,6,0,0,7,1,7,0,2,10
2020,53020,Roccalbegna,GR,57,3,3,0,0,6,1,8,2,1,12
2020,53020,Roccalbegna,GR,58,2,10,0,0,12,2,6,0,0,8
2020,53020,Roccalbegna,GR,59,4,5,1,0,10,1,6,0,2,9
2020,53020,Roccalbegna,GR,60,0,6,0,0,6,0,7,0,0,7
2020,53020,Roccalbegna,GR,61,3,12,1,0,16,0,2,0,0,2
2020,53020,Roccalbegna,GR,62,1,5,2,1,9,1,4,0,2,7
2020,53020,Roccalbegna,GR,63,4,1,2,0,7,1,11,0,0,12
2020,53020,Roccalbegna,GR,64,2,1,1,0,4,1,2,1,0,4
2020,53020,Roccalbegna,GR,65,1,5,0,1,7,0,5,1,0,6
2020,53020,Roccalbegna,GR,66,1,14,0,0,15,0,6,1,2,9
2020,53020,Roccalbegna,GR,67,2,10,1,0,13,0,4,1,2,7
2020,53020,Roccalbegna,GR,68,1,4,1,0,6,0,6,0,1,7
2020,53020,Roccalbegna,GR,69,2,4,0,0,6,0,3,0,4,7
2020,53020,Roccalbegna,GR,70,1,0,0,1,2,0,2,0,3,5
2020,53020,Roccalbegna,GR,71,1,3,0,0,4,0,5,0,0,5
2020,53020,Roccalbegna,GR,72,1,4,0,1,6,0,4,0,1,5
2020,53020,Roccalbegna,GR,73,1,4,0,0,5,0,3,0,4,7
2020,53020,Roccalbegna,GR,74,0,10,0,0,10,0,3,0,1,4
2020,53020,Roccalbegna,GR,75,1,1,0,0,2,0,3,0,2,5
2020,53020,Roccalbegna,GR,76,1,6,0,0,7,0,3,0,1,4
2020,53020,Roccalbegna,GR,77,0,8,1,0,9,1,6,1,2,10
2020,53020,Roccalbegna,GR,78,2,4,1,1,8,0,0,0,3,3
2020,53020,Roccalbegna,GR,79,3,4,0,0,7,0,3,0,3,6
2020,53020,Roccalbegna,GR,80,1,3,0,0,4,0,5,0,1,6
2020,53020,Roccalbegna,GR,81,0,4,0,0,4,0,1,0,7,8
2020,53020,Roccalbegna,GR,82,1,2,1,2,6,1,2,0,3,6
2020,53020,Roccalbegna,GR,83,0,2,0,0,2,1,0,0,8,9
2020,53020,Roccalbegna,GR,84,2,3,0,0,5,1,3,0,4,8
2020,53020,Roccalbegna,GR,85,0,3,0,0,3,1,2,0,5,8
2020,53020,Roccalbegna,GR,86,0,1,0,0,1,0,1,0,5,6
2020,53020,Roccalbegna,GR,87,1,2,0,0,3,0,0,1,5,6
2020,53020,Roccalbegna,GR,88,0,1,0,0,1,0,0,0,5,5
2020,53020,Roccalbegna,GR,89,0,2,0,2,4,0,0,0,1,1
2020,53020,Roccalbegna,GR,90,0,2,0,0,2,1,0,0,1,2
2020,53020,Roccalbegna,GR,91,0,0,0,0,0,0,0,0,5,5
2020,53020,Roccalbegna,GR,92,0,0,0,0,0,0,0,0,2,2
2020,53020,Roccalbegna,GR,93,0,0,0,1,1,0,0,0,2,2
2020,53020,Roccalbegna,GR,94,0,0,0,0,0,0,0,0,3,3
2020,53020,Roccalbegna,GR,95,0,0,0,1,1,1,0,0,2,3
2020,53020,Roccalbegna,GR,96,1,0,0,0,1,0,0,0,2,2
2020,53020,Roccalbegna,GR,97,0,0,0,0,0,0,0,0,1,1
2020,53020,Roccalbegna,GR,98,0,0,0,0,0,0,0,0,0,0
2020,53020,Roccalbegna,GR,99,0,0,0,0,0,0,0,0,0,0
2020,53020,Roccalbegna,GR,100 e più,0,0,0,0,0,0,0,0,1,1
2020,53021,Roccastrada,GR,0,23,0,0,0,23,25,0,0,0,25
2020,53021,Roccastrada,GR,1,16,0,0,0,16,37,0,0,0,37
2020,53021,Roccastrada,GR,2,32,0,0,0,32,28,0,0,0,28
2020,53021,Roccastrada,GR,3,31,0,0,0,31,35,0,0,0,35
2020,53021,Roccastrada,GR,4,43,0,0,0,43,27,0,0,0,27
2020,53021,Roccastrada,GR,5,28,0,0,0,28,25,0,0,0,25
2020,53021,Roccastrada,GR,6,30,0,0,0,30,34,0,0,0,34
2020,53021,Roccastrada,GR,7,31,0,0,0,31,31,0,0,0,31
2020,53021,Roccastrada,GR,8,26,0,0,0,26,22,0,0,0,22
2020,53021,Roccastrada,GR,9,39,0,0,0,39,31,0,0,0,31
2020,53021,Roccastrada,GR,10,32,0,0,0,32,22,0,0,0,22
2020,53021,Roccastrada,GR,11,40,0,0,0,40,27,0,0,0,27
2020,53021,Roccastrada,GR,12,46,0,0,0,46,28,0,0,0,28
2020,53021,Roccastrada,GR,13,47,0,0,0,47,32,0,0,0,32
2020,53021,Roccastrada,GR,14,38,0,0,0,38,33,0,0,0,33
2020,53021,Roccastrada,GR,15,35,0,0,0,35,34,0,0,0,34
2020,53021,Roccastrada,GR,16,36,0,0,0,36,36,0,0,0,36
2020,53021,Roccastrada,GR,17,30,0,0,0,30,38,0,0,0,38
2020,53021,Roccastrada,GR,18,40,0,0,0,40,45,0,0,0,45
2020,53021,Roccastrada,GR,19,49,0,0,0,49,21,0,0,0,21
2020,53021,Roccastrada,GR,20,38,0,0,0,38,41,1,0,0,42
2020,53021,Roccastrada,GR,21,37,0,0,0,37,39,0,0,0,39
2020,53021,Roccastrada,GR,22,46,0,0,0,46,34,0,0,0,34
2020,53021,Roccastrada,GR,23,31,0,0,0,31,32,4,0,0,36
2020,53021,Roccastrada,GR,24,41,2,0,0,43,27,4,0,0,31
2020,53021,Roccastrada,GR,25,45,1,0,0,46,33,6,0,0,39
2020,53021,Roccastrada,GR,26,38,0,1,0,39,32,7,1,0,40
2020,53021,Roccastrada,GR,27,36,4,0,0,40,34,7,0,0,41
2020,53021,Roccastrada,GR,28,36,4,0,0,40,29,3,0,0,32
2020,53021,Roccastrada,GR,29,35,8,0,0,43,32,8,0,0,40
2020,53021,Roccastrada,GR,30,38,8,0,0,46,33,13,0,0,46
2020,53021,Roccastrada,GR,31,39,5,0,0,44,29,15,0,0,44
2020,53021,Roccastrada,GR,32,26,11,0,0,37,24,10,0,0,34
2020,53021,Roccastrada,GR,33,37,13,0,0,50,27,11,1,0,39
2020,53021,Roccastrada,GR,34,36,7,0,0,43,24,20,1,0,45
2020,53021,Roccastrada,GR,35,28,17,0,0,45,18,16,0,0,34
2020,53021,Roccastrada,GR,36,28,11,2,0,41,19,11,1,0,31
2020,53021,Roccastrada,GR,37,25,18,0,0,43,25,24,2,0,51
2020,53021,Roccastrada,GR,38,34,11,0,0,45,18,24,1,0,43
2020,53021,Roccastrada,GR,39,36,18,2,0,56,15,26,0,0,41
2020,53021,Roccastrada,GR,40,30,17,2,0,49,20,23,1,0,44
2020,53021,Roccastrada,GR,41,19,21,2,0,42,17,27,3,2,49
2020,53021,Roccastrada,GR,42,29,22,3,0,54,22,29,2,0,53
2020,53021,Roccastrada,GR,43,29,28,3,1,61,18,32,2,0,52
2020,53021,Roccastrada,GR,44,26,30,2,0,58,19,35,5,0,59
2020,53021,Roccastrada,GR,45,34,28,0,0,62,18,40,5,0,63
2020,53021,Roccastrada,GR,46,22,32,6,0,60,18,32,5,1,56
2020,53021,Roccastrada,GR,47,20,27,1,1,49,12,51,5,0,68
2020,53021,Roccastrada,GR,48,21,40,5,0,66,14,38,3,2,57
2020,53021,Roccastrada,GR,49,17,51,2,0,70,13,42,7,1,63
2020,53021,Roccastrada,GR,50,16,44,5,0,65,12,57,5,2,76
2020,53021,Roccastrada,GR,51,19,45,8,0,72,12,52,6,0,70
2020,53021,Roccastrada,GR,52,17,41,7,0,65,12,44,4,0,60
2020,53021,Roccastrada,GR,53,17,42,6,0,65,14,50,2,2,68
2020,53021,Roccastrada,GR,54,17,43,6,0,66,14,48,6,6,74
2020,53021,Roccastrada,GR,55,13,62,8,1,84,11,51,9,1,72
2020,53021,Roccastrada,GR,56,13,70,5,0,88,11,55,2,6,74
2020,53021,Roccastrada,GR,57,13,59,4,2,78,10,57,5,3,75
2020,53021,Roccastrada,GR,58,13,49,8,2,72,8,54,4,3,69
2020,53021,Roccastrada,GR,59,12,39,9,0,60,9,61,4,3,77
2020,53021,Roccastrada,GR,60,12,58,1,3,74,10,55,4,6,75
2020,53021,Roccastrada,GR,61,9,41,8,0,58,6,47,6,5,64
2020,53021,Roccastrada,GR,62,12,51,0,2,65,6,30,4,6,46
2020,53021,Roccastrada,GR,63,12,43,4,0,59,6,52,3,8,69
2020,53021,Roccastrada,GR,64,2,52,3,1,58,7,45,4,5,61
2020,53021,Roccastrada,GR,65,6,52,7,2,67,3,42,5,9,59
2020,53021,Roccastrada,GR,66,6,51,2,1,60,6,49,4,4,63
2020,53021,Roccastrada,GR,67,4,43,1,1,49,5,45,4,13,67
2020,53021,Roccastrada,GR,68,1,47,4,2,54,4,43,2,10,59
2020,53021,Roccastrada,GR,69,10,53,3,1,67,8,38,3,13,62
2020,53021,Roccastrada,GR,70,11,46,2,3,62,4,52,0,10,66
2020,53021,Roccastrada,GR,71,5,52,1,4,62,8,38,0,18,64
2020,53021,Roccastrada,GR,72,4,50,1,4,59,7,49,2,21,79
2020,53021,Roccastrada,GR,73,9,42,2,6,59,2,41,3,15,61
2020,53021,Roccastrada,GR,74,3,42,1,4,50,8,37,0,31,76
2020,53021,Roccastrada,GR,75,2,25,2,4,33,2,35,3,17,57
2020,53021,Roccastrada,GR,76,5,46,4,2,57,5,32,2,17,56
2020,53021,Roccastrada,GR,77,4,33,0,4,41,1,21,1,19,42
2020,53021,Roccastrada,GR,78,4,24,0,6,34,2,26,0,22,50
2020,53021,Roccastrada,GR,79,4,30,1,6,41,3,32,1,21,57
2020,53021,Roccastrada,GR,80,5,37,0,9,51,4,30,1,23,58
2020,53021,Roccastrada,GR,81,2,36,1,10,49,1,20,1,35,57
2020,53021,Roccastrada,GR,82,5,37,0,7,49,0,14,1,25,40
2020,53021,Roccastrada,GR,83,4,22,0,3,29,4,15,1,36,56
2020,53021,Roccastrada,GR,84,1,20,1,4,26,2,13,1,30,46
2020,53021,Roccastrada,GR,85,0,23,0,6,29,2,11,0,33,46
2020,53021,Roccastrada,GR,86,3,18,0,7,28,1,5,0,35,41
2020,53021,Roccastrada,GR,87,4,11,0,3,18,1,5,1,26,33
2020,53021,Roccastrada,GR,88,1,9,0,8,18,0,6,0,20,26
2020,53021,Roccastrada,GR,89,3,14,0,3,20,0,4,0,20,24
2020,53021,Roccastrada,GR,90,0,4,0,3,7,0,2,0,24,26
2020,53021,Roccastrada,GR,91,0,2,0,4,6,0,1,1,22,24
2020,53021,Roccastrada,GR,92,0,4,0,1,5,0,1,0,18,19
2020,53021,Roccastrada,GR,93,0,2,0,2,4,0,1,0,30,31
2020,53021,Roccastrada,GR,94,1,3,0,2,6,0,0,0,10,10
2020,53021,Roccastrada,GR,95,0,3,0,0,3,0,0,0,10,10
2020,53021,Roccastrada,GR,96,0,0,0,0,0,1,0,0,7,8
2020,53021,Roccastrada,GR,97,0,0,0,0,0,1,0,0,3,4
2020,53021,Roccastrada,GR,98,0,0,0,0,0,0,0,0,3,3
2020,53021,Roccastrada,GR,99,0,0,0,0,0,0,0,0,0,0
2020,53021,Roccastrada,GR,100 e più,0,0,0,1,1,0,0,0,0,0
2020,53022,Santa Fiora,GR,0,7,0,0,0,7,5,0,0,0,5
2020,53022,Santa Fiora,GR,1,4,0,0,0,4,3,0,0,0,3
2020,53022,Santa Fiora,GR,2,13,0,0,0,13,2,0,0,0,2
2020,53022,Santa Fiora,GR,3,7,0,0,0,7,3,0,0,0,3
2020,53022,Santa Fiora,GR,4,6,0,0,0,6,9,0,0,0,9
2020,53022,Santa Fiora,GR,5,11,0,0,0,11,11,0,0,0,11
2020,53022,Santa Fiora,GR,6,7,0,0,0,7,8,0,0,0,8
2020,53022,Santa Fiora,GR,7,3,0,0,0,3,12,0,0,0,12
2020,53022,Santa Fiora,GR,8,13,0,0,0,13,4,0,0,0,4
2020,53022,Santa Fiora,GR,9,6,0,0,0,6,5,0,0,0,5
2020,53022,Santa Fiora,GR,10,6,0,0,0,6,2,0,0,0,2
2020,53022,Santa Fiora,GR,11,10,0,0,0,10,3,0,0,0,3
2020,53022,Santa Fiora,GR,12,8,0,0,0,8,11,0,0,0,11
2020,53022,Santa Fiora,GR,13,10,0,0,0,10,6,0,0,0,6
2020,53022,Santa Fiora,GR,14,12,0,0,0,12,13,0,0,0,13
2020,53022,Santa Fiora,GR,15,11,0,0,0,11,8,0,0,0,8
2020,53022,Santa Fiora,GR,16,9,0,0,0,9,10,0,0,0,10
2020,53022,Santa Fiora,GR,17,10,0,0,0,10,9,0,0,0,9
2020,53022,Santa Fiora,GR,18,8,0,0,0,8,16,0,0,0,16
2020,53022,Santa Fiora,GR,19,12,0,0,0,12,7,0,0,0,7
2020,53022,Santa Fiora,GR,20,11,0,0,0,11,6,0,0,0,6
2020,53022,Santa Fiora,GR,21,10,0,0,0,10,4,0,0,0,4
2020,53022,Santa Fiora,GR,22,8,0,0,0,8,12,0,0,0,12
2020,53022,Santa Fiora,GR,23,11,0,0,0,11,8,1,0,0,9
2020,53022,Santa Fiora,GR,24,15,0,0,0,15,7,0,0,0,7
2020,53022,Santa Fiora,GR,25,12,0,0,0,12,13,1,0,0,14
2020,53022,Santa Fiora,GR,26,15,1,0,0,16,10,1,0,0,11
2020,53022,Santa Fiora,GR,27,10,2,0,0,12,11,2,1,0,14
2020,53022,Santa Fiora,GR,28,18,3,0,0,21,5,3,0,0,8
2020,53022,Santa Fiora,GR,29,6,0,0,0,6,12,1,0,0,13
2020,53022,Santa Fiora,GR,30,8,2,0,0,10,9,2,2,0,13
2020,53022,Santa Fiora,GR,31,9,0,0,0,9,5,4,1,0,10
2020,53022,Santa Fiora,GR,32,14,2,0,0,16,4,4,1,0,9
2020,53022,Santa Fiora,GR,33,4,3,0,0,7,6,1,0,1,8
2020,53022,Santa Fiora,GR,34,7,3,0,0,10,5,9,0,0,14
2020,53022,Santa Fiora,GR,35,2,5,0,0,7,7,5,0,0,12
2020,53022,Santa Fiora,GR,36,7,5,0,0,12,6,4,1,0,11
2020,53022,Santa Fiora,GR,37,10,2,0,0,12,4,8,0,0,12
2020,53022,Santa Fiora,GR,38,8,5,0,0,13,8,9,1,0,18
2020,53022,Santa Fiora,GR,39,12,4,0,0,16,9,4,0,0,13
2020,53022,Santa Fiora,GR,40,10,5,0,0,15,7,3,1,0,11
2020,53022,Santa Fiora,GR,41,4,6,0,0,10,4,9,1,0,14
2020,53022,Santa Fiora,GR,42,4,6,0,0,10,7,5,1,0,13
2020,53022,Santa Fiora,GR,43,5,2,3,0,10,10,9,0,1,20
2020,53022,Santa Fiora,GR,44,13,6,2,0,21,8,4,2,0,14
2020,53022,Santa Fiora,GR,45,12,10,0,0,22,5,10,0,1,16
2020,53022,Santa Fiora,GR,46,11,7,0,0,18,3,13,0,0,16
2020,53022,Santa Fiora,GR,47,5,11,2,0,18,7,11,1,0,19
2020,53022,Santa Fiora,GR,48,7,11,0,0,18,10,7,1,0,18
2020,53022,Santa Fiora,GR,49,3,13,0,0,16,5,18,2,0,25
2020,53022,Santa Fiora,GR,50,7,6,0,0,13,4,11,1,1,17
2020,53022,Santa Fiora,GR,51,4,14,0,0,18,5,17,0,1,23
2020,53022,Santa Fiora,GR,52,8,15,2,0,25,3,9,1,0,13
2020,53022,Santa Fiora,GR,53,4,20,5,0,29,4,15,0,0,19
2020,53022,Santa Fiora,GR,54,5,16,0,0,21,3,14,0,1,18
2020,53022,Santa Fiora,GR,55,3,13,2,0,18,1,16,1,1,19
2020,53022,Santa Fiora,GR,56,7,16,5,1,29,1,23,0,1,25
2020,53022,Santa Fiora,GR,57,5,15,0,0,20,5,13,2,1,21
2020,53022,Santa Fiora,GR,58,2,12,0,0,14,1,21,1,0,23
2020,53022,Santa Fiora,GR,59,7,15,2,1,25,1,13,2,0,16
2020,53022,Santa Fiora,GR,60,1,20,2,0,23,3,20,0,1,24
2020,53022,Santa Fiora,GR,61,1,18,1,0,20,4,12,3,4,23
2020,53022,Santa Fiora,GR,62,4,22,0,1,27,2,10,3,1,16
2020,53022,Santa Fiora,GR,63,3,14,2,0,19,0,12,4,0,16
2020,53022,Santa Fiora,GR,64,1,14,3,1,19,0,7,1,4,12
2020,53022,Santa Fiora,GR,65,4,8,1,0,13,1,10,1,5,17
2020,53022,Santa Fiora,GR,66,2,10,0,1,13,1,14,1,3,19
2020,53022,Santa Fiora,GR,67,3,12,1,1,17,1,11,2,3,17
2020,53022,Santa Fiora,GR,68,2,12,2,2,18,1,9,0,2,12
2020,53022,Santa Fiora,GR,69,2,6,2,2,12,0,12,0,3,15
2020,53022,Santa Fiora,GR,70,0,16,1,0,17,2,14,1,4,21
2020,53022,Santa Fiora,GR,71,1,14,2,1,18,1,8,0,4,13
2020,53022,Santa Fiora,GR,72,3,11,1,0,15,1,13,2,2,18
2020,53022,Santa Fiora,GR,73,2,11,1,0,14,2,5,1,6,14
2020,53022,Santa Fiora,GR,74,2,8,0,0,10,0,11,0,5,16
2020,53022,Santa Fiora,GR,75,2,13,1,2,18,2,11,0,9,22
2020,53022,Santa Fiora,GR,76,1,6,0,0,7,1,6,1,7,15
2020,53022,Santa Fiora,GR,77,1,8,1,0,10,1,12,0,4,17
2020,53022,Santa Fiora,GR,78,2,8,0,3,13,1,9,0,2,12
2020,53022,Santa Fiora,GR,79,1,13,4,4,22,0,9,0,3,12
2020,53022,Santa Fiora,GR,80,0,14,0,0,14,0,14,0,13,27
2020,53022,Santa Fiora,GR,81,0,8,1,5,14,2,7,0,6,15
2020,53022,Santa Fiora,GR,82,0,8,0,2,10,0,9,0,16,25
2020,53022,Santa Fiora,GR,83,1,8,1,5,15,1,1,1,9,12
2020,53022,Santa Fiora,GR,84,1,6,1,0,8,1,5,0,11,17
2020,53022,Santa Fiora,GR,85,1,2,0,2,5,0,2,0,11,13
2020,53022,Santa Fiora,GR,86,0,5,1,3,9,1,3,0,14,18
2020,53022,Santa Fiora,GR,87,1,5,0,2,8,0,0,0,8,8
2020,53022,Santa Fiora,GR,88,0,4,2,1,7,0,2,0,4,6
2020,53022,Santa Fiora,GR,89,1,3,0,4,8,0,1,0,11,12
2020,53022,Santa Fiora,GR,90,0,1,0,3,4,0,3,0,16,19
2020,53022,Santa Fiora,GR,91,0,4,0,2,6,0,1,0,12,13
2020,53022,Santa Fiora,GR,92,0,1,0,3,4,0,0,0,8,8
2020,53022,Santa Fiora,GR,93,0,1,0,0,1,0,0,0,7,7
2020,53022,Santa Fiora,GR,94,0,0,0,0,0,1,0,0,1,2
2020,53022,Santa Fiora,GR,95,0,0,0,0,0,0,0,0,5,5
2020,53022,Santa Fiora,GR,96,0,0,0,1,1,0,0,0,6,6
2020,53022,Santa Fiora,GR,97,0,0,0,0,0,0,0,0,3,3
2020,53022,Santa Fiora,GR,98,0,0,0,0,0,0,0,0,0,0
2020,53022,Santa Fiora,GR,99,0,0,0,0,0,0,0,0,0,0
2020,53022,Santa Fiora,GR,100 e più,0,0,0,1,1,0,0,0,1,1
2020,53023,Scansano,GR,0,15,0,0,0,15,13,0,0,0,13
2020,53023,Scansano,GR,1,16,0,0,0,16,16,0,0,0,16
2020,53023,Scansano,GR,2,12,0,0,0,12,10,0,0,0,10
2020,53023,Scansano,GR,3,21,0,0,0,21,12,0,0,0,12
2020,53023,Scansano,GR,4,12,0,0,0,12,9,0,0,0,9
2020,53023,Scansano,GR,5,21,0,0,0,21,11,0,0,0,11
2020,53023,Scansano,GR,6,16,0,0,0,16,12,0,0,0,12
2020,53023,Scansano,GR,7,15,0,0,0,15,14,0,0,0,14
2020,53023,Scansano,GR,8,17,0,0,0,17,10,0,0,0,10
2020,53023,Scansano,GR,9,19,0,0,0,19,13,0,0,0,13
2020,53023,Scansano,GR,10,16,0,0,0,16,20,0,0,0,20
2020,53023,Scansano,GR,11,18,0,0,0,18,16,0,0,0,16
2020,53023,Scansano,GR,12,17,0,0,0,17,10,0,0,0,10
2020,53023,Scansano,GR,13,22,0,0,0,22,15,0,0,0,15
2020,53023,Scansano,GR,14,17,0,0,0,17,18,0,0,0,18
2020,53023,Scansano,GR,15,21,0,0,0,21,16,0,0,0,16
2020,53023,Scansano,GR,16,10,0,0,0,10,13,0,0,0,13
2020,53023,Scansano,GR,17,15,0,0,0,15,15,0,0,0,15
2020,53023,Scansano,GR,18,17,0,0,0,17,17,0,0,0,17
2020,53023,Scansano,GR,19,22,0,0,0,22,18,0,0,0,18
2020,53023,Scansano,GR,20,26,0,0,0,26,14,1,0,0,15
2020,53023,Scansano,GR,21,19,0,0,0,19,15,3,0,0,18
2020,53023,Scansano,GR,22,19,0,0,0,19,14,3,0,0,17
2020,53023,Scansano,GR,23,20,0,0,0,20,14,2,0,0,16
2020,53023,Scansano,GR,24,26,0,0,0,26,12,4,0,0,16
2020,53023,Scansano,GR,25,20,0,0,0,20,16,0,0,0,16
2020,53023,Scansano,GR,26,15,4,1,0,20,13,3,0,0,16
2020,53023,Scansano,GR,27,21,0,0,0,21,14,7,0,0,21
2020,53023,Scansano,GR,28,20,6,0,0,26,16,8,0,0,24
2020,53023,Scansano,GR,29,21,5,0,0,26,10,7,0,0,17
2020,53023,Scansano,GR,30,20,0,0,0,20,8,7,0,0,15
2020,53023,Scansano,GR,31,17,3,0,0,20,6,1,0,0,7
2020,53023,Scansano,GR,32,22,2,0,0,24,9,8,1,0,18
2020,53023,Scansano,GR,33,16,5,0,0,21,12,8,0,0,20
2020,53023,Scansano,GR,34,18,6,0,0,24,9,9,1,0,19
2020,53023,Scansano,GR,35,16,6,0,0,22,11,7,0,0,18
2020,53023,Scansano,GR,36,16,7,1,0,24,12,7,0,0,19
2020,53023,Scansano,GR,37,15,10,0,0,25,7,9,0,0,16
2020,53023,Scansano,GR,38,10,4,0,0,14,9,13,1,0,23
2020,53023,Scansano,GR,39,12,15,0,0,27,10,9,0,0,19
2020,53023,Scansano,GR,40,18,14,0,0,32,4,12,1,1,18
2020,53023,Scansano,GR,41,11,14,0,0,25,5,12,0,0,17
2020,53023,Scansano,GR,42,12,14,1,0,27,4,14,5,0,23
2020,53023,Scansano,GR,43,19,10,1,0,30,10,13,2,0,25
2020,53023,Scansano,GR,44,20,15,1,0,36,8,22,1,0,31
2020,53023,Scansano,GR,45,17,17,3,1,38,5,16,2,1,24
2020,53023,Scansano,GR,46,13,18,0,0,31,9,13,5,1,28
2020,53023,Scansano,GR,47,6,11,1,0,18,8,24,3,1,36
2020,53023,Scansano,GR,48,11,18,1,0,30,7,17,4,1,29
2020,53023,Scansano,GR,49,11,19,5,0,35,9,22,5,2,38
2020,53023,Scansano,GR,50,15,18,1,0,34,8,21,3,0,32
2020,53023,Scansano,GR,51,12,16,3,0,31,7,28,0,1,36
2020,53023,Scansano,GR,52,15,16,1,1,33,6,20,3,0,29
2020,53023,Scansano,GR,53,11,20,3,0,34,4,21,3,1,29
2020,53023,Scansano,GR,54,9,20,3,0,32,5,22,1,1,29
2020,53023,Scansano,GR,55,9,22,4,0,35,4,20,2,3,29
2020,53023,Scansano,GR,56,10,20,1,1,32,6,21,2,2,31
2020,53023,Scansano,GR,57,11,19,4,0,34,6,26,6,6,44
2020,53023,Scansano,GR,58,12,35,2,0,49,4,32,0,1,37
2020,53023,Scansano,GR,59,11,23,0,1,35,7,23,4,1,35
2020,53023,Scansano,GR,60,6,30,5,0,41,8,17,3,2,30
2020,53023,Scansano,GR,61,12,30,2,0,44,5,17,3,2,27
2020,53023,Scansano,GR,62,4,25,1,0,30,2,24,4,2,32
2020,53023,Scansano,GR,63,5,18,2,1,26,7,24,5,5,41
2020,53023,Scansano,GR,64,3,23,0,1,27,1,24,1,3,29
2020,53023,Scansano,GR,65,3,20,2,0,25,6,31,0,4,41
2020,53023,Scansano,GR,66,3,20,3,1,27,3,27,3,4,37
2020,53023,Scansano,GR,67,4,28,2,1,35,5,21,0,5,31
2020,53023,Scansano,GR,68,1,30,1,2,34,2,22,0,3,27
2020,53023,Scansano,GR,69,5,23,4,2,34,6,20,4,3,33
2020,53023,Scansano,GR,70,2,21,3,3,29,1,22,1,6,30
2020,53023,Scansano,GR,71,2,30,2,1,35,3,17,4,7,31
2020,53023,Scansano,GR,72,7,33,0,3,43,4,22,0,4,30
2020,53023,Scansano,GR,73,2,19,1,1,23,2,20,1,8,31
2020,53023,Scansano,GR,74,2,25,2,3,32,0,20,0,8,28
2020,53023,Scansano,GR,75,2,22,2,2,28,3,12,2,8,25
2020,53023,Scansano,GR,76,2,21,2,2,27,4,16,1,10,31
2020,53023,Scansano,GR,77,2,14,1,0,17,0,13,2,4,19
2020,53023,Scansano,GR,78,0,16,1,2,19,1,11,0,7,19
2020,53023,Scansano,GR,79,2,22,0,0,24,1,16,2,11,30
2020,53023,Scansano,GR,80,1,10,1,2,14,2,14,1,10,27
2020,53023,Scansano,GR,81,2,11,0,5,18,3,8,0,14,25
2020,53023,Scansano,GR,82,0,19,0,2,21,1,9,0,14,24
2020,53023,Scansano,GR,83,1,14,0,3,18,3,4,0,15,22
2020,53023,Scansano,GR,84,1,17,0,0,18,0,4,0,7,11
2020,53023,Scansano,GR,85,1,7,0,3,11,3,5,1,11,20
2020,53023,Scansano,GR,86,0,7,1,3,11,1,3,0,13,17
2020,53023,Scansano,GR,87,1,8,0,1,10,0,3,0,15,18
2020,53023,Scansano,GR,88,0,4,0,3,7,0,1,0,14,15
2020,53023,Scansano,GR,89,1,2,0,1,4,0,1,0,11,12
2020,53023,Scansano,GR,90,0,3,0,2,5,1,2,0,13,16
2020,53023,Scansano,GR,91,0,2,0,1,3,0,0,0,5,5
2020,53023,Scansano,GR,92,0,1,0,2,3,0,1,0,6,7
2020,53023,Scansano,GR,93,0,1,0,0,1,0,0,0,7,7
2020,53023,Scansano,GR,94,0,1,0,1,2,0,1,0,9,10
2020,53023,Scansano,GR,95,0,1,0,1,2,0,0,0,0,0
2020,53023,Scansano,GR,96,0,0,0,2,2,0,0,0,8,8
2020,53023,Scansano,GR,97,0,0,0,0,0,0,0,0,3,3
2020,53023,Scansano,GR,98,0,0,0,0,0,0,0,0,3,3
2020,53023,Scansano,GR,99,0,0,0,0,0,0,0,0,2,2
2020,53023,Scansano,GR,100 e più,0,0,0,0,0,0,0,0,2,2
2020,53024,Scarlino,GR,0,12,0,0,0,12,7,0,0,0,7
2020,53024,Scarlino,GR,1,11,0,0,0,11,4,0,0,0,4
2020,53024,Scarlino,GR,2,12,0,0,0,12,11,0,0,0,11
2020,53024,Scarlino,GR,3,12,0,0,0,12,19,0,0,0,19
2020,53024,Scarlino,GR,4,16,0,0,0,16,14,0,0,0,14
2020,53024,Scarlino,GR,5,20,0,0,0,20,15,0,0,0,15
2020,53024,Scarlino,GR,6,12,0,0,0,12,20,0,0,0,20
2020,53024,Scarlino,GR,7,12,0,0,0,12,13,0,0,0,13
2020,53024,Scarlino,GR,8,16,0,0,0,16,15,0,0,0,15
2020,53024,Scarlino,GR,9,20,0,0,0,20,10,0,0,0,10
2020,53024,Scarlino,GR,10,14,0,0,0,14,18,0,0,0,18
2020,53024,Scarlino,GR,11,17,0,0,0,17,20,0,0,0,20
2020,53024,Scarlino,GR,12,24,0,0,0,24,15,0,0,0,15
2020,53024,Scarlino,GR,13,21,0,0,0,21,16,0,0,0,16
2020,53024,Scarlino,GR,14,13,0,0,0,13,19,0,0,0,19
2020,53024,Scarlino,GR,15,18,0,0,0,18,14,0,0,0,14
2020,53024,Scarlino,GR,16,20,0,0,0,20,17,0,0,0,17
2020,53024,Scarlino,GR,17,16,0,0,0,16,17,0,0,0,17
2020,53024,Scarlino,GR,18,16,0,0,0,16,14,0,0,0,14
2020,53024,Scarlino,GR,19,16,0,0,0,16,16,0,0,0,16
2020,53024,Scarlino,GR,20,12,0,0,0,12,12,0,0,0,12
2020,53024,Scarlino,GR,21,16,0,0,0,16,13,0,0,0,13
2020,53024,Scarlino,GR,22,16,0,0,0,16,15,0,0,0,15
2020,53024,Scarlino,GR,23,20,0,0,0,20,9,0,0,0,9
2020,53024,Scarlino,GR,24,12,0,0,0,12,7,1,0,0,8
2020,53024,Scarlino,GR,25,11,1,0,0,12,7,1,0,0,8
2020,53024,Scarlino,GR,26,11,1,0,0,12,9,5,0,0,14
2020,53024,Scarlino,GR,27,12,3,0,0,15,14,5,0,0,19
2020,53024,Scarlino,GR,28,12,0,0,0,12,17,4,0,0,21
2020,53024,Scarlino,GR,29,17,0,0,0,17,22,4,0,0,26
2020,53024,Scarlino,GR,30,16,3,0,0,19,13,3,0,0,16
2020,53024,Scarlino,GR,31,20,4,0,0,24,12,5,0,0,17
2020,53024,Scarlino,GR,32,18,6,1,0,25,13,4,0,0,17
2020,53024,Scarlino,GR,33,28,4,0,0,32,12,7,1,0,20
2020,53024,Scarlino,GR,34,15,2,0,0,17,13,2,1,0,16
2020,53024,Scarlino,GR,35,11,4,0,0,15,7,6,2,0,15
2020,53024,Scarlino,GR,36,13,8,1,0,22,10,18,0,0,28
2020,53024,Scarlino,GR,37,21,5,1,0,27,7,10,1,0,18
2020,53024,Scarlino,GR,38,11,4,1,0,16,13,17,1,0,31
2020,53024,Scarlino,GR,39,11,9,0,0,20,14,7,0,0,21
2020,53024,Scarlino,GR,40,19,10,2,0,31,11,21,1,0,33
2020,53024,Scarlino,GR,41,17,16,0,0,33,13,15,2,0,30
2020,53024,Scarlino,GR,42,16,14,1,0,31,8,10,2,1,21
2020,53024,Scarlino,GR,43,20,18,0,0,38,13,10,0,0,23
2020,53024,Scarlino,GR,44,16,14,2,0,32,8,24,2,0,34
2020,53024,Scarlino,GR,45,16,17,3,0,36,8,17,5,0,30
2020,53024,Scarlino,GR,46,11,17,1,0,29,6,29,2,1,38
2020,53024,Scarlino,GR,47,11,19,3,0,33,14,17,1,0,32
2020,53024,Scarlino,GR,48,18,22,2,0,42,15,20,5,3,43
2020,53024,Scarlino,GR,49,14,26,2,0,42,7,17,5,0,29
2020,53024,Scarlino,GR,50,11,14,3,0,28,5,19,2,0,26
2020,53024,Scarlino,GR,51,8,28,3,0,39,6,20,3,0,29
2020,53024,Scarlino,GR,52,5,17,4,0,26,11,23,4,1,39
2020,53024,Scarlino,GR,53,8,16,2,0,26,3,22,5,0,30
2020,53024,Scarlino,GR,54,7,21,3,0,31,3,26,3,3,35
2020,53024,Scarlino,GR,55,6,29,3,1,39,8,31,7,1,47
2020,53024,Scarlino,GR,56,8,23,4,0,35,4,23,4,1,32
2020,53024,Scarlino,GR,57,11,24,2,0,37,2,27,3,3,35
2020,53024,Scarlino,GR,58,2,27,1,0,30,5,18,4,0,27
2020,53024,Scarlino,GR,59,2,23,3,0,28,4,23,2,1,30
2020,53024,Scarlino,GR,60,6,20,3,0,29,2,15,2,1,20
2020,53024,Scarlino,GR,61,1,25,1,1,28,2,23,1,1,27
2020,53024,Scarlino,GR,62,2,18,2,0,22,3,17,2,1,23
2020,53024,Scarlino,GR,63,2,25,5,1,33,5,25,4,1,35
2020,53024,Scarlino,GR,64,2,18,2,0,22,0,16,3,4,23
2020,53024,Scarlino,GR,65,5,16,2,1,24,2,19,1,7,29
2020,53024,Scarlino,GR,66,1,18,2,2,23,1,16,2,1,20
2020,53024,Scarlino,GR,67,1,24,0,2,27,1,20,0,2,23
2020,53024,Scarlino,GR,68,1,17,2,0,20,3,13,0,5,21
2020,53024,Scarlino,GR,69,0,27,1,0,28,2,10,0,3,15
2020,53024,Scarlino,GR,70,1,19,2,1,23,1,13,1,5,20
2020,53024,Scarlino,GR,71,2,20,0,2,24,2,15,0,10,27
2020,53024,Scarlino,GR,72,2,32,3,1,38,1,20,0,3,24
2020,53024,Scarlino,GR,73,2,17,3,5,27,1,23,2,3,29
2020,53024,Scarlino,GR,74,2,20,0,1,23,2,21,0,4,27
2020,53024,Scarlino,GR,75,0,16,1,1,18,1,9,0,2,12
2020,53024,Scarlino,GR,76,0,18,2,2,22,0,9,0,3,12
2020,53024,Scarlino,GR,77,0,14,0,2,16,1,8,0,6,15
2020,53024,Scarlino,GR,78,2,11,0,2,15,0,6,0,8,14
2020,53024,Scarlino,GR,79,0,7,0,3,10,1,6,1,6,14
2020,53024,Scarlino,GR,80,0,18,0,2,20,0,14,0,10,24
2020,53024,Scarlino,GR,81,0,15,0,3,18,0,10,0,9,19
2020,53024,Scarlino,GR,82,1,11,0,2,14,1,12,0,10,23
2020,53024,Scarlino,GR,83,3,4,2,0,9,0,2,0,8,10
2020,53024,Scarlino,GR,84,0,7,0,2,9,0,5,0,3,8
2020,53024,Scarlino,GR,85,0,4,0,3,7,1,5,0,8,14
2020,53024,Scarlino,GR,86,0,8,0,2,10,0,4,0,8,12
2020,53024,Scarlino,GR,87,0,6,0,1,7,0,3,0,3,6
2020,53024,Scarlino,GR,88,0,3,0,2,5,0,1,0,7,8
2020,53024,Scarlino,GR,89,1,5,0,1,7,0,1,0,8,9
2020,53024,Scarlino,GR,90,0,2,0,1,3,0,0,0,9,9
2020,53024,Scarlino,GR,91,0,3,0,3,6,0,0,0,8,8
2020,53024,Scarlino,GR,92,0,3,0,2,5,1,1,0,10,12
2020,53024,Scarlino,GR,93,0,0,0,0,0,0,0,0,2,2
2020,53024,Scarlino,GR,94,0,1,0,1,2,1,0,0,3,4
2020,53024,Scarlino,GR,95,0,0,0,1,1,0,0,0,4,4
2020,53024,Scarlino,GR,96,0,0,0,0,0,0,0,0,3,3
2020,53024,Scarlino,GR,97,0,0,0,0,0,0,1,0,1,2
2020,53024,Scarlino,GR,98,0,0,0,0,0,0,0,0,1,1
2020,53024,Scarlino,GR,99,0,0,0,0,0,0,0,0,0,0
2020,53024,Scarlino,GR,100 e più,0,0,0,0,0,0,0,0,0,0
2020,53025,Seggiano,GR,0,3,0,0,0,3,5,0,0,0,5
2020,53025,Seggiano,GR,1,6,0,0,0,6,9,0,0,0,9
2020,53025,Seggiano,GR,2,2,0,0,0,2,4,0,0,0,4
2020,53025,Seggiano,GR,3,4,0,0,0,4,4,0,0,0,4
2020,53025,Seggiano,GR,4,1,0,0,0,1,3,0,0,0,3
2020,53025,Seggiano,GR,5,5,0,0,0,5,1,0,0,0,1
2020,53025,Seggiano,GR,6,8,0,0,0,8,2,0,0,0,2
2020,53025,Seggiano,GR,7,3,0,0,0,3,0,0,0,0,0
2020,53025,Seggiano,GR,8,3,0,0,0,3,4,0,0,0,4
2020,53025,Seggiano,GR,9,2,0,0,0,2,4,0,0,0,4
2020,53025,Seggiano,GR,10,6,0,0,0,6,0,0,0,0,0
2020,53025,Seggiano,GR,11,4,0,0,0,4,7,0,0,0,7
2020,53025,Seggiano,GR,12,7,0,0,0,7,3,0,0,0,3
2020,53025,Seggiano,GR,13,4,0,0,0,4,2,0,0,0,2
2020,53025,Seggiano,GR,14,2,0,0,0,2,2,0,0,0,2
2020,53025,Seggiano,GR,15,1,0,0,0,1,3,0,0,0,3
2020,53025,Seggiano,GR,16,3,0,0,0,3,3,0,0,0,3
2020,53025,Seggiano,GR,17,5,0,0,0,5,6,0,0,0,6
2020,53025,Seggiano,GR,18,4,0,0,0,4,5,0,0,0,5
2020,53025,Seggiano,GR,19,7,0,0,0,7,4,0,0,0,4
2020,53025,Seggiano,GR,20,4,0,0,0,4,7,0,0,0,7
2020,53025,Seggiano,GR,21,3,0,0,0,3,7,1,0,0,8
2020,53025,Seggiano,GR,22,10,0,0,0,10,2,1,0,0,3
2020,53025,Seggiano,GR,23,6,0,0,0,6,1,0,0,0,1
2020,53025,Seggiano,GR,24,3,0,0,0,3,1,1,0,0,2
2020,53025,Seggiano,GR,25,2,0,0,0,2,3,0,0,0,3
2020,53025,Seggiano,GR,26,4,1,0,0,5,0,1,0,0,1
2020,53025,Seggiano,GR,27,3,0,0,0,3,1,4,0,0,5
2020,53025,Seggiano,GR,28,6,1,0,0,7,6,0,0,0,6
2020,53025,Seggiano,GR,29,5,0,0,0,5,5,0,0,0,5
2020,53025,Seggiano,GR,30,2,1,0,0,3,6,1,0,0,7
2020,53025,Seggiano,GR,31,3,2,0,0,5,5,3,0,0,8
2020,53025,Seggiano,GR,32,6,1,0,0,7,1,3,0,0,4
2020,53025,Seggiano,GR,33,0,1,0,0,1,2,5,0,0,7
2020,53025,Seggiano,GR,34,5,2,0,0,7,4,1,0,0,5
2020,53025,Seggiano,GR,35,3,2,0,0,5,4,1,0,0,5
2020,53025,Seggiano,GR,36,2,3,2,0,7,1,4,0,0,5
2020,53025,Seggiano,GR,37,3,0,0,0,3,2,1,0,0,3
2020,53025,Seggiano,GR,38,4,1,0,0,5,1,1,0,0,2
2020,53025,Seggiano,GR,39,5,7,0,0,12,1,2,1,0,4
2020,53025,Seggiano,GR,40,4,3,0,0,7,1,1,0,0,2
2020,53025,Seggiano,GR,41,5,4,0,0,9,2,7,1,0,10
2020,53025,Seggiano,GR,42,4,2,0,0,6,4,1,0,0,5
2020,53025,Seggiano,GR,43,3,4,0,0,7,3,2,3,0,8
2020,53025,Seggiano,GR,44,2,3,0,0,5,1,5,0,0,6
2020,53025,Seggiano,GR,45,1,5,0,0,6,5,1,0,1,7
2020,53025,Seggiano,GR,46,5,6,1,0,12,6,3,0,0,9
2020,53025,Seggiano,GR,47,3,7,0,0,10,2,3,1,0,6
2020,53025,Seggiano,GR,48,5,3,0,0,8,2,4,0,0,6
2020,53025,Seggiano,GR,49,6,1,0,0,7,0,4,0,0,4
2020,53025,Seggiano,GR,50,6,5,0,0,11,4,5,0,0,9
2020,53025,Seggiano,GR,51,2,4,0,0,6,5,2,0,0,7
2020,53025,Seggiano,GR,52,2,2,0,0,4,0,3,0,2,5
2020,53025,Seggiano,GR,53,0,2,2,2,6,0,4,1,0,5
2020,53025,Seggiano,GR,54,2,3,1,0,6,0,7,0,1,8
2020,53025,Seggiano,GR,55,1,7,1,0,9,3,2,0,0,5
2020,53025,Seggiano,GR,56,0,5,1,0,6,1,2,1,0,4
2020,53025,Seggiano,GR,57,1,3,1,1,6,1,2,3,0,6
2020,53025,Seggiano,GR,58,2,5,3,0,10,1,6,0,1,8
2020,53025,Seggiano,GR,59,1,6,1,0,8,3,5,0,1,9
2020,53025,Seggiano,GR,60,0,5,0,0,5,1,9,0,0,10
2020,53025,Seggiano,GR,61,1,4,0,0,5,1,5,0,1,7
2020,53025,Seggiano,GR,62,3,10,2,0,15,0,4,1,0,5
2020,53025,Seggiano,GR,63,1,3,1,0,5,3,3,0,1,7
2020,53025,Seggiano,GR,64,0,3,0,0,3,1,8,0,0,9
2020,53025,Seggiano,GR,65,1,6,2,1,10,0,7,0,2,9
2020,53025,Seggiano,GR,66,2,8,0,0,10,1,1,1,4,7
2020,53025,Seggiano,GR,67,0,5,0,0,5,0,9,0,0,9
2020,53025,Seggiano,GR,68,0,6,0,0,6,1,6,0,1,8
2020,53025,Seggiano,GR,69,0,4,2,0,6,0,4,0,1,5
2020,53025,Seggiano,GR,70,0,6,0,0,6,0,9,0,0,9
2020,53025,Seggiano,GR,71,0,10,0,1,11,1,6,2,2,11
2020,53025,Seggiano,GR,72,0,6,1,1,8,1,5,0,1,7
2020,53025,Seggiano,GR,73,0,3,0,1,4,0,5,0,3,8
2020,53025,Seggiano,GR,74,0,7,2,1,10,0,0,0,3,3
2020,53025,Seggiano,GR,75,0,4,0,0,4,0,3,0,6,9
2020,53025,Seggiano,GR,76,0,7,0,0,7,1,2,1,3,7
2020,53025,Seggiano,GR,77,0,4,1,0,5,0,2,0,1,3
2020,53025,Seggiano,GR,78,0,1,1,0,2,0,1,0,6,7
2020,53025,Seggiano,GR,79,0,4,0,1,5,0,1,1,3,5
2020,53025,Seggiano,GR,80,0,7,1,0,8,2,1,0,2,5
2020,53025,Seggiano,GR,81,0,2,0,2,4,1,0,0,3,4
2020,53025,Seggiano,GR,82,1,1,0,0,2,0,3,1,1,5
2020,53025,Seggiano,GR,83,0,0,0,0,0,1,1,1,3,6
2020,53025,Seggiano,GR,84,2,0,1,2,5,0,0,0,4,4
2020,53025,Seggiano,GR,85,0,0,0,0,0,1,0,1,3,5
2020,53025,Seggiano,GR,86,1,3,1,0,5,0,1,0,3,4
2020,53025,Seggiano,GR,87,0,1,0,0,1,0,0,0,0,0
2020,53025,Seggiano,GR,88,1,0,0,0,1,0,1,0,2,3
2020,53025,Seggiano,GR,89,1,1,0,1,3,0,2,0,7,9
2020,53025,Seggiano,GR,90,1,1,0,1,3,0,0,0,4,4
2020,53025,Seggiano,GR,91,0,0,0,2,2,0,0,0,5,5
2020,53025,Seggiano,GR,92,0,0,0,3,3,0,0,0,2,2
2020,53025,Seggiano,GR,93,0,1,0,0,1,2,0,0,3,5
2020,53025,Seggiano,GR,94,0,0,0,0,0,0,0,0,3,3
2020,53025,Seggiano,GR,95,0,0,0,0,0,0,0,0,0,0
2020,53025,Seggiano,GR,96,0,1,0,0,1,0,0,0,0,0
2020,53025,Seggiano,GR,97,0,0,0,0,0,0,0,0,1,1
2020,53025,Seggiano,GR,98,0,0,0,1,1,0,0,0,0,0
2020,53025,Seggiano,GR,99,0,0,0,0,0,0,0,0,0,0
2020,53025,Seggiano,GR,100 e più,0,0,0,0,0,0,0,0,1,1
2020,53026,Sorano,GR,0,5,0,0,0,5,5,0,0,0,5
2020,53026,Sorano,GR,1,2,0,0,0,2,3,0,0,0,3
2020,53026,Sorano,GR,2,8,0,0,0,8,10,0,0,0,10
2020,53026,Sorano,GR,3,7,0,0,0,7,9,0,0,0,9
2020,53026,Sorano,GR,4,8,0,0,0,8,4,0,0,0,4
2020,53026,Sorano,GR,5,11,0,0,0,11,7,0,0,0,7
2020,53026,Sorano,GR,6,7,0,0,0,7,4,0,0,0,4
2020,53026,Sorano,GR,7,7,0,0,0,7,11,0,0,0,11
2020,53026,Sorano,GR,8,9,0,0,0,9,10,0,0,0,10
2020,53026,Sorano,GR,9,10,0,0,0,10,8,0,0,0,8
2020,53026,Sorano,GR,10,11,0,0,0,11,8,0,0,0,8
2020,53026,Sorano,GR,11,8,0,0,0,8,11,0,0,0,11
2020,53026,Sorano,GR,12,6,0,0,0,6,5,0,0,0,5
2020,53026,Sorano,GR,13,11,0,0,0,11,15,0,0,0,15
2020,53026,Sorano,GR,14,12,0,0,0,12,5,0,0,0,5
2020,53026,Sorano,GR,15,11,0,0,0,11,13,0,0,0,13
2020,53026,Sorano,GR,16,11,0,0,0,11,10,0,0,0,10
2020,53026,Sorano,GR,17,14,0,0,0,14,15,0,0,0,15
2020,53026,Sorano,GR,18,7,0,0,0,7,14,0,0,0,14
2020,53026,Sorano,GR,19,6,0,0,0,6,8,0,0,0,8
2020,53026,Sorano,GR,20,11,0,0,0,11,7,0,0,0,7
2020,53026,Sorano,GR,21,11,0,0,0,11,15,1,0,0,16
2020,53026,Sorano,GR,22,13,0,0,0,13,7,1,0,0,8
2020,53026,Sorano,GR,23,11,0,0,0,11,14,0,0,0,14
2020,53026,Sorano,GR,24,11,0,0,0,11,6,1,0,0,7
2020,53026,Sorano,GR,25,9,0,0,0,9,8,0,0,1,9
2020,53026,Sorano,GR,26,17,0,0,0,17,10,1,0,0,11
2020,53026,Sorano,GR,27,7,0,0,0,7,7,1,0,0,8
2020,53026,Sorano,GR,28,7,1,0,0,8,13,0,0,0,13
2020,53026,Sorano,GR,29,11,1,0,0,12,11,2,0,0,13
2020,53026,Sorano,GR,30,11,0,0,0,11,7,3,0,0,10
2020,53026,Sorano,GR,31,12,0,0,0,12,8,2,0,0,10
2020,53026,Sorano,GR,32,11,1,0,0,12,12,4,0,0,16
2020,53026,Sorano,GR,33,8,0,0,0,8,9,5,0,0,14
2020,53026,Sorano,GR,34,14,3,0,0,17,5,7,0,0,12
2020,53026,Sorano,GR,35,9,1,0,0,10,8,8,0,0,16
2020,53026,Sorano,GR,36,9,4,0,0,13,6,6,0,0,12
2020,53026,Sorano,GR,37,6,6,0,0,12,7,7,0,0,14
2020,53026,Sorano,GR,38,8,5,1,0,14,8,8,0,0,16
2020,53026,Sorano,GR,39,11,6,0,0,17,7,8,1,0,16
2020,53026,Sorano,GR,40,14,8,0,0,22,5,2,0,1,8
2020,53026,Sorano,GR,41,14,7,0,0,21,6,8,0,0,14
2020,53026,Sorano,GR,42,12,11,0,0,23,4,12,0,0,16
2020,53026,Sorano,GR,43,7,3,0,0,10,1,10,0,1,12
2020,53026,Sorano,GR,44,10,12,1,0,23,6,13,1,0,20
2020,53026,Sorano,GR,45,10,8,0,0,18,4,15,0,0,19
2020,53026,Sorano,GR,46,2,13,0,0,15,7,16,0,0,23
2020,53026,Sorano,GR,47,9,12,2,1,24,6,15,1,0,22
2020,53026,Sorano,GR,48,10,12,0,1,23,5,15,2,0,22
2020,53026,Sorano,GR,49,11,12,0,0,23,6,14,2,1,23
2020,53026,Sorano,GR,50,6,12,0,0,18,6,14,3,0,23
2020,53026,Sorano,GR,51,10,11,3,0,24,7,17,1,0,25
2020,53026,Sorano,GR,52,5,15,0,0,20,5,18,2,1,26
2020,53026,Sorano,GR,53,7,19,4,0,30,3,17,1,1,22
2020,53026,Sorano,GR,54,7,15,3,0,25,5,20,3,0,28
2020,53026,Sorano,GR,55,9,20,1,0,30,6,20,3,1,30
2020,53026,Sorano,GR,56,5,19,2,0,26,2,19,3,4,28
2020,53026,Sorano,GR,57,10,17,6,0,33,3,22,4,2,31
2020,53026,Sorano,GR,58,5,19,1,0,25,6,20,2,0,28
2020,53026,Sorano,GR,59,5,22,5,0,32,2,29,2,1,34
2020,53026,Sorano,GR,60,3,20,4,0,27,6,21,1,1,29
2020,53026,Sorano,GR,61,7,13,1,0,21,2,15,1,4,22
2020,53026,Sorano,GR,62,7,21,1,0,29,2,18,3,3,26
2020,53026,Sorano,GR,63,2,15,0,1,18,2,16,1,3,22
2020,53026,Sorano,GR,64,2,15,1,0,18,4,21,3,2,30
2020,53026,Sorano,GR,65,7,29,3,1,40,2,19,0,3,24
2020,53026,Sorano,GR,66,5,21,3,1,30,2,20,2,4,28
2020,53026,Sorano,GR,67,6,31,1,0,38,0,20,0,4,24
2020,53026,Sorano,GR,68,4,27,3,2,36,2,13,1,7,23
2020,53026,Sorano,GR,69,5,22,1,3,31,1,25,1,4,31
2020,53026,Sorano,GR,70,2,19,2,2,25,0,19,0,5,24
2020,53026,Sorano,GR,71,1,22,1,2,26,2,12,1,5,20
2020,53026,Sorano,GR,72,2,19,1,5,27,2,11,2,12,27
2020,53026,Sorano,GR,73,4,18,1,0,23,0,13,1,3,17
2020,53026,Sorano,GR,74,1,18,0,2,21,3,17,0,7,27
2020,53026,Sorano,GR,75,4,11,1,1,17,0,10,0,6,16
2020,53026,Sorano,GR,76,6,18,0,1,25,0,12,0,12,24
2020,53026,Sorano,GR,77,1,20,1,2,24,0,7,1,11,19
2020,53026,Sorano,GR,78,2,5,1,0,8,0,14,0,10,24
2020,53026,Sorano,GR,79,0,13,1,2,16,1,11,0,7,19
2020,53026,Sorano,GR,80,2,14,1,1,18,0,12,0,9,21
2020,53026,Sorano,GR,81,2,12,1,3,18,0,6,0,9,15
2020,53026,Sorano,GR,82,3,16,1,6,26,0,6,0,12,18
2020,53026,Sorano,GR,83,0,11,0,4,15,0,3,1,15,19
2020,53026,Sorano,GR,84,2,9,0,3,14,1,4,0,11,16
2020,53026,Sorano,GR,85,1,8,0,4,13,1,6,1,14,22
2020,53026,Sorano,GR,86,0,6,0,5,11,0,3,0,14,17
2020,53026,Sorano,GR,87,1,4,0,2,7,0,4,0,18,22
2020,53026,Sorano,GR,88,0,5,0,2,7,3,2,0,12,17
2020,53026,Sorano,GR,89,1,4,0,2,7,0,0,0,13,13
2020,53026,Sorano,GR,90,1,2,0,2,5,0,4,0,7,11
2020,53026,Sorano,GR,91,1,3,0,1,5,0,2,0,10,12
2020,53026,Sorano,GR,92,1,4,0,1,6,0,1,0,12,13
2020,53026,Sorano,GR,93,0,1,0,0,1,0,0,0,2,2
2020,53026,Sorano,GR,94,0,2,0,1,3,0,0,0,1,1
2020,53026,Sorano,GR,95,0,1,0,0,1,0,0,1,5,6
2020,53026,Sorano,GR,96,0,0,0,1,1,0,0,0,6,6
2020,53026,Sorano,GR,97,0,0,0,0,0,0,0,0,3,3
2020,53026,Sorano,GR,98,0,0,0,0,0,0,0,0,1,1
2020,53026,Sorano,GR,99,0,0,0,0,0,0,0,0,3,3
2020,53026,Sorano,GR,100 e più,0,0,0,0,0,0,0,0,3,3
2020,53027,Monterotondo Marittimo,GR,0,3,0,0,0,3,4,0,0,0,4
2020,53027,Monterotondo Marittimo,GR,1,5,0,0,0,5,3,0,0,0,3
2020,53027,Monterotondo Marittimo,GR,2,4,0,0,0,4,2,0,0,0,2
2020,53027,Monterotondo Marittimo,GR,3,7,0,0,0,7,5,0,0,0,5
2020,53027,Monterotondo Marittimo,GR,4,6,0,0,0,6,3,0,0,0,3
2020,53027,Monterotondo Marittimo,GR,5,6,0,0,0,6,4,0,0,0,4
2020,53027,Monterotondo Marittimo,GR,6,4,0,0,0,4,7,0,0,0,7
2020,53027,Monterotondo Marittimo,GR,7,5,0,0,0,5,3,0,0,0,3
2020,53027,Monterotondo Marittimo,GR,8,6,0,0,0,6,7,0,0,0,7
2020,53027,Monterotondo Marittimo,GR,9,8,0,0,0,8,10,0,0,0,10
2020,53027,Monterotondo Marittimo,GR,10,3,0,0,0,3,5,0,0,0,5
2020,53027,Monterotondo Marittimo,GR,11,3,0,0,0,3,4,0,0,0,4
2020,53027,Monterotondo Marittimo,GR,12,3,0,0,0,3,6,0,0,0,6
2020,53027,Monterotondo Marittimo,GR,13,4,0,0,0,4,12,0,0,0,12
2020,53027,Monterotondo Marittimo,GR,14,4,0,0,0,4,2,0,0,0,2
2020,53027,Monterotondo Marittimo,GR,15,7,0,0,0,7,6,0,0,0,6
2020,53027,Monterotondo Marittimo,GR,16,6,0,0,0,6,3,0,0,0,3
2020,53027,Monterotondo Marittimo,GR,17,5,0,0,0,5,4,0,0,0,4
2020,53027,Monterotondo Marittimo,GR,18,10,0,0,0,10,7,0,0,0,7
2020,53027,Monterotondo Marittimo,GR,19,6,0,0,0,6,5,0,0,0,5
2020,53027,Monterotondo Marittimo,GR,20,5,0,0,0,5,3,0,0,0,3
2020,53027,Monterotondo Marittimo,GR,21,12,0,0,0,12,4,1,0,0,5
2020,53027,Monterotondo Marittimo,GR,22,10,0,0,0,10,8,1,0,0,9
2020,53027,Monterotondo Marittimo,GR,23,8,0,0,0,8,5,0,0,0,5
2020,53027,Monterotondo Marittimo,GR,24,10,0,0,0,10,7,1,0,0,8
2020,53027,Monterotondo Marittimo,GR,25,9,1,0,0,10,3,3,0,0,6
2020,53027,Monterotondo Marittimo,GR,26,9,1,0,0,10,7,2,0,0,9
2020,53027,Monterotondo Marittimo,GR,27,5,0,0,0,5,1,0,0,0,1
2020,53027,Monterotondo Marittimo,GR,28,6,1,0,0,7,5,2,0,0,7
2020,53027,Monterotondo Marittimo,GR,29,6,1,0,0,7,5,4,0,0,9
2020,53027,Monterotondo Marittimo,GR,30,7,1,0,0,8,2,1,0,0,3
2020,53027,Monterotondo Marittimo,GR,31,9,2,0,0,11,5,5,0,0,10
2020,53027,Monterotondo Marittimo,GR,32,8,2,0,0,10,1,2,0,0,3
2020,53027,Monterotondo Marittimo,GR,33,5,0,0,0,5,2,4,0,0,6
2020,53027,Monterotondo Marittimo,GR,34,3,2,0,0,5,2,2,0,0,4
2020,53027,Monterotondo Marittimo,GR,35,4,7,0,0,11,1,3,0,0,4
2020,53027,Monterotondo Marittimo,GR,36,2,6,0,0,8,6,1,0,0,7
2020,53027,Monterotondo Marittimo,GR,37,5,6,0,0,11,2,2,1,0,5
2020,53027,Monterotondo Marittimo,GR,38,4,4,0,0,8,3,9,0,0,12
2020,53027,Monterotondo Marittimo,GR,39,3,4,0,0,7,2,4,0,0,6
2020,53027,Monterotondo Marittimo,GR,40,6,8,0,0,14,4,1,1,0,6
2020,53027,Monterotondo Marittimo,GR,41,0,9,0,0,9,0,6,0,0,6
2020,53027,Monterotondo Marittimo,GR,42,4,2,0,0,6,2,2,1,0,5
2020,53027,Monterotondo Marittimo,GR,43,3,5,0,0,8,2,3,1,0,6
2020,53027,Monterotondo Marittimo,GR,44,4,4,1,0,9,0,1,0,0,1
2020,53027,Monterotondo Marittimo,GR,45,2,4,0,0,6,0,5,0,0,5
2020,53027,Monterotondo Marittimo,GR,46,4,5,0,0,9,0,9,0,0,9
2020,53027,Monterotondo Marittimo,GR,47,5,9,0,0,14,1,6,0,0,7
2020,53027,Monterotondo Marittimo,GR,48,5,5,0,0,10,2,6,0,0,8
2020,53027,Monterotondo Marittimo,GR,49,7,5,0,0,12,0,9,0,0,9
2020,53027,Monterotondo Marittimo,GR,50,1,4,0,0,5,1,7,2,0,10
2020,53027,Monterotondo Marittimo,GR,51,4,8,0,0,12,0,8,0,0,8
2020,53027,Monterotondo Marittimo,GR,52,2,10,0,0,12,3,6,1,1,11
2020,53027,Monterotondo Marittimo,GR,53,1,4,0,0,5,1,8,1,0,10
2020,53027,Monterotondo Marittimo,GR,54,2,8,2,0,12,2,2,0,0,4
2020,53027,Monterotondo Marittimo,GR,55,0,6,1,1,8,1,8,0,0,9
2020,53027,Monterotondo Marittimo,GR,56,3,8,1,0,12,1,5,2,1,9
2020,53027,Monterotondo Marittimo,GR,57,3,10,0,0,13,1,7,0,1,9
2020,53027,Monterotondo Marittimo,GR,58,0,4,2,0,6,1,5,3,2,11
2020,53027,Monterotondo Marittimo,GR,59,1,12,1,0,14,0,3,0,0,3
2020,53027,Monterotondo Marittimo,GR,60,2,8,2,0,12,2,11,0,0,13
2020,53027,Monterotondo Marittimo,GR,61,2,4,2,0,8,1,3,1,1,6
2020,53027,Monterotondo Marittimo,GR,62,1,0,0,1,2,1,9,2,0,12
2020,53027,Monterotondo Marittimo,GR,63,0,9,1,1,11,1,2,2,0,5
2020,53027,Monterotondo Marittimo,GR,64,0,5,1,0,6,0,6,1,1,8
2020,53027,Monterotondo Marittimo,GR,65,0,3,0,0,3,0,9,0,0,9
2020,53027,Monterotondo Marittimo,GR,66,3,9,0,0,12,0,6,0,2,8
2020,53027,Monterotondo Marittimo,GR,67,0,12,0,0,12,0,9,0,0,9
2020,53027,Monterotondo Marittimo,GR,68,0,8,2,0,10,1,5,1,0,7
2020,53027,Monterotondo Marittimo,GR,69,1,7,2,0,10,0,3,0,3,6
2020,53027,Monterotondo Marittimo,GR,70,0,13,0,1,14,2,3,0,0,5
2020,53027,Monterotondo Marittimo,GR,71,0,2,0,0,2,1,9,0,0,10
2020,53027,Monterotondo Marittimo,GR,72,1,3,1,0,5,0,3,0,3,6
2020,53027,Monterotondo Marittimo,GR,73,1,6,0,0,7,2,3,0,3,8
2020,53027,Monterotondo Marittimo,GR,74,0,5,0,0,5,0,1,0,4,5
2020,53027,Monterotondo Marittimo,GR,75,1,4,0,0,5,0,2,0,2,4
2020,53027,Monterotondo Marittimo,GR,76,1,9,0,0,10,0,3,0,5,8
2020,53027,Monterotondo Marittimo,GR,77,0,3,1,0,4,0,0,0,4,4
2020,53027,Monterotondo Marittimo,GR,78,1,1,0,2,4,2,5,0,3,10
2020,53027,Monterotondo Marittimo,GR,79,1,6,0,1,8,0,6,0,1,7
2020,53027,Monterotondo Marittimo,GR,80,1,2,0,2,5,0,5,0,2,7
2020,53027,Monterotondo Marittimo,GR,81,2,0,0,0,2,0,3,0,3,6
2020,53027,Monterotondo Marittimo,GR,82,1,4,1,0,6,0,3,0,5,8
2020,53027,Monterotondo Marittimo,GR,83,1,2,0,1,4,0,1,0,4,5
2020,53027,Monterotondo Marittimo,GR,84,0,3,0,0,3,0,3,0,6,9
2020,53027,Monterotondo Marittimo,GR,85,0,3,1,1,5,0,1,0,3,4
2020,53027,Monterotondo Marittimo,GR,86,0,3,0,1,4,0,0,0,2,2
2020,53027,Monterotondo Marittimo,GR,87,0,5,0,0,5,0,0,0,4,4
2020,53027,Monterotondo Marittimo,GR,88,0,1,0,1,2,0,2,0,2,4
2020,53027,Monterotondo Marittimo,GR,89,0,1,0,0,1,1,2,0,3,6
2020,53027,Monterotondo Marittimo,GR,90,2,4,0,3,9,0,1,0,6,7
2020,53027,Monterotondo Marittimo,GR,91,1,0,0,1,2,0,0,0,5,5
2020,53027,Monterotondo Marittimo,GR,92,1,0,0,0,1,0,0,0,4,4
2020,53027,Monterotondo Marittimo,GR,93,1,1,0,0,2,0,0,0,1,1
2020,53027,Monterotondo Marittimo,GR,94,1,0,0,0,1,0,0,0,4,4
2020,53027,Monterotondo Marittimo,GR,95,0,0,0,0,0,0,0,0,1,1
2020,53027,Monterotondo Marittimo,GR,96,0,0,0,0,0,0,0,0,0,0
2020,53027,Monterotondo Marittimo,GR,97,0,0,0,0,0,1,0,0,0,1
2020,53027,Monterotondo Marittimo,GR,98,0,0,0,0,0,0,0,0,0,0
2020,53027,Monterotondo Marittimo,GR,99,0,0,0,0,0,0,0,0,0,0
2020,53027,Monterotondo Marittimo,GR,100 e più,0,0,0,0,0,0,0,0,0,0
2020,53028,Semproniano,GR,0,2,0,0,0,2,0,0,0,0,0
2020,53028,Semproniano,GR,1,3,0,0,0,3,1,0,0,0,1
2020,53028,Semproniano,GR,2,5,0,0,0,5,3,0,0,0,3
2020,53028,Semproniano,GR,3,1,0,0,0,1,6,0,0,0,6
2020,53028,Semproniano,GR,4,2,0,0,0,2,1,0,0,0,1
2020,53028,Semproniano,GR,5,2,0,0,0,2,3,0,0,0,3
2020,53028,Semproniano,GR,6,5,0,0,0,5,0,0,0,0,0
2020,53028,Semproniano,GR,7,2,0,0,0,2,3,0,0,0,3
2020,53028,Semproniano,GR,8,3,0,0,0,3,5,0,0,0,5
2020,53028,Semproniano,GR,9,3,0,0,0,3,3,0,0,0,3
2020,53028,Semproniano,GR,10,5,0,0,0,5,2,0,0,0,2
2020,53028,Semproniano,GR,11,3,0,0,0,3,2,0,0,0,2
2020,53028,Semproniano,GR,12,1,0,0,0,1,2,0,0,0,2
2020,53028,Semproniano,GR,13,2,0,0,0,2,3,0,0,0,3
2020,53028,Semproniano,GR,14,6,0,0,0,6,5,0,0,0,5
2020,53028,Semproniano,GR,15,5,0,0,0,5,1,0,0,0,1
2020,53028,Semproniano,GR,16,4,0,0,0,4,2,0,0,0,2
2020,53028,Semproniano,GR,17,4,0,0,0,4,4,0,0,0,4
2020,53028,Semproniano,GR,18,2,0,0,0,2,3,0,0,0,3
2020,53028,Semproniano,GR,19,4,0,0,0,4,2,0,0,0,2
2020,53028,Semproniano,GR,20,3,0,0,0,3,4,1,0,0,5
2020,53028,Semproniano,GR,21,4,0,0,0,4,4,0,0,0,4
2020,53028,Semproniano,GR,22,0,0,0,0,0,3,0,0,0,3
2020,53028,Semproniano,GR,23,3,1,0,0,4,7,0,0,0,7
2020,53028,Semproniano,GR,24,4,0,0,0,4,2,0,0,0,2
2020,53028,Semproniano,GR,25,2,0,0,0,2,4,0,0,0,4
2020,53028,Semproniano,GR,26,1,0,0,0,1,3,3,0,0,6
2020,53028,Semproniano,GR,27,2,0,0,0,2,3,0,0,0,3
2020,53028,Semproniano,GR,28,1,0,0,0,1,4,2,0,0,6
2020,53028,Semproniano,GR,29,4,0,0,0,4,1,1,0,0,2
2020,53028,Semproniano,GR,30,2,2,0,0,4,3,2,0,0,5
2020,53028,Semproniano,GR,31,1,0,0,0,1,3,1,0,0,4
2020,53028,Semproniano,GR,32,5,1,0,0,6,1,3,0,0,4
2020,53028,Semproniano,GR,33,1,3,0,0,4,3,1,0,0,4
2020,53028,Semproniano,GR,34,4,2,0,0,6,1,2,0,0,3
2020,53028,Semproniano,GR,35,2,4,0,0,6,1,3,0,0,4
2020,53028,Semproniano,GR,36,5,1,0,0,6,4,2,0,0,6
2020,53028,Semproniano,GR,37,4,0,0,0,4,0,3,0,0,3
2020,53028,Semproniano,GR,38,6,4,0,0,10,3,2,0,0,5
2020,53028,Semproniano,GR,39,3,1,0,0,4,0,1,1,0,2
2020,53028,Semproniano,GR,40,1,2,1,0,4,1,2,0,0,3
2020,53028,Semproniano,GR,41,3,2,0,0,5,0,0,0,0,0
2020,53028,Semproniano,GR,42,1,4,0,0,5,1,5,0,0,6
2020,53028,Semproniano,GR,43,1,5,0,0,6,0,5,0,0,5
2020,53028,Semproniano,GR,44,1,2,0,0,3,2,2,0,0,4
2020,53028,Semproniano,GR,45,5,2,2,0,9,2,2,0,0,4
2020,53028,Semproniano,GR,46,3,4,0,0,7,4,4,0,2,10
2020,53028,Semproniano,GR,47,1,5,1,0,7,2,3,0,0,5
2020,53028,Semproniano,GR,48,1,1,0,0,2,1,3,1,0,5
2020,53028,Semproniano,GR,49,3,2,0,0,5,0,2,0,0,2
2020,53028,Semproniano,GR,50,1,4,1,0,6,3,5,0,0,8
2020,53028,Semproniano,GR,51,2,6,0,0,8,3,5,1,0,9
2020,53028,Semproniano,GR,52,5,3,0,0,8,1,3,1,0,5
2020,53028,Semproniano,GR,53,2,6,0,0,8,3,8,1,0,12
2020,53028,Semproniano,GR,54,1,6,0,0,7,1,10,0,0,11
2020,53028,Semproniano,GR,55,2,4,0,0,6,2,5,2,0,9
2020,53028,Semproniano,GR,56,2,6,1,0,9,0,5,0,0,5
2020,53028,Semproniano,GR,57,4,4,0,0,8,1,3,1,1,6
2020,53028,Semproniano,GR,58,1,6,1,0,8,1,3,3,0,7
2020,53028,Semproniano,GR,59,3,6,0,0,9,2,9,0,1,12
2020,53028,Semproniano,GR,60,4,8,1,0,13,1,5,1,0,7
2020,53028,Semproniano,GR,61,4,2,2,0,8,0,3,0,1,4
2020,53028,Semproniano,GR,62,0,6,0,2,8,2,5,0,0,7
2020,53028,Semproniano,GR,63,1,5,2,0,8,0,3,1,1,5
2020,53028,Semproniano,GR,64,1,4,0,0,5,2,2,2,0,6
2020,53028,Semproniano,GR,65,3,2,0,0,5,3,4,2,3,12
2020,53028,Semproniano,GR,66,2,5,0,0,7,1,7,0,2,10
2020,53028,Semproniano,GR,67,1,6,0,0,7,2,9,0,1,12
2020,53028,Semproniano,GR,68,2,3,2,0,7,0,6,0,2,8
2020,53028,Semproniano,GR,69,0,8,2,0,10,0,4,0,2,6
2020,53028,Semproniano,GR,70,1,10,1,1,13,1,5,0,0,6
2020,53028,Semproniano,GR,71,1,4,0,0,5,1,4,0,2,7
2020,53028,Semproniano,GR,72,1,9,0,1,11,1,5,0,2,8
2020,53028,Semproniano,GR,73,1,6,0,0,7,2,6,0,4,12
2020,53028,Semproniano,GR,74,0,8,0,2,10,1,3,0,4,8
2020,53028,Semproniano,GR,75,0,10,0,0,10,1,6,0,1,8
2020,53028,Semproniano,GR,76,1,4,0,0,5,0,2,0,7,9
2020,53028,Semproniano,GR,77,1,2,0,1,4,1,2,0,5,8
2020,53028,Semproniano,GR,78,0,4,0,1,5,0,5,0,4,9
2020,53028,Semproniano,GR,79,0,4,0,1,5,0,4,0,7,11
2020,53028,Semproniano,GR,80,0,2,1,0,3,0,1,0,3,4
2020,53028,Semproniano,GR,81,2,5,0,1,8,0,2,0,4,6
2020,53028,Semproniano,GR,82,1,4,0,1,6,1,4,0,6,11
2020,53028,Semproniano,GR,83,0,3,0,0,3,0,1,0,7,8
2020,53028,Semproniano,GR,84,0,5,0,1,6,0,4,0,5,9
2020,53028,Semproniano,GR,85,0,2,0,1,3,1,1,0,5,7
2020,53028,Semproniano,GR,86,0,1,0,1,2,0,1,0,6,7
2020,53028,Semproniano,GR,87,3,2,0,1,6,1,0,0,4,5
2020,53028,Semproniano,GR,88,0,1,0,1,2,0,0,0,7,7
2020,53028,Semproniano,GR,89,0,3,0,1,4,0,0,0,3,3
2020,53028,Semproniano,GR,90,1,0,0,1,2,0,0,0,4,4
2020,53028,Semproniano,GR,91,0,0,0,0,0,2,1,0,3,6
2020,53028,Semproniano,GR,92,1,0,0,0,1,0,0,0,4,4
2020,53028,Semproniano,GR,93,0,0,0,2,2,0,0,0,4,4
2020,53028,Semproniano,GR,94,0,1,0,1,2,0,0,0,0,0
2020,53028,Semproniano,GR,95,0,1,0,1,2,0,0,0,1,1
2020,53028,Semproniano,GR,96,0,0,0,0,0,0,0,0,1,1
2020,53028,Semproniano,GR,97,0,0,0,0,0,0,0,0,2,2
2020,53028,Semproniano,GR,98,0,0,0,0,0,0,0,0,0,0
2020,53028,Semproniano,GR,99,0,0,0,0,0,0,0,0,0,0
2020,53028,Semproniano,GR,100 e più,0,0,0,0,0,0,0,0,0,0
2020,49001,Bibbona,LI,0,11,0,0,0,11,8,0,0,0,8
2020,49001,Bibbona,LI,1,9,0,0,0,9,11,0,0,0,11
2020,49001,Bibbona,LI,2,20,0,0,0,20,9,0,0,0,9
2020,49001,Bibbona,LI,3,15,0,0,0,15,27,0,0,0,27
2020,49001,Bibbona,LI,4,7,0,0,0,7,13,0,0,0,13
2020,49001,Bibbona,LI,5,14,0,0,0,14,13,0,0,0,13
2020,49001,Bibbona,LI,6,10,0,0,0,10,10,0,0,0,10
2020,49001,Bibbona,LI,7,10,0,0,0,10,10,0,0,0,10
2020,49001,Bibbona,LI,8,22,0,0,0,22,7,0,0,0,7
2020,49001,Bibbona,LI,9,17,0,0,0,17,10,0,0,0,10
2020,49001,Bibbona,LI,10,10,0,0,0,10,9,0,0,0,9
2020,49001,Bibbona,LI,11,12,0,0,0,12,16,0,0,0,16
2020,49001,Bibbona,LI,12,5,0,0,0,5,7,0,0,0,7
2020,49001,Bibbona,LI,13,14,0,0,0,14,3,0,0,0,3
2020,49001,Bibbona,LI,14,17,0,0,0,17,12,0,0,0,12
2020,49001,Bibbona,LI,15,19,0,0,0,19,9,0,0,0,9
2020,49001,Bibbona,LI,16,12,0,0,0,12,7,0,0,0,7
2020,49001,Bibbona,LI,17,19,0,0,0,19,13,0,0,0,13
2020,49001,Bibbona,LI,18,6,0,0,0,6,16,0,0,0,16
2020,49001,Bibbona,LI,19,11,0,0,0,11,15,0,0,0,15
2020,49001,Bibbona,LI,20,23,0,0,0,23,13,0,0,0,13
2020,49001,Bibbona,LI,21,17,0,0,0,17,11,0,0,0,11
2020,49001,Bibbona,LI,22,17,0,0,0,17,14,1,0,0,15
2020,49001,Bibbona,LI,23,14,0,0,0,14,14,1,0,0,15
2020,49001,Bibbona,LI,24,11,0,0,0,11,8,0,0,0,8
2020,49001,Bibbona,LI,25,12,1,0,0,13,11,1,0,0,12
2020,49001,Bibbona,LI,26,16,0,0,0,16,11,2,0,0,13
2020,49001,Bibbona,LI,27,15,1,0,0,16,7,2,0,0,9
2020,49001,Bibbona,LI,28,10,2,0,0,12,11,3,0,0,14
2020,49001,Bibbona,LI,29,16,2,0,0,18,10,6,1,0,17
2020,49001,Bibbona,LI,30,7,2,0,0,9,9,3,0,0,12
2020,49001,Bibbona,LI,31,9,4,0,0,13,14,6,0,0,20
2020,49001,Bibbona,LI,32,10,5,0,0,15,9,7,0,0,16
2020,49001,Bibbona,LI,33,17,3,0,0,20,6,5,0,0,11
2020,49001,Bibbona,LI,34,9,3,0,0,12,8,11,0,0,19
2020,49001,Bibbona,LI,35,16,3,0,0,19,7,7,0,0,14
2020,49001,Bibbona,LI,36,12,7,0,0,19,8,7,0,0,15
2020,49001,Bibbona,LI,37,8,8,0,0,16,2,7,0,0,9
2020,49001,Bibbona,LI,38,12,11,0,0,23,8,7,0,0,15
2020,49001,Bibbona,LI,39,13,5,0,0,18,7,11,2,0,20
2020,49001,Bibbona,LI,40,6,9,0,0,15,4,6,0,0,10
2020,49001,Bibbona,LI,41,14,3,0,0,17,5,10,1,0,16
2020,49001,Bibbona,LI,42,8,10,1,0,19,9,12,2,0,23
2020,49001,Bibbona,LI,43,15,13,2,0,30,8,14,5,0,27
2020,49001,Bibbona,LI,44,10,15,0,0,25,8,12,3,0,23
2020,49001,Bibbona,LI,45,10,7,2,0,19,12,14,2,0,28
2020,49001,Bibbona,LI,46,13,7,2,0,22,6,13,0,0,19
2020,49001,Bibbona,LI,47,11,10,0,1,22,8,13,0,0,21
2020,49001,Bibbona,LI,48,7,20,4,0,31,3,17,3,0,23
2020,49001,Bibbona,LI,49,4,17,4,0,25,4,25,3,3,35
2020,49001,Bibbona,LI,50,4,25,3,0,32,7,27,4,2,40
2020,49001,Bibbona,LI,51,3,27,2,0,32,5,19,0,0,24
2020,49001,Bibbona,LI,52,5,16,0,0,21,6,16,3,3,28
2020,49001,Bibbona,LI,53,2,19,1,0,22,5,15,1,3,24
2020,49001,Bibbona,LI,54,7,18,1,0,26,5,16,6,0,27
2020,49001,Bibbona,LI,55,6,24,5,1,36,4,23,2,0,29
2020,49001,Bibbona,LI,56,6,22,3,1,32,2,16,5,0,23
2020,49001,Bibbona,LI,57,4,25,4,0,33,1,19,3,0,23
2020,49001,Bibbona,LI,58,3,19,3,0,25,2,29,2,0,33
2020,49001,Bibbona,LI,59,3,18,1,1,23,2,13,3,2,20
2020,49001,Bibbona,LI,60,2,25,0,0,27,5,16,2,0,23
2020,49001,Bibbona,LI,61,1,20,3,0,24,2,16,0,1,19
2020,49001,Bibbona,LI,62,1,19,1,0,21,0,21,2,0,23
2020,49001,Bibbona,LI,63,3,18,1,1,23,1,16,3,1,21
2020,49001,Bibbona,LI,64,0,16,4,0,20,0,18,0,5,23
2020,49001,Bibbona,LI,65,2,11,1,2,16,0,16,0,7,23
2020,49001,Bibbona,LI,66,0,17,2,1,20,2,18,2,3,25
2020,49001,Bibbona,LI,67,3,21,2,2,28,0,23,0,2,25
2020,49001,Bibbona,LI,68,0,15,0,1,16,0,18,0,3,21
2020,49001,Bibbona,LI,69,1,11,5,1,18,1,23,0,0,24
2020,49001,Bibbona,LI,70,0,15,1,1,17,0,13,1,7,21
2020,49001,Bibbona,LI,71,0,19,3,1,23,2,22,1,4,29
2020,49001,Bibbona,LI,72,1,20,2,0,23,0,7,1,4,12
2020,49001,Bibbona,LI,73,2,20,1,0,23,1,22,1,1,25
2020,49001,Bibbona,LI,74,0,18,1,4,23,2,14,1,6,23
2020,49001,Bibbona,LI,75,0,11,0,3,14,1,15,2,4,22
2020,49001,Bibbona,LI,76,2,14,0,2,18,0,10,0,3,13
2020,49001,Bibbona,LI,77,2,16,0,4,22,0,8,0,7,15
2020,49001,Bibbona,LI,78,1,15,0,0,16,0,2,0,10,12
2020,49001,Bibbona,LI,79,1,12,0,0,13,0,9,1,4,14
2020,49001,Bibbona,LI,80,1,16,0,0,17,0,7,0,6,13
2020,49001,Bibbona,LI,81,0,11,0,3,14,0,8,1,7,16
2020,49001,Bibbona,LI,82,1,9,1,3,14,1,5,1,12,19
2020,49001,Bibbona,LI,83,0,4,0,4,8,0,7,0,10,17
2020,49001,Bibbona,LI,84,0,6,0,1,7,0,3,0,10,13
2020,49001,Bibbona,LI,85,1,9,0,2,12,2,7,0,9,18
2020,49001,Bibbona,LI,86,0,4,0,3,7,0,0,0,9,9
2020,49001,Bibbona,LI,87,0,5,0,1,6,1,3,0,7,11
2020,49001,Bibbona,LI,88,0,4,0,1,5,2,1,0,7,10
2020,49001,Bibbona,LI,89,0,4,0,1,5,0,1,0,4,5
2020,49001,Bibbona,LI,90,1,4,0,3,8,0,1,0,10,11
2020,49001,Bibbona,LI,91,1,3,0,0,4,1,1,0,5,7
2020,49001,Bibbona,LI,92,0,3,0,1,4,0,1,0,4,5
2020,49001,Bibbona,LI,93,1,1,0,0,2,0,0,0,2,2
2020,49001,Bibbona,LI,94,0,0,0,0,0,0,0,0,1,1
2020,49001,Bibbona,LI,95,0,0,0,0,0,0,0,0,0,0
2020,49001,Bibbona,LI,96,0,0,0,1,1,0,1,0,3,4
2020,49001,Bibbona,LI,97,0,0,0,0,0,0,0,0,2,2
2020,49001,Bibbona,LI,98,0,0,0,0,0,0,0,0,2,2
2020,49001,Bibbona,LI,99,0,0,0,0,0,0,0,0,0,0
2020,49001,Bibbona,LI,100 e più,0,0,0,0,0,0,0,0,1,1
2020,49002,Campiglia Marittima,LI,0,27,0,0,0,27,37,0,0,0,37
2020,49002,Campiglia Marittima,LI,1,41,0,0,0,41,33,0,0,0,33
2020,49002,Campiglia Marittima,LI,2,39,0,0,0,39,25,0,0,0,25
2020,49002,Campiglia Marittima,LI,3,35,0,0,0,35,49,0,0,0,49
2020,49002,Campiglia Marittima,LI,4,41,0,0,0,41,39,0,0,0,39
2020,49002,Campiglia Marittima,LI,5,36,0,0,0,36,39,0,0,0,39
2020,49002,Campiglia Marittima,LI,6,39,0,0,0,39,54,0,0,0,54
2020,49002,Campiglia Marittima,LI,7,40,0,0,0,40,38,0,0,0,38
2020,49002,Campiglia Marittima,LI,8,40,0,0,0,40,52,0,0,0,52
2020,49002,Campiglia Marittima,LI,9,44,0,0,0,44,56,0,0,0,56
2020,49002,Campiglia Marittima,LI,10,61,0,0,0,61,44,0,0,0,44
2020,49002,Campiglia Marittima,LI,11,51,0,0,0,51,48,0,0,0,48
2020,49002,Campiglia Marittima,LI,12,56,0,0,0,56,66,0,0,0,66
2020,49002,Campiglia Marittima,LI,13,58,0,0,0,58,61,0,0,0,61
2020,49002,Campiglia Marittima,LI,14,70,0,0,0,70,49,0,0,0,49
2020,49002,Campiglia Marittima,LI,15,47,0,0,0,47,53,0,0,0,53
2020,49002,Campiglia Marittima,LI,16,66,0,0,0,66,50,0,0,0,50
2020,49002,Campiglia Marittima,LI,17,44,0,0,0,44,51,0,0,0,51
2020,49002,Campiglia Marittima,LI,18,50,0,0,0,50,45,0,0,0,45
2020,49002,Campiglia Marittima,LI,19,61,0,0,0,61,51,0,0,0,51
2020,49002,Campiglia Marittima,LI,20,62,1,0,0,63,42,0,0,0,42
2020,49002,Campiglia Marittima,LI,21,49,0,0,0,49,40,6,0,0,46
2020,49002,Campiglia Marittima,LI,22,46,0,0,0,46,49,3,0,0,52
2020,49002,Campiglia Marittima,LI,23,66,1,0,0,67,37,2,0,0,39
2020,49002,Campiglia Marittima,LI,24,41,1,0,0,42,54,1,0,0,55
2020,49002,Campiglia Marittima,LI,25,44,1,0,0,45,48,3,0,0,51
2020,49002,Campiglia Marittima,LI,26,38,2,0,0,40,41,3,1,0,45
2020,49002,Campiglia Marittima,LI,27,55,3,0,0,58,35,15,0,0,50
2020,49002,Campiglia Marittima,LI,28,49,6,0,0,55,29,6,0,0,35
2020,49002,Campiglia Marittima,LI,29,45,6,0,0,51,40,13,0,0,53
2020,49002,Campiglia Marittima,LI,30,56,11,0,0,67,33,10,2,0,45
2020,49002,Campiglia Marittima,LI,31,49,13,0,0,62,40,14,1,0,55
2020,49002,Campiglia Marittima,LI,32,33,9,1,0,43,41,25,0,0,66
2020,49002,Campiglia Marittima,LI,33,41,15,0,0,56,48,22,1,1,72
2020,49002,Campiglia Marittima,LI,34,45,9,1,0,55,32,28,2,0,62
2020,49002,Campiglia Marittima,LI,35,37,23,4,0,64,26,25,1,0,52
2020,49002,Campiglia Marittima,LI,36,39,20,1,1,61,33,32,0,0,65
2020,49002,Campiglia Marittima,LI,37,42,28,0,0,70,25,42,2,1,70
2020,49002,Campiglia Marittima,LI,38,39,34,0,0,73,22,36,4,0,62
2020,49002,Campiglia Marittima,LI,39,31,39,0,0,70,32,32,6,0,70
2020,49002,Campiglia Marittima,LI,40,41,45,4,0,90,30,41,1,0,72
2020,49002,Campiglia Marittima,LI,41,37,34,2,0,73,33,42,9,0,84
2020,49002,Campiglia Marittima,LI,42,39,39,1,0,79,36,48,4,0,88
2020,49002,Campiglia Marittima,LI,43,43,34,5,1,83,23,46,5,0,74
2020,49002,Campiglia Marittima,LI,44,44,55,6,0,105,32,59,5,1,97
2020,49002,Campiglia Marittima,LI,45,35,44,7,0,86,21,60,9,2,92
2020,49002,Campiglia Marittima,LI,46,36,64,10,0,110,27,69,10,2,108
2020,49002,Campiglia Marittima,LI,47,30,57,10,0,97,22,61,8,3,94
2020,49002,Campiglia Marittima,LI,48,35,73,4,0,112,24,81,10,1,116
2020,49002,Campiglia Marittima,LI,49,32,64,5,2,103,16,60,11,1,88
2020,49002,Campiglia Marittima,LI,50,32,60,6,0,98,24,82,9,1,116
2020,49002,Campiglia Marittima,LI,51,27,78,15,0,120,24,73,6,5,108
2020,49002,Campiglia Marittima,LI,52,24,71,10,0,105,10,100,12,1,123
2020,49002,Campiglia Marittima,LI,53,12,93,12,1,118,9,79,17,4,109
2020,49002,Campiglia Marittima,LI,54,18,78,6,0,102,11,81,11,8,111
2020,49002,Campiglia Marittima,LI,55,16,62,13,1,92,7,69,13,3,92
2020,49002,Campiglia Marittima,LI,56,13,91,8,1,113,8,84,15,6,113
2020,49002,Campiglia Marittima,LI,57,9,69,9,1,88,8,71,10,6,95
2020,49002,Campiglia Marittima,LI,58,11,83,13,0,107,9,75,9,4,97
2020,49002,Campiglia Marittima,LI,59,5,65,7,1,78,6,83,9,7,105
2020,49002,Campiglia Marittima,LI,60,6,75,10,1,92,1,76,4,8,89
2020,49002,Campiglia Marittima,LI,61,7,72,7,0,86,6,62,5,9,82
2020,49002,Campiglia Marittima,LI,62,9,63,9,0,81,3,77,9,10,99
2020,49002,Campiglia Marittima,LI,63,7,67,6,2,82,3,73,5,12,93
2020,49002,Campiglia Marittima,LI,64,3,79,7,3,92,2,75,2,21,100
2020,49002,Campiglia Marittima,LI,65,2,76,3,1,82,4,57,9,10,80
2020,49002,Campiglia Marittima,LI,66,3,52,3,3,61,1,59,3,21,84
2020,49002,Campiglia Marittima,LI,67,2,54,2,4,62,1,61,4,17,83
2020,49002,Campiglia Marittima,LI,68,6,79,6,2,93,1,62,4,15,82
2020,49002,Campiglia Marittima,LI,69,2,56,1,1,60,3,70,5,18,96
2020,49002,Campiglia Marittima,LI,70,4,62,1,7,74,1,60,1,15,77
2020,49002,Campiglia Marittima,LI,71,7,72,1,2,82,2,45,2,23,72
2020,49002,Campiglia Marittima,LI,72,2,81,2,3,88,1,70,1,27,99
2020,49002,Campiglia Marittima,LI,73,2,66,4,2,74,1,76,4,29,110
2020,49002,Campiglia Marittima,LI,74,5,61,6,2,74,4,68,3,33,108
2020,49002,Campiglia Marittima,LI,75,1,64,0,2,67,2,43,2,31,78
2020,49002,Campiglia Marittima,LI,76,3,65,3,6,77,1,51,0,30,82
2020,49002,Campiglia Marittima,LI,77,0,42,2,8,52,2,45,1,26,74
2020,49002,Campiglia Marittima,LI,78,2,45,2,6,55,1,47,1,25,74
2020,49002,Campiglia Marittima,LI,79,0,47,1,13,61,1,44,1,36,82
2020,49002,Campiglia Marittima,LI,80,3,55,0,13,71,3,35,1,35,74
2020,49002,Campiglia Marittima,LI,81,1,63,2,10,76,1,34,1,51,87
2020,49002,Campiglia Marittima,LI,82,2,50,0,14,66,0,30,1,47,78
2020,49002,Campiglia Marittima,LI,83,1,42,2,3,48,2,23,0,51,76
2020,49002,Campiglia Marittima,LI,84,3,25,0,10,38,1,20,0,47,68
2020,49002,Campiglia Marittima,LI,85,5,16,1,4,26,0,9,0,37,46
2020,49002,Campiglia Marittima,LI,86,1,22,0,8,31,2,21,0,38,61
2020,49002,Campiglia Marittima,LI,87,2,37,0,6,45,1,14,2,35,52
2020,49002,Campiglia Marittima,LI,88,1,20,0,10,31,0,5,0,29,34
2020,49002,Campiglia Marittima,LI,89,0,17,0,11,28,0,5,1,48,54
2020,49002,Campiglia Marittima,LI,90,0,6,0,5,11,1,1,0,35,37
2020,49002,Campiglia Marittima,LI,91,1,12,0,7,20,0,4,0,13,17
2020,49002,Campiglia Marittima,LI,92,0,3,0,5,8,1,4,0,19,24
2020,49002,Campiglia Marittima,LI,93,0,7,0,5,12,0,2,0,8,10
2020,49002,Campiglia Marittima,LI,94,0,2,0,2,4,0,1,0,12,13
2020,49002,Campiglia Marittima,LI,95,1,6,0,1,8,0,1,0,8,9
2020,49002,Campiglia Marittima,LI,96,1,0,0,2,3,0,0,0,7,7
2020,49002,Campiglia Marittima,LI,97,0,0,0,1,1,0,0,0,5,5
2020,49002,Campiglia Marittima,LI,98,0,1,0,0,1,0,1,0,6,7
2020,49002,Campiglia Marittima,LI,99,0,0,0,0,0,1,0,0,4,5
2020,49002,Campiglia Marittima,LI,100 e più,0,1,0,0,1,0,0,0,2,2
2020,49003,Campo nell'Elba,LI,0,10,0,0,0,10,14,0,0,0,14
2020,49003,Campo nell'Elba,LI,1,15,0,0,0,15,19,0,0,0,19
2020,49003,Campo nell'Elba,LI,2,13,0,0,0,13,12,0,0,0,12
2020,49003,Campo nell'Elba,LI,3,17,0,0,0,17,16,0,0,0,16
2020,49003,Campo nell'Elba,LI,4,22,0,0,0,22,19,0,0,0,19
2020,49003,Campo nell'Elba,LI,5,13,0,0,0,13,14,0,0,0,14
2020,49003,Campo nell'Elba,LI,6,28,0,0,0,28,26,0,0,0,26
2020,49003,Campo nell'Elba,LI,7,22,0,0,0,22,23,0,0,0,23
2020,49003,Campo nell'Elba,LI,8,13,0,0,0,13,23,0,0,0,23
2020,49003,Campo nell'Elba,LI,9,21,0,0,0,21,17,0,0,0,17
2020,49003,Campo nell'Elba,LI,10,23,0,0,0,23,22,0,0,0,22
2020,49003,Campo nell'Elba,LI,11,23,0,0,0,23,19,0,0,0,19
2020,49003,Campo nell'Elba,LI,12,14,0,0,0,14,30,0,0,0,30
2020,49003,Campo nell'Elba,LI,13,25,0,0,0,25,18,0,0,0,18
2020,49003,Campo nell'Elba,LI,14,17,0,0,0,17,22,0,0,0,22
2020,49003,Campo nell'Elba,LI,15,15,0,0,0,15,19,0,0,0,19
2020,49003,Campo nell'Elba,LI,16,23,0,0,0,23,24,0,0,0,24
2020,49003,Campo nell'Elba,LI,17,25,0,0,0,25,15,0,0,0,15
2020,49003,Campo nell'Elba,LI,18,17,0,0,0,17,24,0,0,0,24
2020,49003,Campo nell'Elba,LI,19,24,0,0,0,24,23,0,0,0,23
2020,49003,Campo nell'Elba,LI,20,19,0,0,0,19,26,0,0,0,26
2020,49003,Campo nell'Elba,LI,21,22,0,0,0,22,18,1,0,0,19
2020,49003,Campo nell'Elba,LI,22,18,0,0,0,18,10,0,0,0,10
2020,49003,Campo nell'Elba,LI,23,15,0,0,0,15,16,0,0,0,16
2020,49003,Campo nell'Elba,LI,24,16,0,0,0,16,22,1,0,0,23
2020,49003,Campo nell'Elba,LI,25,22,1,0,0,23,23,0,0,0,23
2020,49003,Campo nell'Elba,LI,26,21,1,0,0,22,18,2,0,0,20
2020,49003,Campo nell'Elba,LI,27,15,1,0,0,16,12,2,0,0,14
2020,49003,Campo nell'Elba,LI,28,17,0,0,0,17,18,9,0,0,27
2020,49003,Campo nell'Elba,LI,29,18,2,0,0,20,14,5,0,0,19
2020,49003,Campo nell'Elba,LI,30,25,6,0,0,31,11,3,0,0,14
2020,49003,Campo nell'Elba,LI,31,16,0,0,0,16,15,4,1,0,20
2020,49003,Campo nell'Elba,LI,32,18,3,0,0,21,15,6,0,0,21
2020,49003,Campo nell'Elba,LI,33,17,5,0,0,22,13,5,0,0,18
2020,49003,Campo nell'Elba,LI,34,23,3,0,0,26,12,6,2,0,20
2020,49003,Campo nell'Elba,LI,35,18,5,3,0,26,13,7,0,0,20
2020,49003,Campo nell'Elba,LI,36,18,7,0,0,25,10,16,0,1,27
2020,49003,Campo nell'Elba,LI,37,20,4,1,0,25,15,16,2,0,33
2020,49003,Campo nell'Elba,LI,38,17,19,0,0,36,9,16,1,0,26
2020,49003,Campo nell'Elba,LI,39,17,8,1,0,26,14,19,1,2,36
2020,49003,Campo nell'Elba,LI,40,9,9,0,0,18,7,13,0,1,21
2020,49003,Campo nell'Elba,LI,41,7,16,0,0,23,11,18,1,0,30
2020,49003,Campo nell'Elba,LI,42,23,18,2,0,43,9,13,1,0,23
2020,49003,Campo nell'Elba,LI,43,10,19,1,0,30,6,19,3,0,28
2020,49003,Campo nell'Elba,LI,44,12,18,1,0,31,9,31,1,2,43
2020,49003,Campo nell'Elba,LI,45,17,21,2,0,40,6,26,1,0,33
2020,49003,Campo nell'Elba,LI,46,19,29,5,0,53,8,34,6,0,48
2020,49003,Campo nell'Elba,LI,47,22,23,1,0,46,10,27,5,1,43
2020,49003,Campo nell'Elba,LI,48,18,33,0,0,51,13,25,2,0,40
2020,49003,Campo nell'Elba,LI,49,13,28,2,0,43,6,25,4,0,35
2020,49003,Campo nell'Elba,LI,50,12,33,3,0,48,12,32,6,1,51
2020,49003,Campo nell'Elba,LI,51,14,24,6,0,44,14,19,7,0,40
2020,49003,Campo nell'Elba,LI,52,12,27,6,0,45,10,21,6,1,38
2020,49003,Campo nell'Elba,LI,53,12,30,3,0,45,8,26,3,5,42
2020,49003,Campo nell'Elba,LI,54,11,22,5,0,38,7,34,5,1,47
2020,49003,Campo nell'Elba,LI,55,17,34,5,0,56,6,28,9,1,44
2020,49003,Campo nell'Elba,LI,56,7,30,1,1,39,5,25,1,1,32
2020,49003,Campo nell'Elba,LI,57,6,29,4,0,39,5,33,8,1,47
2020,49003,Campo nell'Elba,LI,58,5,26,1,1,33,5,28,5,4,42
2020,49003,Campo nell'Elba,LI,59,6,22,1,1,30,9,25,3,2,39
2020,49003,Campo nell'Elba,LI,60,4,29,6,0,39,0,16,3,2,21
2020,49003,Campo nell'Elba,LI,61,2,28,3,1,34,4,29,3,4,40
2020,49003,Campo nell'Elba,LI,62,8,31,1,0,40,2,22,3,2,29
2020,49003,Campo nell'Elba,LI,63,3,17,5,0,25,2,21,3,3,29
2020,49003,Campo nell'Elba,LI,64,6,17,3,0,26,2,22,4,8,36
2020,49003,Campo nell'Elba,LI,65,2,18,0,2,22,2,25,4,5,36
2020,49003,Campo nell'Elba,LI,66,3,12,5,1,21,3,16,3,6,28
2020,49003,Campo nell'Elba,LI,67,2,24,4,1,31,5,15,0,3,23
2020,49003,Campo nell'Elba,LI,68,3,20,1,0,24,1,26,1,4,32
2020,49003,Campo nell'Elba,LI,69,1,18,3,2,24,1,25,0,2,28
2020,49003,Campo nell'Elba,LI,70,4,19,2,0,25,1,17,1,5,24
2020,49003,Campo nell'Elba,LI,71,4,23,0,0,27,2,19,1,3,25
2020,49003,Campo nell'Elba,LI,72,2,18,2,1,23,2,23,3,11,39
2020,49003,Campo nell'Elba,LI,73,2,23,4,3,32,3,22,0,9,34
2020,49003,Campo nell'Elba,LI,74,2,25,3,0,30,2,20,2,11,35
2020,49003,Campo nell'Elba,LI,75,0,18,0,6,24,1,12,0,5,18
2020,49003,Campo nell'Elba,LI,76,2,16,3,2,23,1,13,2,11,27
2020,49003,Campo nell'Elba,LI,77,1,15,1,2,19,2,17,1,9,29
2020,49003,Campo nell'Elba,LI,78,2,23,0,2,27,2,9,0,5,16
2020,49003,Campo nell'Elba,LI,79,0,11,1,2,14,1,12,0,8,21
2020,49003,Campo nell'Elba,LI,80,1,23,0,4,28,0,16,1,12,29
2020,49003,Campo nell'Elba,LI,81,0,21,0,3,24,0,9,1,9,19
2020,49003,Campo nell'Elba,LI,82,2,23,1,3,29,1,8,0,13,22
2020,49003,Campo nell'Elba,LI,83,1,8,0,3,12,0,7,0,13,20
2020,49003,Campo nell'Elba,LI,84,1,10,0,3,14,1,9,0,18,28
2020,49003,Campo nell'Elba,LI,85,0,8,0,2,10,0,3,2,11,16
2020,49003,Campo nell'Elba,LI,86,0,5,0,1,6,2,4,0,8,14
2020,49003,Campo nell'Elba,LI,87,1,6,0,0,7,0,1,1,11,13
2020,49003,Campo nell'Elba,LI,88,0,7,0,3,10,2,4,0,6,12
2020,49003,Campo nell'Elba,LI,89,0,6,0,3,9,0,2,0,8,10
2020,49003,Campo nell'Elba,LI,90,0,3,0,0,3,1,0,0,11,12
2020,49003,Campo nell'Elba,LI,91,0,1,0,0,1,1,1,0,3,5
2020,49003,Campo nell'Elba,LI,92,0,4,0,1,5,0,1,0,3,4
2020,49003,Campo nell'Elba,LI,93,0,2,0,1,3,0,1,0,5,6
2020,49003,Campo nell'Elba,LI,94,0,0,0,1,1,0,1,0,1,2
2020,49003,Campo nell'Elba,LI,95,0,2,0,0,2,0,1,0,6,7
2020,49003,Campo nell'Elba,LI,96,0,1,0,1,2,0,0,0,3,3
2020,49003,Campo nell'Elba,LI,97,0,1,0,0,1,0,0,0,1,1
2020,49003,Campo nell'Elba,LI,98,1,0,0,0,1,1,0,0,1,2
2020,49003,Campo nell'Elba,LI,99,0,0,0,0,0,1,0,0,1,2
2020,49003,Campo nell'Elba,LI,100 e più,0,0,0,0,0,1,0,0,0,1
2020,49004,Capoliveri,LI,0,8,0,0,0,8,12,0,0,0,12
2020,49004,Capoliveri,LI,1,16,0,0,0,16,15,0,0,0,15
2020,49004,Capoliveri,LI,2,11,0,0,0,11,16,0,0,0,16
2020,49004,Capoliveri,LI,3,14,0,0,0,14,13,0,0,0,13
2020,49004,Capoliveri,LI,4,11,0,0,0,11,20,0,0,0,20
2020,49004,Capoliveri,LI,5,18,0,0,0,18,13,0,0,0,13
2020,49004,Capoliveri,LI,6,13,0,0,0,13,12,0,0,0,12
2020,49004,Capoliveri,LI,7,17,0,0,0,17,9,0,0,0,9
2020,49004,Capoliveri,LI,8,17,0,0,0,17,18,0,0,0,18
2020,49004,Capoliveri,LI,9,20,0,0,0,20,17,0,0,0,17
2020,49004,Capoliveri,LI,10,17,0,0,0,17,15,0,0,0,15
2020,49004,Capoliveri,LI,11,16,0,0,0,16,12,0,0,0,12
2020,49004,Capoliveri,LI,12,12,0,0,0,12,20,0,0,0,20
2020,49004,Capoliveri,LI,13,23,0,0,0,23,23,0,0,0,23
2020,49004,Capoliveri,LI,14,22,0,0,0,22,19,0,0,0,19
2020,49004,Capoliveri,LI,15,12,0,0,0,12,16,0,0,0,16
2020,49004,Capoliveri,LI,16,17,0,0,0,17,15,0,0,0,15
2020,49004,Capoliveri,LI,17,17,0,0,0,17,12,0,0,0,12
2020,49004,Capoliveri,LI,18,15,0,0,0,15,19,0,0,0,19
2020,49004,Capoliveri,LI,19,8,0,0,0,8,13,0,0,0,13
2020,49004,Capoliveri,LI,20,16,0,0,0,16,18,0,0,0,18
2020,49004,Capoliveri,LI,21,20,0,0,0,20,16,0,0,0,16
2020,49004,Capoliveri,LI,22,19,0,0,0,19,17,3,0,0,20
2020,49004,Capoliveri,LI,23,17,0,0,0,17,14,0,0,0,14
2020,49004,Capoliveri,LI,24,21,1,0,0,22,12,0,0,0,12
2020,49004,Capoliveri,LI,25,22,0,0,0,22,17,2,0,0,19
2020,49004,Capoliveri,LI,26,14,1,0,0,15,12,2,0,0,14
2020,49004,Capoliveri,LI,27,17,0,0,0,17,17,3,0,0,20
2020,49004,Capoliveri,LI,28,12,0,0,0,12,18,3,0,0,21
2020,49004,Capoliveri,LI,29,16,3,0,0,19,15,3,0,0,18
2020,49004,Capoliveri,LI,30,10,3,0,0,13,12,2,0,0,14
2020,49004,Capoliveri,LI,31,14,3,1,0,18,11,9,0,0,20
2020,49004,Capoliveri,LI,32,20,3,1,0,24,9,5,0,0,14
2020,49004,Capoliveri,LI,33,17,0,0,0,17,3,11,0,0,14
2020,49004,Capoliveri,LI,34,10,10,0,0,20,10,10,1,0,21
2020,49004,Capoliveri,LI,35,10,5,2,0,17,7,14,0,0,21
2020,49004,Capoliveri,LI,36,10,7,0,0,17,7,13,0,0,20
2020,49004,Capoliveri,LI,37,12,13,0,0,25,9,12,0,0,21
2020,49004,Capoliveri,LI,38,12,9,1,0,22,5,13,3,0,21
2020,49004,Capoliveri,LI,39,6,10,1,0,17,11,11,0,0,22
2020,49004,Capoliveri,LI,40,13,10,1,0,24,9,12,1,1,23
2020,49004,Capoliveri,LI,41,13,14,1,0,28,9,9,0,0,18
2020,49004,Capoliveri,LI,42,18,17,1,0,36,8,13,1,1,23
2020,49004,Capoliveri,LI,43,12,16,0,0,28,11,23,2,0,36
2020,49004,Capoliveri,LI,44,17,22,2,0,41,14,18,4,0,36
2020,49004,Capoliveri,LI,45,13,11,2,0,26,6,21,2,0,29
2020,49004,Capoliveri,LI,46,9,21,3,0,33,11,28,4,0,43
2020,49004,Capoliveri,LI,47,10,16,1,0,27,5,19,1,0,25
2020,49004,Capoliveri,LI,48,16,20,0,1,37,10,22,3,1,36
2020,49004,Capoliveri,LI,49,9,15,2,0,26,7,22,0,0,29
2020,49004,Capoliveri,LI,50,15,10,1,0,26,7,24,2,0,33
2020,49004,Capoliveri,LI,51,11,15,2,0,28,6,22,7,0,35
2020,49004,Capoliveri,LI,52,5,31,0,0,36,4,18,1,2,25
2020,49004,Capoliveri,LI,53,8,21,4,0,33,9,23,2,2,36
2020,49004,Capoliveri,LI,54,10,17,7,0,34,9,23,3,0,35
2020,49004,Capoliveri,LI,55,8,28,3,1,40,7,24,5,2,38
2020,49004,Capoliveri,LI,56,10,28,2,0,40,3,29,1,0,33
2020,49004,Capoliveri,LI,57,8,30,3,1,42,5,26,3,0,34
2020,49004,Capoliveri,LI,58,5,21,2,1,29,5,26,6,1,38
2020,49004,Capoliveri,LI,59,3,19,4,0,26,7,26,6,2,41
2020,49004,Capoliveri,LI,60,4,26,3,0,33,3,21,3,3,30
2020,49004,Capoliveri,LI,61,4,25,4,0,33,6,19,3,3,31
2020,49004,Capoliveri,LI,62,3,21,3,0,27,4,22,0,0,26
2020,49004,Capoliveri,LI,63,4,22,2,0,28,4,18,2,3,27
2020,49004,Capoliveri,LI,64,4,20,0,0,24,4,15,0,2,21
2020,49004,Capoliveri,LI,65,2,22,3,0,27,0,13,0,4,17
2020,49004,Capoliveri,LI,66,0,15,4,4,23,0,21,2,2,25
2020,49004,Capoliveri,LI,67,2,20,2,2,26,2,20,0,6,28
2020,49004,Capoliveri,LI,68,1,18,1,1,21,0,18,1,3,22
2020,49004,Capoliveri,LI,69,2,21,1,1,25,0,16,2,1,19
2020,49004,Capoliveri,LI,70,1,18,0,2,21,1,19,0,4,24
2020,49004,Capoliveri,LI,71,0,22,2,1,25,1,17,2,11,31
2020,49004,Capoliveri,LI,72,2,25,1,1,29,2,23,0,5,30
2020,49004,Capoliveri,LI,73,1,24,0,1,26,1,17,0,7,25
2020,49004,Capoliveri,LI,74,1,21,3,2,27,1,13,2,4,20
2020,49004,Capoliveri,LI,75,0,12,1,1,14,0,17,1,6,24
2020,49004,Capoliveri,LI,76,0,20,1,2,23,2,11,0,3,16
2020,49004,Capoliveri,LI,77,0,19,1,1,21,1,10,0,5,16
2020,49004,Capoliveri,LI,78,1,7,0,0,8,0,14,1,4,19
2020,49004,Capoliveri,LI,79,0,11,0,1,12,0,7,1,11,19
2020,49004,Capoliveri,LI,80,1,21,1,3,26,2,11,1,9,23
2020,49004,Capoliveri,LI,81,5,9,1,0,15,1,6,0,11,18
2020,49004,Capoliveri,LI,82,0,10,1,2,13,0,6,0,9,15
2020,49004,Capoliveri,LI,83,0,5,0,1,6,0,8,0,9,17
2020,49004,Capoliveri,LI,84,0,11,0,0,11,0,2,1,9,12
2020,49004,Capoliveri,LI,85,2,7,0,2,11,1,3,1,9,14
2020,49004,Capoliveri,LI,86,0,4,0,3,7,2,4,0,9,15
2020,49004,Capoliveri,LI,87,0,4,0,2,6,0,0,0,5,5
2020,49004,Capoliveri,LI,88,0,6,0,4,10,0,2,2,8,12
2020,49004,Capoliveri,LI,89,0,3,0,0,3,0,2,0,3,5
2020,49004,Capoliveri,LI,90,0,2,0,2,4,0,0,0,6,6
2020,49004,Capoliveri,LI,91,0,1,0,1,2,1,0,1,5,7
2020,49004,Capoliveri,LI,92,0,3,0,2,5,0,1,0,1,2
2020,49004,Capoliveri,LI,93,0,1,0,1,2,0,1,0,2,3
2020,49004,Capoliveri,LI,94,0,1,0,0,1,0,0,0,5,5
2020,49004,Capoliveri,LI,95,0,0,0,0,0,0,0,0,0,0
2020,49004,Capoliveri,LI,96,0,0,0,0,0,0,0,0,0,0
2020,49004,Capoliveri,LI,97,0,0,0,0,0,0,0,0,2,2
2020,49004,Capoliveri,LI,98,0,1,0,0,1,0,0,0,0,0
2020,49004,Capoliveri,LI,99,0,1,0,0,1,0,1,0,0,1
2020,49004,Capoliveri,LI,100 e più,0,0,0,0,0,0,0,0,0,0
2020,49005,Capraia Isola,LI,0,0,0,0,0,0,1,0,0,0,1
2020,49005,Capraia Isola,LI,1,2,0,0,0,2,0,0,0,0,0
2020,49005,Capraia Isola,LI,2,2,0,0,0,2,3,0,0,0,3
2020,49005,Capraia Isola,LI,3,2,0,0,0,2,2,0,0,0,2
2020,49005,Capraia Isola,LI,4,1,0,0,0,1,0,0,0,0,0
2020,49005,Capraia Isola,LI,5,0,0,0,0,0,0,0,0,0,0
2020,49005,Capraia Isola,LI,6,2,0,0,0,2,0,0,0,0,0
2020,49005,Capraia Isola,LI,7,1,0,0,0,1,0,0,0,0,0
2020,49005,Capraia Isola,LI,8,1,0,0,0,1,0,0,0,0,0
2020,49005,Capraia Isola,LI,9,2,0,0,0,2,0,0,0,0,0
2020,49005,Capraia Isola,LI,10,0,0,0,0,0,0,0,0,0,0
2020,49005,Capraia Isola,LI,11,0,0,0,0,0,3,0,0,0,3
2020,49005,Capraia Isola,LI,12,0,0,0,0,0,0,0,0,0,0
2020,49005,Capraia Isola,LI,13,0,0,0,0,0,1,0,0,0,1
2020,49005,Capraia Isola,LI,14,2,0,0,0,2,1,0,0,0,1
2020,49005,Capraia Isola,LI,15,1,0,0,0,1,1,0,0,0,1
2020,49005,Capraia Isola,LI,16,3,0,0,0,3,0,0,0,0,0
2020,49005,Capraia Isola,LI,17,1,0,0,0,1,1,0,0,0,1
2020,49005,Capraia Isola,LI,18,0,0,0,0,0,0,0,0,0,0
2020,49005,Capraia Isola,LI,19,3,0,0,0,3,2,0,0,0,2
2020,49005,Capraia Isola,LI,20,1,0,0,0,1,0,0,0,0,0
2020,49005,Capraia Isola,LI,21,2,0,0,0,2,1,0,0,0,1
2020,49005,Capraia Isola,LI,22,5,0,0,0,5,0,0,0,0,0
2020,49005,Capraia Isola,LI,23,1,0,0,0,1,1,0,0,0,1
2020,49005,Capraia Isola,LI,24,5,0,0,0,5,6,0,0,0,6
2020,49005,Capraia Isola,LI,25,3,0,0,0,3,0,0,0,0,0
2020,49005,Capraia Isola,LI,26,4,0,0,0,4,1,0,0,0,1
2020,49005,Capraia Isola,LI,27,4,0,0,0,4,0,0,0,0,0
2020,49005,Capraia Isola,LI,28,0,0,0,0,0,2,0,0,0,2
2020,49005,Capraia Isola,LI,29,1,1,0,0,2,0,0,0,0,0
2020,49005,Capraia Isola,LI,30,0,0,0,0,0,1,0,0,0,1
2020,49005,Capraia Isola,LI,31,1,0,0,0,1,0,1,0,0,1
2020,49005,Capraia Isola,LI,32,2,0,0,0,2,2,0,0,0,2
2020,49005,Capraia Isola,LI,33,3,0,0,0,3,3,0,0,0,3
2020,49005,Capraia Isola,LI,34,1,0,0,0,1,2,1,0,0,3
2020,49005,Capraia Isola,LI,35,1,1,0,0,2,3,0,0,0,3
2020,49005,Capraia Isola,LI,36,1,1,0,0,2,5,0,0,0,5
2020,49005,Capraia Isola,LI,37,0,0,0,0,0,0,1,0,0,1
2020,49005,Capraia Isola,LI,38,0,0,0,0,0,1,0,0,0,1
2020,49005,Capraia Isola,LI,39,2,0,0,0,2,0,1,0,0,1
2020,49005,Capraia Isola,LI,40,2,0,0,0,2,3,1,0,0,4
2020,49005,Capraia Isola,LI,41,2,1,0,0,3,1,0,0,0,1
2020,49005,Capraia Isola,LI,42,1,1,0,0,2,0,1,0,0,1
2020,49005,Capraia Isola,LI,43,4,0,0,0,4,1,2,0,0,3
2020,49005,Capraia Isola,LI,44,1,0,0,0,1,5,2,0,0,7
2020,49005,Capraia Isola,LI,45,2,1,0,0,3,1,1,0,0,2
2020,49005,Capraia Isola,LI,46,0,0,2,0,2,0,1,2,0,3
2020,49005,Capraia Isola,LI,47,1,0,0,0,1,0,0,0,0,0
2020,49005,Capraia Isola,LI,48,2,3,0,0,5,0,0,0,0,0
2020,49005,Capraia Isola,LI,49,0,5,0,0,5,1,0,1,0,2
2020,49005,Capraia Isola,LI,50,2,1,1,0,4,1,2,1,0,4
2020,49005,Capraia Isola,LI,51,1,1,1,0,3,0,1,0,0,1
2020,49005,Capraia Isola,LI,52,2,3,0,0,5,1,2,0,0,3
2020,49005,Capraia Isola,LI,53,0,2,0,0,2,1,2,0,0,3
2020,49005,Capraia Isola,LI,54,0,6,0,0,6,0,3,1,0,4
2020,49005,Capraia Isola,LI,55,1,3,2,0,6,1,2,0,1,4
2020,49005,Capraia Isola,LI,56,1,1,0,0,2,1,4,1,0,6
2020,49005,Capraia Isola,LI,57,3,4,2,0,9,1,2,1,0,4
2020,49005,Capraia Isola,LI,58,0,2,1,0,3,2,0,0,1,3
2020,49005,Capraia Isola,LI,59,1,1,1,0,3,2,1,0,0,3
2020,49005,Capraia Isola,LI,60,1,3,0,0,4,0,3,1,1,5
2020,49005,Capraia Isola,LI,61,2,2,2,0,6,0,0,0,1,1
2020,49005,Capraia Isola,LI,62,0,3,1,0,4,0,2,0,1,3
2020,49005,Capraia Isola,LI,63,0,5,0,0,5,0,1,0,0,1
2020,49005,Capraia Isola,LI,64,0,2,0,0,2,0,1,1,0,2
2020,49005,Capraia Isola,LI,65,0,3,1,1,5,0,3,0,0,3
2020,49005,Capraia Isola,LI,66,1,4,2,0,7,0,4,0,0,4
2020,49005,Capraia Isola,LI,67,0,4,0,0,4,0,2,1,0,3
2020,49005,Capraia Isola,LI,68,0,3,1,0,4,0,2,0,0,2
2020,49005,Capraia Isola,LI,69,1,0,1,0,2,0,1,0,0,1
2020,49005,Capraia Isola,LI,70,0,1,0,0,1,0,1,1,0,2
2020,49005,Capraia Isola,LI,71,0,1,0,0,1,0,2,1,0,3
2020,49005,Capraia Isola,LI,72,0,5,1,1,7,0,5,1,0,6
2020,49005,Capraia Isola,LI,73,0,4,0,1,5,0,3,0,0,3
2020,49005,Capraia Isola,LI,74,0,3,0,0,3,0,3,1,1,5
2020,49005,Capraia Isola,LI,75,1,2,0,0,3,0,2,0,2,4
2020,49005,Capraia Isola,LI,76,0,2,0,1,3,0,0,0,1,1
2020,49005,Capraia Isola,LI,77,0,1,1,0,2,0,1,0,0,1
2020,49005,Capraia Isola,LI,78,0,1,0,0,1,0,1,0,0,1
2020,49005,Capraia Isola,LI,79,0,0,0,0,0,0,0,2,1,3
2020,49005,Capraia Isola,LI,80,0,0,0,0,0,0,0,0,1,1
2020,49005,Capraia Isola,LI,81,0,2,0,0,2,0,0,0,1,1
2020,49005,Capraia Isola,LI,82,0,2,0,1,3,0,2,1,0,3
2020,49005,Capraia Isola,LI,83,0,2,1,0,3,0,1,0,0,1
2020,49005,Capraia Isola,LI,84,0,1,0,1,2,0,0,1,0,1
2020,49005,Capraia Isola,LI,85,0,1,0,0,1,0,0,0,2,2
2020,49005,Capraia Isola,LI,86,0,1,0,0,1,0,0,0,2,2
2020,49005,Capraia Isola,LI,87,0,0,0,3,3,0,0,0,0,0
2020,49005,Capraia Isola,LI,88,0,1,0,0,1,0,1,0,0,1
2020,49005,Capraia Isola,LI,89,0,0,0,0,0,0,0,0,0,0
2020,49005,Capraia Isola,LI,90,0,0,0,0,0,0,0,0,0,0
2020,49005,Capraia Isola,LI,91,0,0,0,0,0,0,0,0,1,1
2020,49005,Capraia Isola,LI,92,0,0,0,0,0,0,0,0,0,0
2020,49005,Capraia Isola,LI,93,0,0,0,0,0,0,0,0,0,0
2020,49005,Capraia Isola,LI,94,0,0,0,0,0,0,0,0,0,0
2020,49005,Capraia Isola,LI,95,0,0,0,0,0,0,0,0,0,0
2020,49005,Capraia Isola,LI,96,0,0,0,0,0,0,0,0,0,0
2020,49005,Capraia Isola,LI,97,0,0,0,0,0,0,0,0,0,0
2020,49005,Capraia Isola,LI,98,0,0,0,0,0,0,0,0,0,0
2020,49005,Capraia Isola,LI,99,0,0,0,0,0,0,0,0,0,0
2020,49005,Capraia Isola,LI,100 e più,0,0,0,0,0,0,0,0,0,0
2020,49006,Castagneto Carducci,LI,0,28,0,0,0,28,20,0,0,0,20
2020,49006,Castagneto Carducci,LI,1,39,0,0,0,39,39,0,0,0,39
2020,49006,Castagneto Carducci,LI,2,32,0,0,0,32,26,0,0,0,26
2020,49006,Castagneto Carducci,LI,3,30,0,0,0,30,29,0,0,0,29
2020,49006,Castagneto Carducci,LI,4,30,0,0,0,30,30,0,0,0,30
2020,49006,Castagneto Carducci,LI,5,36,0,0,0,36,28,0,0,0,28
2020,49006,Castagneto Carducci,LI,6,40,0,0,0,40,31,0,0,0,31
2020,49006,Castagneto Carducci,LI,7,47,0,0,0,47,34,0,0,0,34
2020,49006,Castagneto Carducci,LI,8,39,0,0,0,39,38,0,0,0,38
2020,49006,Castagneto Carducci,LI,9,43,0,0,0,43,38,0,0,0,38
2020,49006,Castagneto Carducci,LI,10,33,0,0,0,33,46,0,0,0,46
2020,49006,Castagneto Carducci,LI,11,36,0,0,0,36,32,0,0,0,32
2020,49006,Castagneto Carducci,LI,12,31,0,0,0,31,46,0,0,0,46
2020,49006,Castagneto Carducci,LI,13,35,0,0,0,35,36,0,0,0,36
2020,49006,Castagneto Carducci,LI,14,44,0,0,0,44,37,0,0,0,37
2020,49006,Castagneto Carducci,LI,15,44,0,0,0,44,37,0,0,0,37
2020,49006,Castagneto Carducci,LI,16,40,0,0,0,40,42,0,0,0,42
2020,49006,Castagneto Carducci,LI,17,24,0,0,0,24,35,0,0,0,35
2020,49006,Castagneto Carducci,LI,18,32,0,0,0,32,27,0,0,0,27
2020,49006,Castagneto Carducci,LI,19,33,0,0,0,33,39,1,0,0,40
2020,49006,Castagneto Carducci,LI,20,40,0,0,0,40,33,1,0,0,34
2020,49006,Castagneto Carducci,LI,21,31,0,0,0,31,39,1,1,0,41
2020,49006,Castagneto Carducci,LI,22,36,0,0,0,36,27,3,0,0,30
2020,49006,Castagneto Carducci,LI,23,41,0,0,0,41,33,4,0,0,37
2020,49006,Castagneto Carducci,LI,24,40,1,0,0,41,25,4,0,0,29
2020,49006,Castagneto Carducci,LI,25,38,0,0,0,38,35,3,0,0,38
2020,49006,Castagneto Carducci,LI,26,33,2,0,0,35,20,7,0,0,27
2020,49006,Castagneto Carducci,LI,27,38,3,0,0,41,27,8,0,0,35
2020,49006,Castagneto Carducci,LI,28,40,6,0,0,46,31,9,0,0,40
2020,49006,Castagneto Carducci,LI,29,33,6,0,0,39,24,11,0,0,35
2020,49006,Castagneto Carducci,LI,30,41,13,0,0,54,21,8,0,0,29
2020,49006,Castagneto Carducci,LI,31,31,11,0,0,42,17,13,0,0,30
2020,49006,Castagneto Carducci,LI,32,40,9,0,0,49,22,21,0,0,43
2020,49006,Castagneto Carducci,LI,33,25,12,0,0,37,24,22,1,0,47
2020,49006,Castagneto Carducci,LI,34,20,7,0,0,27,13,24,0,1,38
2020,49006,Castagneto Carducci,LI,35,36,19,0,0,55,29,29,1,1,60
2020,49006,Castagneto Carducci,LI,36,29,12,0,0,41,22,26,1,0,49
2020,49006,Castagneto Carducci,LI,37,33,17,0,0,50,19,19,3,0,41
2020,49006,Castagneto Carducci,LI,38,28,26,1,0,55,16,19,0,0,35
2020,49006,Castagneto Carducci,LI,39,26,26,0,0,52,23,21,1,0,45
2020,49006,Castagneto Carducci,LI,40,38,23,0,0,61,28,37,2,1,68
2020,49006,Castagneto Carducci,LI,41,32,29,1,0,62,23,34,4,0,61
2020,49006,Castagneto Carducci,LI,42,43,29,2,0,74,30,42,4,0,76
2020,49006,Castagneto Carducci,LI,43,31,44,1,0,76,17,33,4,0,54
2020,49006,Castagneto Carducci,LI,44,34,30,1,1,66,22,53,3,0,78
2020,49006,Castagneto Carducci,LI,45,27,37,0,0,64,25,44,2,1,72
2020,49006,Castagneto Carducci,LI,46,41,45,2,0,88,16,40,5,1,62
2020,49006,Castagneto Carducci,LI,47,33,40,5,0,78,17,37,6,3,63
2020,49006,Castagneto Carducci,LI,48,25,34,9,0,68,9,45,5,2,61
2020,49006,Castagneto Carducci,LI,49,32,47,6,1,86,13,45,5,1,64
2020,49006,Castagneto Carducci,LI,50,20,52,7,2,81,13,50,8,4,75
2020,49006,Castagneto Carducci,LI,51,26,56,4,0,86,14,58,3,2,77
2020,49006,Castagneto Carducci,LI,52,24,50,4,1,79,16,52,7,1,76
2020,49006,Castagneto Carducci,LI,53,20,44,5,1,70,13,53,7,3,76
2020,49006,Castagneto Carducci,LI,54,19,47,3,0,69,9,47,13,1,70
2020,49006,Castagneto Carducci,LI,55,11,50,2,0,63,10,45,7,3,65
2020,49006,Castagneto Carducci,LI,56,7,50,7,2,66,9,46,3,0,58
2020,49006,Castagneto Carducci,LI,57,10,49,3,0,62,16,40,5,3,64
2020,49006,Castagneto Carducci,LI,58,15,57,4,1,77,10,46,12,4,72
2020,49006,Castagneto Carducci,LI,59,12,35,7,4,58,13,50,6,1,70
2020,49006,Castagneto Carducci,LI,60,13,41,5,1,60,8,43,8,5,64
2020,49006,Castagneto Carducci,LI,61,6,47,8,1,62,9,37,4,3,53
2020,49006,Castagneto Carducci,LI,62,10,44,7,0,61,9,46,7,4,66
2020,49006,Castagneto Carducci,LI,63,3,37,3,0,43,5,41,1,6,53
2020,49006,Castagneto Carducci,LI,64,15,38,5,0,58,10,52,5,10,77
2020,49006,Castagneto Carducci,LI,65,3,43,1,0,47,7,48,4,7,66
2020,49006,Castagneto Carducci,LI,66,5,34,3,1,43,5,59,3,5,72
2020,49006,Castagneto Carducci,LI,67,9,45,2,0,56,4,27,9,9,49
2020,49006,Castagneto Carducci,LI,68,5,38,3,3,49,1,43,0,5,49
2020,49006,Castagneto Carducci,LI,69,2,43,1,2,48,3,45,1,12,61
2020,49006,Castagneto Carducci,LI,70,2,45,3,3,53,4,45,1,8,58
2020,49006,Castagneto Carducci,LI,71,6,44,2,6,58,1,43,1,13,58
2020,49006,Castagneto Carducci,LI,72,3,59,0,7,69,3,28,3,14,48
2020,49006,Castagneto Carducci,LI,73,2,46,1,3,52,1,50,2,22,75
2020,49006,Castagneto Carducci,LI,74,1,47,1,4,53,0,42,1,16,59
2020,49006,Castagneto Carducci,LI,75,4,28,2,2,36,1,31,1,26,59
2020,49006,Castagneto Carducci,LI,76,3,40,1,4,48,0,31,2,21,54
2020,49006,Castagneto Carducci,LI,77,0,30,0,4,34,2,20,3,15,40
2020,49006,Castagneto Carducci,LI,78,4,43,4,1,52,0,27,0,20,47
2020,49006,Castagneto Carducci,LI,79,6,36,2,7,51,0,25,0,24,49
2020,49006,Castagneto Carducci,LI,80,2,29,0,2,33,3,27,1,33,64
2020,49006,Castagneto Carducci,LI,81,3,29,1,4,37,2,11,1,24,38
2020,49006,Castagneto Carducci,LI,82,3,31,0,5,39,0,18,0,27,45
2020,49006,Castagneto Carducci,LI,83,3,29,0,11,43,0,12,1,27,40
2020,49006,Castagneto Carducci,LI,84,1,11,0,5,17,1,10,0,16,27
2020,49006,Castagneto Carducci,LI,85,1,21,0,6,28,2,10,0,35,47
2020,49006,Castagneto Carducci,LI,86,3,10,0,5,18,1,5,0,23,29
2020,49006,Castagneto Carducci,LI,87,3,10,0,5,18,0,8,0,17,25
2020,49006,Castagneto Carducci,LI,88,2,11,0,1,14,0,3,0,28,31
2020,49006,Castagneto Carducci,LI,89,1,6,0,8,15,0,3,0,13,16
2020,49006,Castagneto Carducci,LI,90,0,6,1,5,12,0,2,0,17,19
2020,49006,Castagneto Carducci,LI,91,1,3,0,4,8,2,0,0,21,23
2020,49006,Castagneto Carducci,LI,92,0,1,0,3,4,1,1,0,19,21
2020,49006,Castagneto Carducci,LI,93,0,3,0,5,8,0,0,0,14,14
2020,49006,Castagneto Carducci,LI,94,0,1,0,3,4,0,1,0,7,8
2020,49006,Castagneto Carducci,LI,95,0,2,0,4,6,0,1,0,4,5
2020,49006,Castagneto Carducci,LI,96,0,1,0,1,2,1,0,0,7,8
2020,49006,Castagneto Carducci,LI,97,0,0,0,1,1,0,1,0,6,7
2020,49006,Castagneto Carducci,LI,98,0,0,0,0,0,0,0,0,4,4
2020,49006,Castagneto Carducci,LI,99,0,0,0,0,0,0,0,0,1,1
2020,49006,Castagneto Carducci,LI,100 e più,0,0,0,0,0,0,0,0,7,7
2020,49007,Cecina,LI,0,66,0,0,0,66,75,0,0,0,75
2020,49007,Cecina,LI,1,87,0,0,0,87,75,0,0,0,75
2020,49007,Cecina,LI,2,100,0,0,0,100,100,0,0,0,100
2020,49007,Cecina,LI,3,96,0,0,0,96,86,0,0,0,86
2020,49007,Cecina,LI,4,107,0,0,0,107,107,0,0,0,107
2020,49007,Cecina,LI,5,107,0,0,0,107,104,0,0,0,104
2020,49007,Cecina,LI,6,122,0,0,0,122,118,0,0,0,118
2020,49007,Cecina,LI,7,105,0,0,0,105,97,0,0,0,97
2020,49007,Cecina,LI,8,133,0,0,0,133,105,0,0,0,105
2020,49007,Cecina,LI,9,141,0,0,0,141,115,0,0,0,115
2020,49007,Cecina,LI,10,133,0,0,0,133,131,0,0,0,131
2020,49007,Cecina,LI,11,141,0,0,0,141,143,0,0,0,143
2020,49007,Cecina,LI,12,135,0,0,0,135,125,0,0,0,125
2020,49007,Cecina,LI,13,134,0,0,0,134,103,0,0,0,103
2020,49007,Cecina,LI,14,121,0,0,0,121,112,0,0,0,112
2020,49007,Cecina,LI,15,125,0,0,0,125,131,0,0,0,131
2020,49007,Cecina,LI,16,118,0,0,0,118,125,0,0,0,125
2020,49007,Cecina,LI,17,129,0,0,0,129,125,0,0,0,125
2020,49007,Cecina,LI,18,129,0,0,0,129,146,0,0,0,146
2020,49007,Cecina,LI,19,110,0,0,0,110,120,0,0,0,120
2020,49007,Cecina,LI,20,125,0,0,0,125,102,0,0,0,102
2020,49007,Cecina,LI,21,114,0,0,0,114,102,2,0,0,104
2020,49007,Cecina,LI,22,134,0,0,0,134,105,4,0,0,109
2020,49007,Cecina,LI,23,145,1,0,0,146,113,7,0,0,120
2020,49007,Cecina,LI,24,110,1,0,0,111,94,7,0,0,101
2020,49007,Cecina,LI,25,120,2,0,0,122,116,9,0,0,125
2020,49007,Cecina,LI,26,132,4,0,0,136,124,12,0,0,136
2020,49007,Cecina,LI,27,122,3,0,0,125,109,16,0,0,125
2020,49007,Cecina,LI,28,126,7,0,0,133,90,28,0,0,119
2020,49007,Cecina,LI,29,111,15,0,0,126,90,24,1,0,116
2020,49007,Cecina,LI,30,109,17,0,0,126,98,28,2,0,128
2020,49007,Cecina,LI,31,121,23,0,0,145,78,40,2,0,121
2020,49007,Cecina,LI,32,108,25,0,0,133,91,48,2,1,143
2020,49007,Cecina,LI,33,102,32,0,0,134,72,54,3,0,129
2020,49007,Cecina,LI,34,84,48,4,0,136,69,55,2,0,126
2020,49007,Cecina,LI,35,90,50,5,0,145,86,71,3,1,161
2020,49007,Cecina,LI,36,78,51,4,0,133,68,73,4,0,146
2020,49007,Cecina,LI,37,80,60,1,1,142,81,78,6,1,167
2020,49007,Cecina,LI,38,81,77,5,0,163,72,78,4,0,154
2020,49007,Cecina,LI,39,78,69,3,0,150,70,92,5,1,168
2020,49007,Cecina,LI,40,75,66,3,0,145,65,98,8,1,172
2020,49007,Cecina,LI,41,82,87,6,0,175,80,97,11,3,191
2020,49007,Cecina,LI,42,103,76,0,0,179,69,115,6,2,192
2020,49007,Cecina,LI,43,78,94,12,0,184,71,131,12,0,214
2020,49007,Cecina,LI,44,78,98,7,0,183,70,143,9,1,223
2020,49007,Cecina,LI,45,97,126,9,1,233,66,133,21,1,222
2020,49007,Cecina,LI,46,82,149,15,1,247,52,164,18,2,236
2020,49007,Cecina,LI,47,67,136,10,2,215,65,151,17,4,237
2020,49007,Cecina,LI,48,76,120,12,0,208,66,159,27,3,255
2020,49007,Cecina,LI,49,52,150,13,0,215,58,142,27,4,231
2020,49007,Cecina,LI,50,53,148,17,2,220,45,139,24,2,210
2020,49007,Cecina,LI,51,57,152,12,1,222,54,172,30,6,262
2020,49007,Cecina,LI,52,54,143,13,0,210,28,172,35,7,242
2020,49007,Cecina,LI,53,39,139,16,1,195,37,151,37,2,227
2020,49007,Cecina,LI,54,38,150,20,1,209,40,170,22,3,235
2020,49007,Cecina,LI,55,42,156,21,2,221,41,158,35,4,239
2020,49007,Cecina,LI,56,32,154,30,7,224,32,176,28,12,248
2020,49007,Cecina,LI,57,23,139,22,4,188,32,161,31,8,232
2020,49007,Cecina,LI,58,30,156,22,1,209,36,148,28,14,226
2020,49007,Cecina,LI,59,17,164,21,7,209,23,168,25,14,230
2020,49007,Cecina,LI,60,25,139,18,4,186,28,168,21,12,229
2020,49007,Cecina,LI,61,15,148,15,2,180,24,141,33,17,215
2020,49007,Cecina,LI,62,23,125,18,5,171,13,130,24,19,186
2020,49007,Cecina,LI,63,13,154,18,5,190,14,130,11,24,179
2020,49007,Cecina,LI,64,13,140,10,7,170,14,158,15,34,221
2020,49007,Cecina,LI,65,11,148,11,2,172,17,151,14,21,203
2020,49007,Cecina,LI,66,14,139,9,3,165,16,149,20,18,203
2020,49007,Cecina,LI,67,9,121,15,10,155,15,123,21,25,184
2020,49007,Cecina,LI,68,13,138,10,10,171,9,139,6,29,183
2020,49007,Cecina,LI,69,8,120,11,8,147,7,113,10,25,155
2020,49007,Cecina,LI,70,8,133,6,11,158,11,134,15,34,194
2020,49007,Cecina,LI,71,8,166,9,7,190,19,127,14,35,195
2020,49007,Cecina,LI,72,7,147,3,16,173,5,135,6,52,198
2020,49007,Cecina,LI,73,5,143,10,12,170,8,115,16,61,200
2020,49007,Cecina,LI,74,8,141,8,11,168,13,128,13,55,209
2020,49007,Cecina,LI,75,6,120,5,9,140,5,105,5,53,168
2020,49007,Cecina,LI,76,4,88,5,15,112,8,86,2,58,154
2020,49007,Cecina,LI,77,4,102,6,8,120,6,101,3,46,156
2020,49007,Cecina,LI,78,7,91,1,16,115,11,75,2,65,153
2020,49007,Cecina,LI,79,2,98,4,18,123,12,75,4,66,157
2020,49007,Cecina,LI,80,3,98,3,19,123,6,56,6,91,159
2020,49007,Cecina,LI,81,3,95,0,16,114,6,65,5,80,156
2020,49007,Cecina,LI,82,6,101,4,18,129,9,68,3,86,166
2020,49007,Cecina,LI,83,4,75,3,11,93,2,41,2,90,135
2020,49007,Cecina,LI,84,3,56,1,11,71,7,38,1,74,120
2020,49007,Cecina,LI,85,2,57,2,21,82,6,28,3,79,116
2020,49007,Cecina,LI,86,3,48,1,15,67,7,24,0,85,116
2020,49007,Cecina,LI,87,1,40,0,15,56,3,23,1,86,113
2020,49007,Cecina,LI,88,0,34,0,15,49,2,16,2,77,97
2020,49007,Cecina,LI,89,2,28,0,12,42,2,9,2,78,91
2020,49007,Cecina,LI,90,3,28,0,20,51,6,8,0,67,81
2020,49007,Cecina,LI,91,2,16,0,7,25,1,4,1,63,69
2020,49007,Cecina,LI,92,0,6,0,10,16,3,3,0,49,55
2020,49007,Cecina,LI,93,0,8,0,9,17,4,2,1,40,47
2020,49007,Cecina,LI,94,0,5,1,10,16,1,2,0,26,29
2020,49007,Cecina,LI,95,0,3,0,9,12,1,0,0,13,14
2020,49007,Cecina,LI,96,1,0,0,5,6,0,1,1,10,12
2020,49007,Cecina,LI,97,0,2,0,4,6,0,0,0,11,11
2020,49007,Cecina,LI,98,0,0,0,0,0,0,0,0,9,9
2020,49007,Cecina,LI,99,0,1,0,0,1,0,0,0,8,8
2020,49007,Cecina,LI,100 e più,0,0,0,2,2,0,1,0,5,6
2020,49008,Collesalvetti,LI,0,45,0,0,0,45,48,0,0,0,48
2020,49008,Collesalvetti,LI,1,59,0,0,0,59,54,0,0,0,54
2020,49008,Collesalvetti,LI,2,58,0,0,0,58,49,0,0,0,49
2020,49008,Collesalvetti,LI,3,69,0,0,0,69,63,0,0,0,63
2020,49008,Collesalvetti,LI,4,57,0,0,0,57,60,0,0,0,60
2020,49008,Collesalvetti,LI,5,68,0,0,0,68,85,0,0,0,85
2020,49008,Collesalvetti,LI,6,72,0,0,0,72,77,0,0,0,77
2020,49008,Collesalvetti,LI,7,73,0,0,0,73,57,0,0,0,57
2020,49008,Collesalvetti,LI,8,85,0,0,0,85,103,0,0,0,103
2020,49008,Collesalvetti,LI,9,70,0,0,0,70,69,0,0,0,69
2020,49008,Collesalvetti,LI,10,67,0,0,0,67,73,0,0,0,73
2020,49008,Collesalvetti,LI,11,87,0,0,0,87,70,0,0,0,70
2020,49008,Collesalvetti,LI,12,100,0,0,0,100,71,0,0,0,71
2020,49008,Collesalvetti,LI,13,87,0,0,0,87,82,0,0,0,82
2020,49008,Collesalvetti,LI,14,80,0,0,0,80,89,0,0,0,89
2020,49008,Collesalvetti,LI,15,74,0,0,0,74,70,0,0,0,70
2020,49008,Collesalvetti,LI,16,78,0,0,0,78,70,0,0,0,70
2020,49008,Collesalvetti,LI,17,73,0,0,0,73,81,0,0,0,81
2020,49008,Collesalvetti,LI,18,75,0,0,0,75,73,0,0,0,73
2020,49008,Collesalvetti,LI,19,57,0,0,0,57,78,1,0,0,79
2020,49008,Collesalvetti,LI,20,73,0,0,0,73,67,0,0,0,67
2020,49008,Collesalvetti,LI,21,69,0,0,0,69,57,0,0,0,57
2020,49008,Collesalvetti,LI,22,63,0,0,0,63,48,2,0,0,50
2020,49008,Collesalvetti,LI,23,73,0,0,0,73,67,8,0,0,75
2020,49008,Collesalvetti,LI,24,83,0,0,0,83,63,4,0,0,67
2020,49008,Collesalvetti,LI,25,64,1,0,0,65,65,4,0,0,69
2020,49008,Collesalvetti,LI,26,64,2,0,0,66,57,5,0,0,62
2020,49008,Collesalvetti,LI,27,58,1,0,0,59,55,11,1,0,67
2020,49008,Collesalvetti,LI,28,60,5,0,0,65,57,18,0,0,75
2020,49008,Collesalvetti,LI,29,60,6,0,0,66,47,18,1,0,66
2020,49008,Collesalvetti,LI,30,62,11,0,0,73,45,19,1,0,65
2020,49008,Collesalvetti,LI,31,61,17,0,0,78,51,36,0,0,87
2020,49008,Collesalvetti,LI,32,73,30,0,0,103,53,33,0,1,87
2020,49008,Collesalvetti,LI,33,47,30,0,0,77,54,28,2,0,84
2020,49008,Collesalvetti,LI,34,54,27,1,0,82,35,40,1,0,76
2020,49008,Collesalvetti,LI,35,50,20,2,0,72,40,42,0,1,83
2020,49008,Collesalvetti,LI,36,60,33,0,0,93,36,57,5,0,98
2020,49008,Collesalvetti,LI,37,47,43,1,0,91,37,46,4,0,87
2020,49008,Collesalvetti,LI,38,46,51,1,0,98,37,51,3,0,91
2020,49008,Collesalvetti,LI,39,40,40,6,0,86,32,48,5,1,86
2020,49008,Collesalvetti,LI,40,59,50,3,0,112,34,65,3,1,103
2020,49008,Collesalvetti,LI,41,49,46,1,0,96,39,52,6,1,98
2020,49008,Collesalvetti,LI,42,48,63,3,1,115,33,88,6,0,127
2020,49008,Collesalvetti,LI,43,62,78,4,0,144,38,72,13,0,123
2020,49008,Collesalvetti,LI,44,56,82,7,1,146,37,78,11,3,129
2020,49008,Collesalvetti,LI,45,33,81,8,0,122,34,103,16,3,156
2020,49008,Collesalvetti,LI,46,48,87,7,1,143,21,113,14,3,151
2020,49008,Collesalvetti,LI,47,49,91,9,2,151,40,96,11,0,147
2020,49008,Collesalvetti,LI,48,43,77,8,0,128,34,124,22,2,182
2020,49008,Collesalvetti,LI,49,32,91,14,1,138,23,82,14,0,119
2020,49008,Collesalvetti,LI,50,33,98,18,0,149,19,104,22,4,149
2020,49008,Collesalvetti,LI,51,32,109,15,1,157,17,81,13,4,115
2020,49008,Collesalvetti,LI,52,32,84,11,0,127,23,93,13,3,132
2020,49008,Collesalvetti,LI,53,24,74,14,0,112,15,98,15,4,132
2020,49008,Collesalvetti,LI,54,23,85,9,0,117,18,110,16,3,147
2020,49008,Collesalvetti,LI,55,25,115,10,2,152,14,100,18,4,136
2020,49008,Collesalvetti,LI,56,17,111,16,3,147,11,89,18,3,121
2020,49008,Collesalvetti,LI,57,16,99,16,2,133,8,102,17,6,133
2020,49008,Collesalvetti,LI,58,21,92,6,1,120,11,97,16,3,127
2020,49008,Collesalvetti,LI,59,9,88,17,4,118,7,89,17,6,119
2020,49008,Collesalvetti,LI,60,10,78,9,0,97,11,87,5,12,115
2020,49008,Collesalvetti,LI,61,9,95,7,5,116,6,77,9,7,99
2020,49008,Collesalvetti,LI,62,11,78,5,2,96,4,94,8,11,117
2020,49008,Collesalvetti,LI,63,7,92,8,3,110,3,80,13,11,107
2020,49008,Collesalvetti,LI,64,13,97,2,0,112,6,100,12,8,126
2020,49008,Collesalvetti,LI,65,4,90,10,1,105,4,93,5,20,122
2020,49008,Collesalvetti,LI,66,5,83,5,7,100,4,82,6,14,106
2020,49008,Collesalvetti,LI,67,4,75,6,3,88,5,83,5,13,106
2020,49008,Collesalvetti,LI,68,4,94,4,2,104,3,71,7,16,97
2020,49008,Collesalvetti,LI,69,3,80,2,3,88,3,67,6,23,99
2020,49008,Collesalvetti,LI,70,3,70,5,3,81,8,95,5,15,123
2020,49008,Collesalvetti,LI,71,5,87,3,4,99,4,75,11,19,109
2020,49008,Collesalvetti,LI,72,3,90,2,9,104,4,89,1,23,117
2020,49008,Collesalvetti,LI,73,5,82,3,10,100,3,73,6,34,116
2020,49008,Collesalvetti,LI,74,4,96,2,11,113,1,89,3,33,126
2020,49008,Collesalvetti,LI,75,3,73,3,8,87,2,70,4,26,102
2020,49008,Collesalvetti,LI,76,3,69,4,10,86,1,44,2,26,73
2020,49008,Collesalvetti,LI,77,5,62,3,10,80,1,51,4,35,91
2020,49008,Collesalvetti,LI,78,2,50,3,8,63,2,42,2,27,73
2020,49008,Collesalvetti,LI,79,5,56,3,4,68,2,36,2,32,72
2020,49008,Collesalvetti,LI,80,7,50,1,8,66,4,31,1,34,70
2020,49008,Collesalvetti,LI,81,4,63,1,9,77,5,28,2,43,78
2020,49008,Collesalvetti,LI,82,1,44,0,9,54,0,33,0,35,68
2020,49008,Collesalvetti,LI,83,0,47,1,6,54,0,27,0,44,71
2020,49008,Collesalvetti,LI,84,4,26,0,12,42,0,18,2,41,61
2020,49008,Collesalvetti,LI,85,4,32,1,16,53,3,12,0,34,49
2020,49008,Collesalvetti,LI,86,2,17,0,10,29,1,12,0,34,47
2020,49008,Collesalvetti,LI,87,2,17,0,10,29,0,7,0,35,42
2020,49008,Collesalvetti,LI,88,2,20,1,3,26,1,7,0,24,32
2020,49008,Collesalvetti,LI,89,0,14,1,6,21,0,5,1,34,40
2020,49008,Collesalvetti,LI,90,0,6,1,3,10,1,2,0,26,29
2020,49008,Collesalvetti,LI,91,1,8,0,3,12,0,3,1,23,27
2020,49008,Collesalvetti,LI,92,0,8,0,7,15,1,2,0,19,22
2020,49008,Collesalvetti,LI,93,0,6,0,6,12,1,0,0,16,17
2020,49008,Collesalvetti,LI,94,0,1,0,2,3,0,0,0,7,7
2020,49008,Collesalvetti,LI,95,0,2,0,2,4,2,0,0,12,14
2020,49008,Collesalvetti,LI,96,0,2,0,5,7,0,0,0,8,8
2020,49008,Collesalvetti,LI,97,1,0,0,2,3,0,1,0,6,7
2020,49008,Collesalvetti,LI,98,0,0,0,1,1,0,0,0,2,2
2020,49008,Collesalvetti,LI,99,0,0,0,2,2,0,0,0,5,5
2020,49008,Collesalvetti,LI,100 e più,0,0,0,2,2,0,0,0,6,6
2020,49009,Livorno,LI,0,490,0,0,0,490,444,0,0,0,444
2020,49009,Livorno,LI,1,458,0,0,0,458,492,0,0,0,492
2020,49009,Livorno,LI,2,530,0,0,0,530,556,0,0,0,556
2020,49009,Livorno,LI,3,530,0,0,0,530,531,0,0,0,531
2020,49009,Livorno,LI,4,578,0,0,0,578,531,0,0,0,531
2020,49009,Livorno,LI,5,612,0,0,0,612,589,0,0,0,589
2020,49009,Livorno,LI,6,621,0,0,0,621,567,0,0,0,567
2020,49009,Livorno,LI,7,638,0,0,0,638,624,0,0,0,624
2020,49009,Livorno,LI,8,631,0,0,0,631,634,0,0,0,634
2020,49009,Livorno,LI,9,635,0,0,0,635,622,0,0,0,622
2020,49009,Livorno,LI,10,744,0,0,0,744,690,0,0,0,690
2020,49009,Livorno,LI,11,751,0,0,0,751,651,0,0,0,651
2020,49009,Livorno,LI,12,719,0,0,0,719,623,0,0,0,623
2020,49009,Livorno,LI,13,772,0,0,0,772,712,0,0,0,712
2020,49009,Livorno,LI,14,711,0,0,0,711,723,0,0,0,723
2020,49009,Livorno,LI,15,705,0,0,0,705,655,0,0,0,655
2020,49009,Livorno,LI,16,756,0,0,0,756,671,0,0,0,671
2020,49009,Livorno,LI,17,709,0,0,0,709,656,0,0,0,656
2020,49009,Livorno,LI,18,703,0,0,0,703,630,0,0,0,630
2020,49009,Livorno,LI,19,721,1,0,0,722,671,2,0,0,673
2020,49009,Livorno,LI,20,683,1,0,0,684,645,3,0,0,648
2020,49009,Livorno,LI,21,724,1,0,0,725,569,13,0,0,582
2020,49009,Livorno,LI,22,704,1,0,0,705,618,18,0,0,636
2020,49009,Livorno,LI,23,753,5,0,0,758,627,22,0,0,649
2020,49009,Livorno,LI,24,714,12,0,0,726,585,34,0,1,620
2020,49009,Livorno,LI,25,682,14,1,0,697,605,47,1,0,653
2020,49009,Livorno,LI,26,686,23,0,0,709,617,56,1,0,674
2020,49009,Livorno,LI,27,695,25,2,0,722,525,85,1,0,611
2020,49009,Livorno,LI,28,695,49,2,0,748,568,125,3,0,697
2020,49009,Livorno,LI,29,693,78,3,0,774,521,163,4,0,688
2020,49009,Livorno,LI,30,674,131,4,0,809,512,216,10,0,738
2020,49009,Livorno,LI,31,679,129,3,0,813,493,236,2,2,733
2020,49009,Livorno,LI,32,621,190,3,0,814,467,282,8,1,758
2020,49009,Livorno,LI,33,531,201,4,1,737,474,308,12,5,801
2020,49009,Livorno,LI,34,503,249,5,0,757,400,348,13,1,765
2020,49009,Livorno,LI,35,506,296,11,0,813,398,344,20,4,766
2020,49009,Livorno,LI,36,477,295,13,1,787,377,374,32,2,786
2020,49009,Livorno,LI,37,449,387,18,1,856,362,432,23,5,824
2020,49009,Livorno,LI,38,513,368,18,1,901,386,447,42,3,878
2020,49009,Livorno,LI,39,430,391,18,0,839,353,492,50,4,899
2020,49009,Livorno,LI,40,459,420,28,1,909,355,543,43,4,945
2020,49009,Livorno,LI,41,413,481,15,0,910,346,587,44,4,981
2020,49009,Livorno,LI,42,464,523,32,1,1021,316,604,52,0,972
2020,49009,Livorno,LI,43,408,558,33,1,1000,368,635,68,7,1080
2020,49009,Livorno,LI,44,428,572,58,1,1060,349,682,78,9,1118
2020,49009,Livorno,LI,45,449,666,53,1,1171,357,722,93,8,1182
2020,49009,Livorno,LI,46,466,732,69,2,1272,358,835,101,14,1308
2020,49009,Livorno,LI,47,417,758,90,2,1268,315,863,116,10,1305
2020,49009,Livorno,LI,48,395,750,91,12,1249,305,890,125,18,1339
2020,49009,Livorno,LI,49,396,813,101,9,1320,281,904,135,15,1337
2020,49009,Livorno,LI,50,358,830,109,2,1300,259,867,161,21,1309
2020,49009,Livorno,LI,51,301,808,117,7,1234,193,915,153,25,1287
2020,49009,Livorno,LI,52,293,799,101,10,1204,218,897,147,31,1294
2020,49009,Livorno,LI,53,290,892,114,7,1304,194,946,176,33,1349
2020,49009,Livorno,LI,54,237,856,127,7,1228,213,942,158,42,1355
2020,49009,Livorno,LI,55,225,844,117,15,1203,198,930,165,30,1324
2020,49009,Livorno,LI,56,230,926,134,13,1304,196,942,188,52,1381
2020,49009,Livorno,LI,57,190,888,133,16,1229,149,946,188,59,1346
2020,49009,Livorno,LI,58,178,847,136,13,1175,133,882,144,64,1224
2020,49009,Livorno,LI,59,149,853,120,16,1140,155,874,150,68,1249
2020,49009,Livorno,LI,60,114,819,110,19,1064,118,818,147,67,1152
2020,49009,Livorno,LI,61,123,782,83,14,1002,105,773,133,76,1087
2020,49009,Livorno,LI,62,115,716,86,18,935,104,792,141,94,1131
2020,49009,Livorno,LI,63,95,793,93,20,1002,95,779,118,111,1104
2020,49009,Livorno,LI,64,77,765,84,33,960,98,722,91,123,1036
2020,49009,Livorno,LI,65,101,759,79,27,966,74,743,112,129,1058
2020,49009,Livorno,LI,66,86,674,54,26,840,76,764,90,148,1078
2020,49009,Livorno,LI,67,56,702,67,32,857,57,712,83,112,964
2020,49009,Livorno,LI,68,74,666,56,33,829,69,655,74,149,949
2020,49009,Livorno,LI,69,67,700,36,36,840,63,653,60,172,948
2020,49009,Livorno,LI,70,62,714,53,41,871,61,670,74,159,964
2020,49009,Livorno,LI,71,43,760,51,64,918,61,710,76,209,1056
2020,49009,Livorno,LI,72,46,825,39,64,974,59,730,84,250,1123
2020,49009,Livorno,LI,73,46,817,59,73,996,55,765,87,272,1179
2020,49009,Livorno,LI,74,42,901,45,72,1060,61,846,82,363,1352
2020,49009,Livorno,LI,75,43,686,28,69,827,34,610,56,283,983
2020,49009,Livorno,LI,76,25,670,32,75,802,43,559,44,326,972
2020,49009,Livorno,LI,77,18,555,20,84,679,41,459,38,334,872
2020,49009,Livorno,LI,78,25,582,15,86,708,35,470,50,325,880
2020,49009,Livorno,LI,79,20,508,17,77,624,50,402,37,373,862
2020,49009,Livorno,LI,80,21,530,21,98,670,41,385,33,448,908
2020,49009,Livorno,LI,81,27,481,15,89,612,42,359,29,470,900
2020,49009,Livorno,LI,82,13,468,13,112,606,39,328,20,468,855
2020,49009,Livorno,LI,83,13,406,13,96,528,41,268,24,442,775
2020,49009,Livorno,LI,84,14,330,6,70,420,32,196,19,432,679
2020,49009,Livorno,LI,85,18,312,9,79,418,26,148,16,432,622
2020,49009,Livorno,LI,86,11,221,10,93,335,42,119,10,374,545
2020,49009,Livorno,LI,87,10,190,4,71,276,24,70,13,371,478
2020,49009,Livorno,LI,88,11,178,2,67,258,30,76,7,392,505
2020,49009,Livorno,LI,89,9,134,1,82,226,30,46,10,327,413
2020,49009,Livorno,LI,90,5,110,0,62,177,28,36,5,320,389
2020,49009,Livorno,LI,91,4,77,1,55,137,30,26,3,294,353
2020,49009,Livorno,LI,92,1,54,1,64,120,24,12,3,246,285
2020,49009,Livorno,LI,93,2,47,0,42,91,20,11,1,202,234
2020,49009,Livorno,LI,94,2,27,0,29,58,19,8,2,165,194
2020,49009,Livorno,LI,95,1,12,0,21,34,11,5,2,105,123
2020,49009,Livorno,LI,96,1,11,2,20,34,8,1,4,91,104
2020,49009,Livorno,LI,97,2,6,0,11,19,6,0,0,61,67
2020,49009,Livorno,LI,98,0,2,0,17,19,2,0,1,47,50
2020,49009,Livorno,LI,99,0,0,0,5,5,4,1,1,36,42
2020,49009,Livorno,LI,100 e più,1,2,0,4,7,3,1,0,36,40
2020,49010,Marciana,LI,0,4,0,0,0,4,3,0,0,0,3
2020,49010,Marciana,LI,1,2,0,0,0,2,2,0,0,0,2
2020,49010,Marciana,LI,2,4,0,0,0,4,5,0,0,0,5
2020,49010,Marciana,LI,3,7,0,0,0,7,5,0,0,0,5
2020,49010,Marciana,LI,4,5,0,0,0,5,4,0,0,0,4
2020,49010,Marciana,LI,5,8,0,0,0,8,4,0,0,0,4
2020,49010,Marciana,LI,6,5,0,0,0,5,3,0,0,0,3
2020,49010,Marciana,LI,7,5,0,0,0,5,8,0,0,0,8
2020,49010,Marciana,LI,8,10,0,0,0,10,2,0,0,0,2
2020,49010,Marciana,LI,9,4,0,0,0,4,8,0,0,0,8
2020,49010,Marciana,LI,10,4,0,0,0,4,9,0,0,0,9
2020,49010,Marciana,LI,11,7,0,0,0,7,6,0,0,0,6
2020,49010,Marciana,LI,12,9,0,0,0,9,9,0,0,0,9
2020,49010,Marciana,LI,13,5,0,0,0,5,9,0,0,0,9
2020,49010,Marciana,LI,14,7,0,0,0,7,9,0,0,0,9
2020,49010,Marciana,LI,15,7,0,0,0,7,6,0,0,0,6
2020,49010,Marciana,LI,16,2,0,0,0,2,5,0,0,0,5
2020,49010,Marciana,LI,17,9,0,0,0,9,6,0,0,0,6
2020,49010,Marciana,LI,18,5,0,0,0,5,7,0,0,0,7
2020,49010,Marciana,LI,19,10,0,0,0,10,9,0,0,0,9
2020,49010,Marciana,LI,20,13,0,0,0,13,10,0,0,0,10
2020,49010,Marciana,LI,21,9,0,0,0,9,7,0,0,0,7
2020,49010,Marciana,LI,22,9,0,0,0,9,10,1,0,0,11
2020,49010,Marciana,LI,23,10,1,0,0,11,11,0,0,0,11
2020,49010,Marciana,LI,24,4,0,0,0,4,3,0,0,0,3
2020,49010,Marciana,LI,25,11,0,0,0,11,9,0,0,0,9
2020,49010,Marciana,LI,26,6,0,0,0,6,10,0,0,0,10
2020,49010,Marciana,LI,27,6,0,0,0,6,8,1,0,0,9
2020,49010,Marciana,LI,28,9,1,0,0,10,2,1,0,0,3
2020,49010,Marciana,LI,29,4,2,0,0,6,10,1,0,0,11
2020,49010,Marciana,LI,30,9,0,0,0,9,5,2,0,0,7
2020,49010,Marciana,LI,31,9,1,0,0,10,8,1,0,0,9
2020,49010,Marciana,LI,32,6,1,0,0,7,9,3,0,0,12
2020,49010,Marciana,LI,33,5,1,0,0,6,5,4,0,0,9
2020,49010,Marciana,LI,34,6,3,0,0,9,5,4,0,0,9
2020,49010,Marciana,LI,35,7,3,0,0,10,5,2,0,0,7
2020,49010,Marciana,LI,36,5,1,0,0,6,11,7,0,0,18
2020,49010,Marciana,LI,37,5,2,0,0,7,3,3,0,0,6
2020,49010,Marciana,LI,38,9,0,1,0,10,5,2,0,0,7
2020,49010,Marciana,LI,39,3,3,0,0,6,7,6,1,0,14
2020,49010,Marciana,LI,40,13,3,0,0,16,9,3,0,0,12
2020,49010,Marciana,LI,41,8,7,0,0,15,4,2,0,0,6
2020,49010,Marciana,LI,42,5,4,0,0,9,7,8,1,0,16
2020,49010,Marciana,LI,43,7,4,0,0,11,7,3,1,0,11
2020,49010,Marciana,LI,44,8,3,0,0,11,6,8,0,0,14
2020,49010,Marciana,LI,45,8,9,0,0,17,3,12,2,0,17
2020,49010,Marciana,LI,46,6,6,0,0,12,7,9,1,0,17
2020,49010,Marciana,LI,47,10,9,3,0,22,9,8,1,0,18
2020,49010,Marciana,LI,48,5,11,0,0,16,3,6,2,1,12
2020,49010,Marciana,LI,49,6,10,0,0,16,7,9,2,0,18
2020,49010,Marciana,LI,50,4,11,3,0,18,6,12,1,0,19
2020,49010,Marciana,LI,51,4,9,3,0,16,8,13,2,0,23
2020,49010,Marciana,LI,52,5,10,2,0,17,3,8,1,1,13
2020,49010,Marciana,LI,53,3,12,3,0,18,6,13,3,1,23
2020,49010,Marciana,LI,54,7,9,1,0,17,0,11,2,0,13
2020,49010,Marciana,LI,55,6,12,0,0,18,1,12,1,0,14
2020,49010,Marciana,LI,56,10,13,1,0,24,4,16,1,1,22
2020,49010,Marciana,LI,57,5,4,4,1,14,9,13,1,0,23
2020,49010,Marciana,LI,58,5,13,2,0,20,1,15,1,0,17
2020,49010,Marciana,LI,59,8,20,2,1,31,5,8,2,0,15
2020,49010,Marciana,LI,60,2,13,0,0,15,2,11,3,3,19
2020,49010,Marciana,LI,61,5,15,1,0,21,1,9,1,0,11
2020,49010,Marciana,LI,62,6,12,0,2,20,0,7,3,2,12
2020,49010,Marciana,LI,63,2,7,1,1,11,8,14,0,0,22
2020,49010,Marciana,LI,64,3,9,1,1,14,1,11,3,3,18
2020,49010,Marciana,LI,65,1,12,3,0,16,2,10,2,1,15
2020,49010,Marciana,LI,66,3,12,1,0,16,2,12,0,0,14
2020,49010,Marciana,LI,67,3,14,1,0,18,1,8,1,1,11
2020,49010,Marciana,LI,68,2,9,1,1,13,1,11,1,1,14
2020,49010,Marciana,LI,69,2,13,1,0,16,0,8,0,2,10
2020,49010,Marciana,LI,70,1,10,0,0,11,2,8,3,6,19
2020,49010,Marciana,LI,71,1,14,1,1,17,0,7,2,0,9
2020,49010,Marciana,LI,72,0,15,0,0,15,1,13,0,1,15
2020,49010,Marciana,LI,73,0,9,2,1,12,3,17,0,4,24
2020,49010,Marciana,LI,74,0,14,0,2,16,1,8,0,7,16
2020,49010,Marciana,LI,75,2,8,1,0,11,0,4,0,3,7
2020,49010,Marciana,LI,76,0,9,0,0,9,2,7,0,7,16
2020,49010,Marciana,LI,77,0,8,0,2,10,1,7,0,2,10
2020,49010,Marciana,LI,78,1,10,0,1,12,1,8,0,4,13
2020,49010,Marciana,LI,79,1,9,0,1,11,1,6,0,6,13
2020,49010,Marciana,LI,80,1,8,0,0,9,1,11,0,9,21
2020,49010,Marciana,LI,81,0,6,1,1,8,1,2,0,8,11
2020,49010,Marciana,LI,82,0,7,0,3,10,0,2,0,4,6
2020,49010,Marciana,LI,83,1,4,0,0,5,0,5,0,3,8
2020,49010,Marciana,LI,84,0,4,0,2,6,0,4,0,3,7
2020,49010,Marciana,LI,85,1,5,0,2,8,1,3,0,8,12
2020,49010,Marciana,LI,86,0,4,0,1,5,2,2,0,10,14
2020,49010,Marciana,LI,87,0,2,1,1,4,1,2,0,7,10
2020,49010,Marciana,LI,88,0,0,0,0,0,0,1,0,7,8
2020,49010,Marciana,LI,89,1,4,0,1,6,0,0,0,13,13
2020,49010,Marciana,LI,90,1,1,0,1,3,0,0,0,9,9
2020,49010,Marciana,LI,91,0,1,0,2,3,0,1,0,5,6
2020,49010,Marciana,LI,92,0,1,0,1,2,0,0,0,5,5
2020,49010,Marciana,LI,93,0,1,0,0,1,1,0,0,6,7
2020,49010,Marciana,LI,94,0,5,0,0,5,0,0,0,2,2
2020,49010,Marciana,LI,95,0,0,0,2,2,0,0,0,2,2
2020,49010,Marciana,LI,96,0,0,0,1,1,0,0,0,1,1
2020,49010,Marciana,LI,97,0,0,0,2,2,0,0,0,0,0
2020,49010,Marciana,LI,98,0,1,0,0,1,0,0,0,1,1
2020,49010,Marciana,LI,99,0,0,0,2,2,1,0,0,2,3
2020,49010,Marciana,LI,100 e più,0,0,0,0,0,1,0,0,2,3
2020,49011,Marciana Marina,LI,0,7,0,0,0,7,6,0,0,0,6
2020,49011,Marciana Marina,LI,1,4,0,0,0,4,5,0,0,0,5
2020,49011,Marciana Marina,LI,2,2,0,0,0,2,3,0,0,0,3
2020,49011,Marciana Marina,LI,3,2,0,0,0,2,8,0,0,0,8
2020,49011,Marciana Marina,LI,4,13,0,0,0,13,6,0,0,0,6
2020,49011,Marciana Marina,LI,5,5,0,0,0,5,4,0,0,0,4
2020,49011,Marciana Marina,LI,6,4,0,0,0,4,6,0,0,0,6
2020,49011,Marciana Marina,LI,7,4,0,0,0,4,4,0,0,0,4
2020,49011,Marciana Marina,LI,8,4,0,0,0,4,3,0,0,0,3
2020,49011,Marciana Marina,LI,9,7,0,0,0,7,8,0,0,0,8
2020,49011,Marciana Marina,LI,10,6,0,0,0,6,5,0,0,0,5
2020,49011,Marciana Marina,LI,11,10,0,0,0,10,7,0,0,0,7
2020,49011,Marciana Marina,LI,12,5,0,0,0,5,7,0,0,0,7
2020,49011,Marciana Marina,LI,13,7,0,0,0,7,8,0,0,0,8
2020,49011,Marciana Marina,LI,14,2,0,0,0,2,6,0,0,0,6
2020,49011,Marciana Marina,LI,15,6,0,0,0,6,7,0,0,0,7
2020,49011,Marciana Marina,LI,16,7,0,0,0,7,6,0,0,0,6
2020,49011,Marciana Marina,LI,17,3,0,0,0,3,7,0,0,0,7
2020,49011,Marciana Marina,LI,18,10,0,0,0,10,9,0,0,0,9
2020,49011,Marciana Marina,LI,19,11,0,0,0,11,10,0,0,0,10
2020,49011,Marciana Marina,LI,20,11,0,0,0,11,9,0,0,0,9
2020,49011,Marciana Marina,LI,21,6,0,0,0,6,4,0,0,0,4
2020,49011,Marciana Marina,LI,22,5,0,0,0,5,5,0,0,0,5
2020,49011,Marciana Marina,LI,23,4,0,0,0,4,6,0,0,0,6
2020,49011,Marciana Marina,LI,24,10,0,0,0,10,6,0,0,0,6
2020,49011,Marciana Marina,LI,25,7,1,0,0,8,6,0,0,0,6
2020,49011,Marciana Marina,LI,26,10,0,0,0,10,6,1,0,0,7
2020,49011,Marciana Marina,LI,27,10,0,0,0,10,2,1,0,0,3
2020,49011,Marciana Marina,LI,28,12,0,0,0,12,4,1,0,0,5
2020,49011,Marciana Marina,LI,29,9,1,0,0,10,8,0,0,0,8
2020,49011,Marciana Marina,LI,30,6,0,0,0,6,9,1,0,0,10
2020,49011,Marciana Marina,LI,31,8,0,0,0,8,10,2,0,0,12
2020,49011,Marciana Marina,LI,32,9,0,0,0,9,6,2,0,0,8
2020,49011,Marciana Marina,LI,33,5,2,0,0,7,3,1,0,0,4
2020,49011,Marciana Marina,LI,34,4,4,0,0,8,7,5,0,0,12
2020,49011,Marciana Marina,LI,35,15,0,0,0,15,10,2,1,0,13
2020,49011,Marciana Marina,LI,36,7,4,0,0,11,4,3,0,0,7
2020,49011,Marciana Marina,LI,37,8,3,0,0,11,4,6,0,0,10
2020,49011,Marciana Marina,LI,38,8,5,1,0,14,5,4,0,0,9
2020,49011,Marciana Marina,LI,39,4,0,0,0,4,7,4,0,0,11
2020,49011,Marciana Marina,LI,40,9,3,0,0,12,7,6,1,0,14
2020,49011,Marciana Marina,LI,41,12,2,0,0,14,5,4,0,0,9
2020,49011,Marciana Marina,LI,42,10,3,0,0,13,6,5,1,1,13
2020,49011,Marciana Marina,LI,43,7,3,0,0,10,5,8,0,0,13
2020,49011,Marciana Marina,LI,44,4,2,1,0,7,8,3,1,0,12
2020,49011,Marciana Marina,LI,45,9,4,0,0,13,3,4,1,0,8
2020,49011,Marciana Marina,LI,46,5,8,0,0,13,2,8,0,0,10
2020,49011,Marciana Marina,LI,47,7,6,2,0,15,8,9,1,0,18
2020,49011,Marciana Marina,LI,48,8,9,1,0,18,4,11,1,1,17
2020,49011,Marciana Marina,LI,49,10,5,4,0,19,5,9,0,0,14
2020,49011,Marciana Marina,LI,50,6,10,0,0,16,3,11,0,0,14
2020,49011,Marciana Marina,LI,51,4,9,2,0,15,3,14,0,2,19
2020,49011,Marciana Marina,LI,52,6,10,3,0,19,3,14,5,0,22
2020,49011,Marciana Marina,LI,53,11,15,1,0,27,1,13,3,0,17
2020,49011,Marciana Marina,LI,54,3,12,1,0,16,2,11,2,0,15
2020,49011,Marciana Marina,LI,55,2,9,2,0,13,3,16,2,1,22
2020,49011,Marciana Marina,LI,56,3,9,4,1,17,5,10,4,0,19
2020,49011,Marciana Marina,LI,57,3,14,1,0,18,1,12,3,0,16
2020,49011,Marciana Marina,LI,58,1,14,3,0,18,1,16,1,1,19
2020,49011,Marciana Marina,LI,59,1,11,0,0,12,2,7,1,1,11
2020,49011,Marciana Marina,LI,60,2,8,1,0,11,0,13,0,1,14
2020,49011,Marciana Marina,LI,61,0,10,0,1,11,1,12,4,1,18
2020,49011,Marciana Marina,LI,62,2,12,0,0,14,1,11,1,0,13
2020,49011,Marciana Marina,LI,63,0,13,0,0,13,3,17,2,0,22
2020,49011,Marciana Marina,LI,64,2,12,0,0,14,0,7,2,1,10
2020,49011,Marciana Marina,LI,65,0,17,2,0,19,1,10,1,3,15
2020,49011,Marciana Marina,LI,66,0,14,2,0,16,0,13,2,1,16
2020,49011,Marciana Marina,LI,67,0,8,1,1,10,0,6,1,1,8
2020,49011,Marciana Marina,LI,68,1,8,2,1,12,0,16,2,1,19
2020,49011,Marciana Marina,LI,69,3,13,0,0,16,1,4,0,5,10
2020,49011,Marciana Marina,LI,70,2,9,1,0,12,2,4,1,3,10
2020,49011,Marciana Marina,LI,71,1,7,0,0,8,1,3,0,3,7
2020,49011,Marciana Marina,LI,72,0,17,1,0,18,0,13,1,2,16
2020,49011,Marciana Marina,LI,73,3,15,1,0,19,1,7,0,5,13
2020,49011,Marciana Marina,LI,74,1,6,0,4,11,1,10,2,2,15
2020,49011,Marciana Marina,LI,75,0,5,0,0,5,0,8,1,3,12
2020,49011,Marciana Marina,LI,76,0,9,0,0,9,0,10,0,5,15
2020,49011,Marciana Marina,LI,77,0,8,0,2,10,1,5,1,2,9
2020,49011,Marciana Marina,LI,78,0,6,0,2,8,1,8,0,5,14
2020,49011,Marciana Marina,LI,79,0,9,0,2,11,0,7,0,5,12
2020,49011,Marciana Marina,LI,80,0,4,0,1,5,0,4,0,5,9
2020,49011,Marciana Marina,LI,81,0,9,0,0,9,0,3,0,5,8
2020,49011,Marciana Marina,LI,82,1,8,0,1,10,0,4,0,3,7
2020,49011,Marciana Marina,LI,83,0,6,0,1,7,0,3,0,3,6
2020,49011,Marciana Marina,LI,84,0,5,0,1,6,0,8,0,4,12
2020,49011,Marciana Marina,LI,85,0,7,0,1,8,2,1,1,14,18
2020,49011,Marciana Marina,LI,86,0,5,0,2,7,0,1,0,5,6
2020,49011,Marciana Marina,LI,87,2,3,0,2,7,1,1,0,7,9
2020,49011,Marciana Marina,LI,88,0,2,1,1,4,0,1,0,3,4
2020,49011,Marciana Marina,LI,89,0,1,0,1,2,0,1,0,6,7
2020,49011,Marciana Marina,LI,90,0,2,0,3,5,1,1,0,5,7
2020,49011,Marciana Marina,LI,91,0,0,0,0,0,0,0,0,2,2
2020,49011,Marciana Marina,LI,92,0,0,0,1,1,0,0,0,3,3
2020,49011,Marciana Marina,LI,93,0,2,0,2,4,0,0,0,1,1
2020,49011,Marciana Marina,LI,94,0,3,0,1,4,0,0,0,5,5
2020,49011,Marciana Marina,LI,95,0,0,0,0,0,0,0,0,2,2
2020,49011,Marciana Marina,LI,96,0,0,0,0,0,1,0,0,2,3
2020,49011,Marciana Marina,LI,97,0,0,0,1,1,0,0,0,2,2
2020,49011,Marciana Marina,LI,98,0,0,0,0,0,0,0,0,1,1
2020,49011,Marciana Marina,LI,99,0,0,0,0,0,0,0,0,0,0
2020,49011,Marciana Marina,LI,100 e più,0,0,0,0,0,0,0,0,2,2
2020,49012,Piombino,LI,0,74,0,0,0,74,66,0,0,0,66
2020,49012,Piombino,LI,1,85,0,0,0,85,76,0,0,0,76
2020,49012,Piombino,LI,2,92,0,0,0,92,90,0,0,0,90
2020,49012,Piombino,LI,3,103,0,0,0,103,85,0,0,0,85
2020,49012,Piombino,LI,4,104,0,0,0,104,102,0,0,0,102
2020,49012,Piombino,LI,5,107,0,0,0,107,88,0,0,0,88
2020,49012,Piombino,LI,6,98,0,0,0,98,96,0,0,0,96
2020,49012,Piombino,LI,7,109,0,0,0,109,116,0,0,0,116
2020,49012,Piombino,LI,8,104,0,0,0,104,135,0,0,0,135
2020,49012,Piombino,LI,9,130,0,0,0,130,126,0,0,0,126
2020,49012,Piombino,LI,10,136,0,0,0,136,114,0,0,0,114
2020,49012,Piombino,LI,11,118,0,0,0,118,128,0,0,0,128
2020,49012,Piombino,LI,12,144,0,0,0,144,137,0,0,0,137
2020,49012,Piombino,LI,13,156,0,0,0,156,130,0,0,0,130
2020,49012,Piombino,LI,14,163,0,0,0,163,143,0,0,0,143
2020,49012,Piombino,LI,15,132,0,0,0,132,123,0,0,0,123
2020,49012,Piombino,LI,16,170,0,0,0,170,122,0,0,0,122
2020,49012,Piombino,LI,17,130,0,0,0,130,135,0,0,0,135
2020,49012,Piombino,LI,18,158,0,0,0,158,139,0,0,0,139
2020,49012,Piombino,LI,19,143,0,0,0,143,148,0,0,0,148
2020,49012,Piombino,LI,20,127,0,0,0,127,161,2,0,0,163
2020,49012,Piombino,LI,21,163,0,0,0,163,124,3,0,0,127
2020,49012,Piombino,LI,22,164,1,0,0,165,150,5,0,0,155
2020,49012,Piombino,LI,23,164,2,0,0,166,124,7,0,0,132
2020,49012,Piombino,LI,24,142,0,0,0,142,105,11,0,0,116
2020,49012,Piombino,LI,25,147,2,0,0,149,107,10,0,0,117
2020,49012,Piombino,LI,26,135,8,0,0,143,110,18,0,0,128
2020,49012,Piombino,LI,27,132,6,1,0,139,107,29,0,0,137
2020,49012,Piombino,LI,28,156,16,0,0,172,93,28,1,0,122
2020,49012,Piombino,LI,29,98,21,2,0,121,96,22,0,0,118
2020,49012,Piombino,LI,30,142,20,0,0,162,94,29,0,0,123
2020,49012,Piombino,LI,31,102,17,0,0,119,70,46,1,0,117
2020,49012,Piombino,LI,32,101,33,1,0,135,84,62,3,0,149
2020,49012,Piombino,LI,33,92,29,1,0,124,66,63,2,1,133
2020,49012,Piombino,LI,34,77,53,1,0,131,69,63,1,0,133
2020,49012,Piombino,LI,35,105,53,0,0,158,79,62,7,1,149
2020,49012,Piombino,LI,36,81,41,3,0,127,72,60,5,1,139
2020,49012,Piombino,LI,37,85,54,2,0,141,45,78,5,0,129
2020,49012,Piombino,LI,38,89,70,4,0,163,72,70,5,1,148
2020,49012,Piombino,LI,39,76,70,2,0,149,58,78,4,1,141
2020,49012,Piombino,LI,40,84,81,4,1,170,58,84,4,1,147
2020,49012,Piombino,LI,41,92,99,6,0,197,64,127,10,1,202
2020,49012,Piombino,LI,42,98,99,3,0,201,82,110,18,1,212
2020,49012,Piombino,LI,43,93,113,10,0,217,62,132,9,4,208
2020,49012,Piombino,LI,44,104,116,16,2,238,63,107,17,0,187
2020,49012,Piombino,LI,45,92,131,19,1,243,68,155,14,5,243
2020,49012,Piombino,LI,46,101,126,15,2,244,64,157,24,5,250
2020,49012,Piombino,LI,47,104,141,27,0,272,72,200,29,3,305
2020,49012,Piombino,LI,48,82,153,22,2,259,50,182,23,4,260
2020,49012,Piombino,LI,49,98,157,15,3,273,50,180,32,7,269
2020,49012,Piombino,LI,50,87,152,28,0,267,53,172,17,1,243
2020,49012,Piombino,LI,51,74,171,26,2,273,27,206,34,9,276
2020,49012,Piombino,LI,52,81,162,22,2,268,41,191,35,5,274
2020,49012,Piombino,LI,53,64,178,27,0,269,31,179,44,6,260
2020,49012,Piombino,LI,54,61,191,33,3,288,33,205,41,9,288
2020,49012,Piombino,LI,55,54,207,31,2,294,33,211,41,8,293
2020,49012,Piombino,LI,56,39,199,34,2,274,40,191,36,7,275
2020,49012,Piombino,LI,57,40,211,31,1,283,38,174,48,15,276
2020,49012,Piombino,LI,58,36,179,21,2,238,24,214,26,13,277
2020,49012,Piombino,LI,59,16,186,27,3,233,16,200,42,22,280
2020,49012,Piombino,LI,60,30,171,21,2,224,13,165,25,21,224
2020,49012,Piombino,LI,61,22,156,21,3,202,16,186,34,24,260
2020,49012,Piombino,LI,62,27,145,20,7,199,15,153,35,23,226
2020,49012,Piombino,LI,63,16,191,23,3,233,14,171,30,26,241
2020,49012,Piombino,LI,64,14,151,16,4,185,17,173,33,28,251
2020,49012,Piombino,LI,65,16,174,22,5,217,6,188,26,29,249
2020,49012,Piombino,LI,66,12,148,17,11,188,14,171,20,23,228
2020,49012,Piombino,LI,67,12,146,19,8,185,9,149,22,28,208
2020,49012,Piombino,LI,68,12,178,17,9,216,7,155,16,21,199
2020,49012,Piombino,LI,69,10,157,9,5,181,8,140,14,42,204
2020,49012,Piombino,LI,70,8,183,15,11,217,7,153,19,41,220
2020,49012,Piombino,LI,71,8,170,15,15,208,6,180,13,46,245
2020,49012,Piombino,LI,72,3,174,12,11,200,4,174,23,59,260
2020,49012,Piombino,LI,73,11,183,12,18,225,5,177,14,74,270
2020,49012,Piombino,LI,74,8,219,8,22,257,8,174,14,76,273
2020,49012,Piombino,LI,75,10,152,9,14,185,4,128,18,71,221
2020,49012,Piombino,LI,76,7,141,4,13,165,8,125,8,67,208
2020,49012,Piombino,LI,77,6,135,5,13,159,3,132,11,63,209
2020,49012,Piombino,LI,78,11,129,7,15,162,6,123,9,102,240
2020,49012,Piombino,LI,79,9,130,5,22,166,4,129,4,121,258
2020,49012,Piombino,LI,80,9,143,3,23,178,6,129,6,142,283
2020,49012,Piombino,LI,81,4,161,0,21,186,2,98,3,132,235
2020,49012,Piombino,LI,82,6,152,4,22,184,4,93,8,126,231
2020,49012,Piombino,LI,83,6,123,4,18,151,6,69,4,115,194
2020,49012,Piombino,LI,84,5,92,2,21,120,2,41,3,121,167
2020,49012,Piombino,LI,85,2,67,3,20,92,3,50,2,120,175
2020,49012,Piombino,LI,86,3,59,0,22,84,2,31,0,106,139
2020,49012,Piombino,LI,87,3,57,2,18,80,3,19,3,99,124
2020,49012,Piombino,LI,88,1,51,1,22,75,6,15,1,113,135
2020,49012,Piombino,LI,89,2,24,1,18,45,4,15,1,91,111
2020,49012,Piombino,LI,90,1,31,0,20,52,3,7,1,97,108
2020,49012,Piombino,LI,91,3,41,0,14,58,3,7,0,66,76
2020,49012,Piombino,LI,92,1,16,0,12,29,2,3,2,50,57
2020,49012,Piombino,LI,93,0,10,0,6,16,4,0,0,47,51
2020,49012,Piombino,LI,94,0,8,0,7,15,0,3,0,40,43
2020,49012,Piombino,LI,95,2,2,0,4,8,2,0,0,32,34
2020,49012,Piombino,LI,96,0,2,0,5,7,1,0,0,19,20
2020,49012,Piombino,LI,97,0,1,0,6,7,2,1,0,18,21
2020,49012,Piombino,LI,98,0,2,0,1,3,0,0,0,13,13
2020,49012,Piombino,LI,99,0,1,0,3,4,0,0,0,7,7
2020,49012,Piombino,LI,100 e più,0,0,0,1,1,0,0,0,8,8
2020,49013,Porto Azzurro,LI,0,10,0,0,0,10,14,0,0,0,14
2020,49013,Porto Azzurro,LI,1,9,0,0,0,9,13,0,0,0,13
2020,49013,Porto Azzurro,LI,2,9,0,0,0,9,11,0,0,0,11
2020,49013,Porto Azzurro,LI,3,14,0,0,0,14,10,0,0,0,10
2020,49013,Porto Azzurro,LI,4,15,0,0,0,15,9,0,0,0,9
2020,49013,Porto Azzurro,LI,5,9,0,0,0,9,10,0,0,0,10
2020,49013,Porto Azzurro,LI,6,16,0,0,0,16,15,0,0,0,15
2020,49013,Porto Azzurro,LI,7,14,0,0,0,14,14,0,0,0,14
2020,49013,Porto Azzurro,LI,8,10,0,0,0,10,16,0,0,0,16
2020,49013,Porto Azzurro,LI,9,8,0,0,0,8,12,0,0,0,12
2020,49013,Porto Azzurro,LI,10,15,0,0,0,15,19,0,0,0,19
2020,49013,Porto Azzurro,LI,11,12,0,0,0,12,13,0,0,0,13
2020,49013,Porto Azzurro,LI,12,13,0,0,0,13,11,0,0,0,11
2020,49013,Porto Azzurro,LI,13,16,0,0,0,16,14,0,0,0,14
2020,49013,Porto Azzurro,LI,14,17,0,0,0,17,21,0,0,0,21
2020,49013,Porto Azzurro,LI,15,14,0,0,0,14,18,0,0,0,18
2020,49013,Porto Azzurro,LI,16,19,0,0,0,19,22,0,0,0,22
2020,49013,Porto Azzurro,LI,17,14,0,0,0,14,17,0,0,0,17
2020,49013,Porto Azzurro,LI,18,14,0,0,0,14,11,0,0,0,11
2020,49013,Porto Azzurro,LI,19,14,0,0,0,14,19,0,0,0,19
2020,49013,Porto Azzurro,LI,20,13,0,0,0,13,10,0,0,0,10
2020,49013,Porto Azzurro,LI,21,12,0,0,0,12,17,0,0,0,17
2020,49013,Porto Azzurro,LI,22,21,0,0,0,21,14,0,0,0,14
2020,49013,Porto Azzurro,LI,23,19,0,0,0,19,10,0,0,0,10
2020,49013,Porto Azzurro,LI,24,23,0,0,0,23,20,3,0,0,23
2020,49013,Porto Azzurro,LI,25,28,0,0,0,28,19,0,0,0,19
2020,49013,Porto Azzurro,LI,26,24,0,0,0,24,13,4,0,0,17
2020,49013,Porto Azzurro,LI,27,14,2,0,0,16,12,5,0,0,17
2020,49013,Porto Azzurro,LI,28,18,2,0,0,20,18,3,0,0,21
2020,49013,Porto Azzurro,LI,29,17,3,0,0,20,15,1,0,0,16
2020,49013,Porto Azzurro,LI,30,24,5,0,0,29,20,3,0,0,23
2020,49013,Porto Azzurro,LI,31,25,5,1,0,31,20,9,0,0,29
2020,49013,Porto Azzurro,LI,32,21,6,0,0,27,11,6,0,0,17
2020,49013,Porto Azzurro,LI,33,17,7,0,0,24,8,5,0,0,13
2020,49013,Porto Azzurro,LI,34,16,9,0,0,25,14,7,0,0,21
2020,49013,Porto Azzurro,LI,35,16,5,0,0,21,12,3,0,0,15
2020,49013,Porto Azzurro,LI,36,11,9,0,0,20,7,5,1,0,13
2020,49013,Porto Azzurro,LI,37,19,9,0,0,28,7,7,0,0,14
2020,49013,Porto Azzurro,LI,38,20,12,0,1,33,14,10,1,0,25
2020,49013,Porto Azzurro,LI,39,13,12,1,0,26,8,13,0,0,21
2020,49013,Porto Azzurro,LI,40,13,11,0,0,24,6,18,0,1,25
2020,49013,Porto Azzurro,LI,41,18,15,0,0,33,12,19,1,0,32
2020,49013,Porto Azzurro,LI,42,13,21,0,0,34,3,10,1,1,15
2020,49013,Porto Azzurro,LI,43,15,15,2,0,32,12,22,1,0,35
2020,49013,Porto Azzurro,LI,44,13,16,1,0,30,11,13,0,1,25
2020,49013,Porto Azzurro,LI,45,13,18,2,0,33,11,19,2,1,33
2020,49013,Porto Azzurro,LI,46,11,26,3,1,41,3,25,1,0,29
2020,49013,Porto Azzurro,LI,47,13,16,1,0,30,8,22,0,1,31
2020,49013,Porto Azzurro,LI,48,13,13,4,1,31,8,19,3,0,30
2020,49013,Porto Azzurro,LI,49,11,19,4,0,34,10,20,1,0,31
2020,49013,Porto Azzurro,LI,50,14,26,1,1,42,4,10,2,1,17
2020,49013,Porto Azzurro,LI,51,9,27,3,0,39,6,32,2,0,40
2020,49013,Porto Azzurro,LI,52,9,17,3,1,30,6,24,0,2,32
2020,49013,Porto Azzurro,LI,53,14,25,0,1,40,2,23,2,0,27
2020,49013,Porto Azzurro,LI,54,6,25,3,1,35,6,21,4,2,33
2020,49013,Porto Azzurro,LI,55,4,23,3,0,30,6,25,1,0,32
2020,49013,Porto Azzurro,LI,56,11,36,7,0,54,7,25,4,0,36
2020,49013,Porto Azzurro,LI,57,5,34,3,0,42,4,28,2,2,36
2020,49013,Porto Azzurro,LI,58,10,28,1,1,40,2,20,2,2,26
2020,49013,Porto Azzurro,LI,59,10,19,3,1,33,4,20,2,1,27
2020,49013,Porto Azzurro,LI,60,5,23,3,1,32,3,24,4,4,35
2020,49013,Porto Azzurro,LI,61,4,24,2,3,33,3,15,4,2,24
2020,49013,Porto Azzurro,LI,62,6,29,3,0,38,3,14,7,0,24
2020,49013,Porto Azzurro,LI,63,1,16,4,1,22,2,18,3,2,25
2020,49013,Porto Azzurro,LI,64,4,19,1,0,24,2,20,2,3,27
2020,49013,Porto Azzurro,LI,65,4,17,1,0,22,1,9,4,1,15
2020,49013,Porto Azzurro,LI,66,1,11,1,1,14,0,13,2,4,19
2020,49013,Porto Azzurro,LI,67,5,17,0,1,23,0,15,2,4,21
2020,49013,Porto Azzurro,LI,68,2,13,1,2,18,0,15,0,4,19
2020,49013,Porto Azzurro,LI,69,1,19,3,1,24,0,13,1,6,20
2020,49013,Porto Azzurro,LI,70,1,15,1,2,19,0,13,1,3,17
2020,49013,Porto Azzurro,LI,71,0,15,0,3,18,0,9,0,3,12
2020,49013,Porto Azzurro,LI,72,1,8,1,1,11,0,10,0,6,16
2020,49013,Porto Azzurro,LI,73,6,15,1,0,22,1,9,1,9,20
2020,49013,Porto Azzurro,LI,74,1,18,0,1,20,0,14,0,4,18
2020,49013,Porto Azzurro,LI,75,0,17,0,0,17,1,14,0,5,20
2020,49013,Porto Azzurro,LI,76,2,9,0,0,11,0,11,0,5,16
2020,49013,Porto Azzurro,LI,77,2,14,2,0,18,1,8,0,1,10
2020,49013,Porto Azzurro,LI,78,2,16,1,1,20,0,7,0,10,17
2020,49013,Porto Azzurro,LI,79,2,11,0,2,15,0,5,1,9,15
2020,49013,Porto Azzurro,LI,80,1,10,0,1,12,2,10,0,6,18
2020,49013,Porto Azzurro,LI,81,0,3,0,2,5,2,9,1,9,21
2020,49013,Porto Azzurro,LI,82,0,5,1,6,12,2,5,0,9,16
2020,49013,Porto Azzurro,LI,83,0,14,0,2,16,1,3,0,5,9
2020,49013,Porto Azzurro,LI,84,1,5,0,2,8,1,2,0,3,6
2020,49013,Porto Azzurro,LI,85,0,4,0,1,5,0,2,0,5,7
2020,49013,Porto Azzurro,LI,86,0,9,0,0,9,0,1,1,9,11
2020,49013,Porto Azzurro,LI,87,0,5,0,2,7,1,1,1,8,11
2020,49013,Porto Azzurro,LI,88,1,3,0,1,5,0,1,0,0,1
2020,49013,Porto Azzurro,LI,89,0,4,0,1,5,0,2,0,2,4
2020,49013,Porto Azzurro,LI,90,0,2,0,0,2,0,1,0,6,7
2020,49013,Porto Azzurro,LI,91,1,3,0,1,5,0,2,0,1,3
2020,49013,Porto Azzurro,LI,92,1,1,0,0,2,0,1,0,3,4
2020,49013,Porto Azzurro,LI,93,0,0,0,0,0,0,0,0,2,2
2020,49013,Porto Azzurro,LI,94,0,1,0,0,1,0,1,0,1,2
2020,49013,Porto Azzurro,LI,95,0,1,0,0,1,0,0,0,5,5
2020,49013,Porto Azzurro,LI,96,0,0,0,0,0,0,0,0,1,1
2020,49013,Porto Azzurro,LI,97,0,0,0,0,0,0,1,0,2,3
2020,49013,Porto Azzurro,LI,98,0,0,0,0,0,0,0,0,1,1
2020,49013,Porto Azzurro,LI,99,0,1,0,0,1,0,0,0,0,0
2020,49013,Porto Azzurro,LI,100 e più,0,0,0,0,0,0,0,0,0,0
2020,49014,Portoferraio,LI,0,46,0,0,0,46,32,0,0,0,32
2020,49014,Portoferraio,LI,1,33,0,0,0,33,48,0,0,0,48
2020,49014,Portoferraio,LI,2,55,0,0,0,55,43,0,0,0,43
2020,49014,Portoferraio,LI,3,45,0,0,0,45,38,0,0,0,38
2020,49014,Portoferraio,LI,4,44,0,0,0,44,36,0,0,0,36
2020,49014,Portoferraio,LI,5,54,0,0,0,54,40,0,0,0,40
2020,49014,Portoferraio,LI,6,42,0,0,0,42,37,0,0,0,37
2020,49014,Portoferraio,LI,7,50,0,0,0,50,43,0,0,0,43
2020,49014,Portoferraio,LI,8,47,0,0,0,47,49,0,0,0,49
2020,49014,Portoferraio,LI,9,50,0,0,0,50,45,0,0,0,45
2020,49014,Portoferraio,LI,10,47,0,0,0,47,37,0,0,0,37
2020,49014,Portoferraio,LI,11,52,0,0,0,52,49,0,0,0,49
2020,49014,Portoferraio,LI,12,52,0,0,0,52,61,0,0,0,61
2020,49014,Portoferraio,LI,13,50,0,0,0,50,58,0,0,0,58
2020,49014,Portoferraio,LI,14,49,0,0,0,49,51,0,0,0,51
2020,49014,Portoferraio,LI,15,68,0,0,0,68,44,0,0,0,44
2020,49014,Portoferraio,LI,16,65,0,0,0,65,52,0,0,0,52
2020,49014,Portoferraio,LI,17,43,0,0,0,43,45,0,0,0,45
2020,49014,Portoferraio,LI,18,59,0,0,0,59,38,0,0,0,38
2020,49014,Portoferraio,LI,19,51,0,0,0,51,56,0,0,0,56
2020,49014,Portoferraio,LI,20,63,0,0,0,63,47,1,0,0,48
2020,49014,Portoferraio,LI,21,50,0,0,0,50,45,0,0,0,45
2020,49014,Portoferraio,LI,22,45,0,0,0,45,53,1,0,0,54
2020,49014,Portoferraio,LI,23,54,1,0,0,55,59,2,0,0,61
2020,49014,Portoferraio,LI,24,49,1,0,0,50,56,4,0,0,60
2020,49014,Portoferraio,LI,25,61,1,0,0,62,43,6,0,0,49
2020,49014,Portoferraio,LI,26,58,4,0,0,62,48,2,0,0,50
2020,49014,Portoferraio,LI,27,55,1,0,0,56,45,5,0,0,50
2020,49014,Portoferraio,LI,28,63,4,0,0,67,50,9,0,0,59
2020,49014,Portoferraio,LI,29,58,4,0,0,62,42,18,0,0,60
2020,49014,Portoferraio,LI,30,57,6,1,0,64,48,19,0,0,67
2020,49014,Portoferraio,LI,31,38,10,0,0,48,48,19,1,0,68
2020,49014,Portoferraio,LI,32,53,15,0,0,68,51,20,3,0,74
2020,49014,Portoferraio,LI,33,50,14,0,0,64,48,24,0,0,72
2020,49014,Portoferraio,LI,34,34,14,0,0,48,27,16,1,0,44
2020,49014,Portoferraio,LI,35,39,15,3,0,57,34,30,0,0,64
2020,49014,Portoferraio,LI,36,53,20,3,0,76,31,30,0,0,61
2020,49014,Portoferraio,LI,37,50,23,0,0,73,39,38,3,1,81
2020,49014,Portoferraio,LI,38,34,19,0,0,53,30,40,7,0,77
2020,49014,Portoferraio,LI,39,30,20,1,0,51,23,22,6,0,51
2020,49014,Portoferraio,LI,40,36,34,2,0,72,26,26,3,1,56
2020,49014,Portoferraio,LI,41,36,40,5,0,81,27,36,4,0,67
2020,49014,Portoferraio,LI,42,39,28,6,0,73,35,47,10,0,92
2020,49014,Portoferraio,LI,43,40,33,2,0,75,36,35,4,1,76
2020,49014,Portoferraio,LI,44,39,35,7,1,82,30,42,8,0,80
2020,49014,Portoferraio,LI,45,37,36,6,0,79,31,54,8,1,94
2020,49014,Portoferraio,LI,46,46,38,7,1,92,29,49,13,1,92
2020,49014,Portoferraio,LI,47,36,55,4,0,95,34,56,11,1,102
2020,49014,Portoferraio,LI,48,34,48,9,1,92,29,71,6,0,106
2020,49014,Portoferraio,LI,49,31,57,8,1,97,24,58,15,1,98
2020,49014,Portoferraio,LI,50,37,47,6,0,90,21,65,21,0,107
2020,49014,Portoferraio,LI,51,33,56,10,0,99,13,71,17,4,105
2020,49014,Portoferraio,LI,52,40,69,10,3,122,30,62,14,3,109
2020,49014,Portoferraio,LI,53,30,71,14,0,115,20,65,10,6,101
2020,49014,Portoferraio,LI,54,24,70,22,1,117,21,91,18,5,135
2020,49014,Portoferraio,LI,55,20,65,10,2,97,20,57,18,4,99
2020,49014,Portoferraio,LI,56,21,78,13,1,113,18,92,16,2,128
2020,49014,Portoferraio,LI,57,18,80,17,0,115,10,77,21,5,113
2020,49014,Portoferraio,LI,58,11,63,8,0,82,13,71,15,4,103
2020,49014,Portoferraio,LI,59,11,56,12,0,79,11,64,15,7,97
2020,49014,Portoferraio,LI,60,6,59,8,0,73,10,67,12,6,95
2020,49014,Portoferraio,LI,61,12,63,11,5,91,14,59,7,16,96
2020,49014,Portoferraio,LI,62,10,51,7,2,70,4,49,15,7,75
2020,49014,Portoferraio,LI,63,5,54,6,3,68,3,59,12,7,81
2020,49014,Portoferraio,LI,64,7,64,5,0,76,3,57,7,15,82
2020,49014,Portoferraio,LI,65,4,50,8,3,65,8,59,15,9,91
2020,49014,Portoferraio,LI,66,3,62,7,1,73,5,48,3,12,68
2020,49014,Portoferraio,LI,67,9,66,11,2,88,8,55,7,8,78
2020,49014,Portoferraio,LI,68,5,67,6,1,79,1,59,4,11,75
2020,49014,Portoferraio,LI,69,4,48,7,3,62,11,46,2,8,67
2020,49014,Portoferraio,LI,70,1,37,2,0,40,2,53,6,14,75
2020,49014,Portoferraio,LI,71,2,55,4,2,63,6,45,2,17,70
2020,49014,Portoferraio,LI,72,4,53,4,5,66,4,40,8,16,68
2020,49014,Portoferraio,LI,73,6,54,5,7,72,4,52,4,15,75
2020,49014,Portoferraio,LI,74,3,65,4,4,76,5,53,8,20,86
2020,49014,Portoferraio,LI,75,4,41,10,1,56,6,34,2,16,58
2020,49014,Portoferraio,LI,76,6,34,4,7,51,2,32,6,25,65
2020,49014,Portoferraio,LI,77,0,49,3,7,59,6,34,6,32,78
2020,49014,Portoferraio,LI,78,2,55,1,7,65,3,29,3,25,60
2020,49014,Portoferraio,LI,79,2,39,2,7,50,2,37,1,29,69
2020,49014,Portoferraio,LI,80,7,42,1,9,59,2,18,3,28,51
2020,49014,Portoferraio,LI,81,3,32,0,7,42,1,29,4,30,64
2020,49014,Portoferraio,LI,82,3,46,0,10,59,2,29,2,32,65
2020,49014,Portoferraio,LI,83,4,25,2,6,37,0,16,2,32,50
2020,49014,Portoferraio,LI,84,2,24,1,9,36,1,15,0,28,44
2020,49014,Portoferraio,LI,85,2,13,1,9,25,1,8,1,23,33
2020,49014,Portoferraio,LI,86,0,20,0,5,25,3,5,1,28,37
2020,49014,Portoferraio,LI,87,1,13,0,4,18,3,7,2,41,53
2020,49014,Portoferraio,LI,88,0,18,0,3,21,1,5,0,28,34
2020,49014,Portoferraio,LI,89,0,9,1,3,13,3,1,1,25,30
2020,49014,Portoferraio,LI,90,0,3,0,2,5,1,1,0,24,26
2020,49014,Portoferraio,LI,91,0,7,0,3,10,2,1,0,20,23
2020,49014,Portoferraio,LI,92,0,4,0,6,10,4,1,0,14,19
2020,49014,Portoferraio,LI,93,0,4,0,1,5,0,1,0,10,11
2020,49014,Portoferraio,LI,94,2,4,0,0,6,1,0,0,12,13
2020,49014,Portoferraio,LI,95,0,1,0,3,4,1,1,0,4,6
2020,49014,Portoferraio,LI,96,0,1,0,0,1,0,0,0,6,6
2020,49014,Portoferraio,LI,97,1,0,0,1,2,0,0,0,7,7
2020,49014,Portoferraio,LI,98,0,0,0,1,1,0,0,0,1,1
2020,49014,Portoferraio,LI,99,0,0,0,1,1,0,0,0,3,3
2020,49014,Portoferraio,LI,100 e più,0,0,0,0,0,0,0,0,3,3
2020,49017,Rosignano Marittimo,LI,0,66,0,0,0,66,77,0,0,0,77
2020,49017,Rosignano Marittimo,LI,1,93,0,0,0,93,79,0,0,0,79
2020,49017,Rosignano Marittimo,LI,2,75,0,0,0,75,80,0,0,0,80
2020,49017,Rosignano Marittimo,LI,3,96,0,0,0,96,107,0,0,0,107
2020,49017,Rosignano Marittimo,LI,4,104,0,0,0,104,75,0,0,0,75
2020,49017,Rosignano Marittimo,LI,5,102,0,0,0,102,114,0,0,0,114
2020,49017,Rosignano Marittimo,LI,6,109,0,0,0,109,112,0,0,0,112
2020,49017,Rosignano Marittimo,LI,7,105,0,0,0,105,95,0,0,0,95
2020,49017,Rosignano Marittimo,LI,8,118,0,0,0,118,117,0,0,0,117
2020,49017,Rosignano Marittimo,LI,9,139,0,0,0,139,130,0,0,0,130
2020,49017,Rosignano Marittimo,LI,10,127,0,0,0,127,109,0,0,0,109
2020,49017,Rosignano Marittimo,LI,11,127,0,0,0,127,137,0,0,0,137
2020,49017,Rosignano Marittimo,LI,12,135,0,0,0,135,143,0,0,0,143
2020,49017,Rosignano Marittimo,LI,13,119,0,0,0,119,127,0,0,0,127
2020,49017,Rosignano Marittimo,LI,14,128,0,0,0,128,111,0,0,0,111
2020,49017,Rosignano Marittimo,LI,15,138,0,0,0,138,115,0,0,0,115
2020,49017,Rosignano Marittimo,LI,16,132,0,0,0,132,134,0,0,0,134
2020,49017,Rosignano Marittimo,LI,17,123,0,0,0,123,127,0,0,0,127
2020,49017,Rosignano Marittimo,LI,18,113,0,0,0,113,120,0,0,0,120
2020,49017,Rosignano Marittimo,LI,19,116,0,0,0,116,106,0,0,0,106
2020,49017,Rosignano Marittimo,LI,20,113,0,0,0,113,118,2,0,0,120
2020,49017,Rosignano Marittimo,LI,21,128,0,0,0,128,121,0,0,0,121
2020,49017,Rosignano Marittimo,LI,22,120,0,0,0,120,106,2,0,0,108
2020,49017,Rosignano Marittimo,LI,23,125,1,0,0,126,137,3,0,0,140
2020,49017,Rosignano Marittimo,LI,24,119,1,0,0,120,110,10,0,0,120
2020,49017,Rosignano Marittimo,LI,25,126,2,0,0,128,123,8,0,0,131
2020,49017,Rosignano Marittimo,LI,26,131,2,0,0,133,100,7,0,0,107
2020,49017,Rosignano Marittimo,LI,27,123,5,0,0,128,111,10,0,0,121
2020,49017,Rosignano Marittimo,LI,28,132,9,0,0,141,85,26,2,0,113
2020,49017,Rosignano Marittimo,LI,29,119,7,0,0,126,106,27,1,0,134
2020,49017,Rosignano Marittimo,LI,30,115,21,0,0,136,101,44,0,0,145
2020,49017,Rosignano Marittimo,LI,31,118,23,0,0,141,85,38,0,0,123
2020,49017,Rosignano Marittimo,LI,32,108,23,0,0,132,82,46,1,0,129
2020,49017,Rosignano Marittimo,LI,33,90,34,0,0,124,80,56,1,2,139
2020,49017,Rosignano Marittimo,LI,34,89,29,1,0,119,62,47,3,0,112
2020,49017,Rosignano Marittimo,LI,35,102,46,1,0,149,76,54,3,0,133
2020,49017,Rosignano Marittimo,LI,36,70,58,3,0,132,62,77,4,1,144
2020,49017,Rosignano Marittimo,LI,37,73,61,3,0,137,55,79,3,0,137
2020,49017,Rosignano Marittimo,LI,38,95,79,1,0,175,68,88,7,0,163
2020,49017,Rosignano Marittimo,LI,39,96,66,4,0,166,49,101,3,0,153
2020,49017,Rosignano Marittimo,LI,40,94,69,5,0,170,62,96,11,1,170
2020,49017,Rosignano Marittimo,LI,41,93,82,3,0,180,61,105,14,0,180
2020,49017,Rosignano Marittimo,LI,42,101,97,4,0,203,82,121,13,1,217
2020,49017,Rosignano Marittimo,LI,43,90,92,5,0,187,64,131,12,0,208
2020,49017,Rosignano Marittimo,LI,44,73,119,11,0,203,76,125,15,2,218
2020,49017,Rosignano Marittimo,LI,45,76,142,12,0,230,65,134,18,0,217
2020,49017,Rosignano Marittimo,LI,46,79,139,10,1,229,72,148,18,2,240
2020,49017,Rosignano Marittimo,LI,47,87,156,11,3,257,55,173,23,5,256
2020,49017,Rosignano Marittimo,LI,48,74,148,12,1,235,60,175,27,2,264
2020,49017,Rosignano Marittimo,LI,49,63,151,19,1,234,54,163,34,2,253
2020,49017,Rosignano Marittimo,LI,50,68,140,24,2,235,43,152,31,5,231
2020,49017,Rosignano Marittimo,LI,51,61,170,22,1,254,48,181,15,6,250
2020,49017,Rosignano Marittimo,LI,52,61,162,18,0,241,47,203,37,6,293
2020,49017,Rosignano Marittimo,LI,53,51,171,28,1,251,39,195,29,9,272
2020,49017,Rosignano Marittimo,LI,54,48,187,26,3,265,39,192,42,7,280
2020,49017,Rosignano Marittimo,LI,55,50,183,31,2,266,34,199,47,13,294
2020,49017,Rosignano Marittimo,LI,56,41,203,31,6,282,25,223,35,9,292
2020,49017,Rosignano Marittimo,LI,57,26,176,31,8,241,24,190,30,8,252
2020,49017,Rosignano Marittimo,LI,58,38,174,24,6,242,25,161,26,13,225
2020,49017,Rosignano Marittimo,LI,59,22,186,31,1,241,29,180,18,19,246
2020,49017,Rosignano Marittimo,LI,60,29,154,32,3,220,20,173,21,18,233
2020,49017,Rosignano Marittimo,LI,61,23,152,17,10,202,20,160,27,20,227
2020,49017,Rosignano Marittimo,LI,62,14,156,14,5,190,17,155,23,18,213
2020,49017,Rosignano Marittimo,LI,63,21,152,19,4,196,17,158,18,23,216
2020,49017,Rosignano Marittimo,LI,64,15,187,8,6,216,18,159,18,18,213
2020,49017,Rosignano Marittimo,LI,65,22,159,21,5,207,12,148,17,28,206
2020,49017,Rosignano Marittimo,LI,66,12,159,7,9,187,9,156,21,18,205
2020,49017,Rosignano Marittimo,LI,67,10,134,4,9,157,5,136,18,35,195
2020,49017,Rosignano Marittimo,LI,68,7,140,15,6,168,9,142,13,26,190
2020,49017,Rosignano Marittimo,LI,69,10,143,11,7,171,10,159,13,28,210
2020,49017,Rosignano Marittimo,LI,70,12,146,10,8,176,11,145,11,31,198
2020,49017,Rosignano Marittimo,LI,71,16,168,9,10,203,8,154,6,37,205
2020,49017,Rosignano Marittimo,LI,72,10,174,11,13,208,6,200,19,44,269
2020,49017,Rosignano Marittimo,LI,73,8,182,7,14,211,2,162,9,55,228
2020,49017,Rosignano Marittimo,LI,74,11,159,7,16,193,7,162,12,64,245
2020,49017,Rosignano Marittimo,LI,75,6,158,10,15,189,9,106,13,68,196
2020,49017,Rosignano Marittimo,LI,76,10,138,7,12,167,2,118,5,65,190
2020,49017,Rosignano Marittimo,LI,77,6,138,3,21,168,4,122,6,46,178
2020,49017,Rosignano Marittimo,LI,78,4,121,7,19,151,5,87,3,66,161
2020,49017,Rosignano Marittimo,LI,79,4,115,5,21,145,10,93,5,64,172
2020,49017,Rosignano Marittimo,LI,80,9,130,2,18,159,6,90,3,79,178
2020,49017,Rosignano Marittimo,LI,81,6,124,2,28,160,8,81,9,90,188
2020,49017,Rosignano Marittimo,LI,82,11,96,5,27,139,4,71,2,103,180
2020,49017,Rosignano Marittimo,LI,83,4,101,2,24,131,4,57,3,86,150
2020,49017,Rosignano Marittimo,LI,84,4,70,1,23,98,5,48,0,88,141
2020,49017,Rosignano Marittimo,LI,85,5,67,0,21,93,3,40,1,100,144
2020,49017,Rosignano Marittimo,LI,86,3,59,4,15,81,4,26,2,96,128
2020,49017,Rosignano Marittimo,LI,87,3,51,0,19,73,5,21,1,76,103
2020,49017,Rosignano Marittimo,LI,88,2,26,0,23,51,3,18,0,84,105
2020,49017,Rosignano Marittimo,LI,89,4,34,0,12,50,5,14,1,83,103
2020,49017,Rosignano Marittimo,LI,90,0,23,1,15,39,5,6,1,72,84
2020,49017,Rosignano Marittimo,LI,91,1,17,0,8,26,4,6,0,65,75
2020,49017,Rosignano Marittimo,LI,92,1,10,1,11,23,1,5,0,48,54
2020,49017,Rosignano Marittimo,LI,93,1,6,0,7,14,1,1,0,42,44
2020,49017,Rosignano Marittimo,LI,94,1,6,0,11,18,2,1,1,36,40
2020,49017,Rosignano Marittimo,LI,95,0,7,0,6,13,2,0,0,33,35
2020,49017,Rosignano Marittimo,LI,96,1,3,0,7,11,1,1,0,25,27
2020,49017,Rosignano Marittimo,LI,97,1,1,0,3,5,2,0,1,15,18
2020,49017,Rosignano Marittimo,LI,98,0,0,0,1,1,0,0,0,10,10
2020,49017,Rosignano Marittimo,LI,99,0,0,0,2,2,0,0,0,7,7
2020,49017,Rosignano Marittimo,LI,100 e più,0,0,0,2,2,1,0,0,8,9
2020,49018,San Vincenzo,LI,0,25,0,0,0,25,13,0,0,0,13
2020,49018,San Vincenzo,LI,1,12,0,0,0,12,16,0,0,0,16
2020,49018,San Vincenzo,LI,2,17,0,0,0,17,26,0,0,0,26
2020,49018,San Vincenzo,LI,3,22,0,0,0,22,17,0,0,0,17
2020,49018,San Vincenzo,LI,4,13,0,0,0,13,26,0,0,0,26
2020,49018,San Vincenzo,LI,5,14,0,0,0,14,20,0,0,0,20
2020,49018,San Vincenzo,LI,6,15,0,0,0,15,24,0,0,0,24
2020,49018,San Vincenzo,LI,7,20,0,0,0,20,22,0,0,0,22
2020,49018,San Vincenzo,LI,8,33,0,0,0,33,32,0,0,0,32
2020,49018,San Vincenzo,LI,9,24,0,0,0,24,35,0,0,0,35
2020,49018,San Vincenzo,LI,10,31,0,0,0,31,25,0,0,0,25
2020,49018,San Vincenzo,LI,11,26,0,0,0,26,35,0,0,0,35
2020,49018,San Vincenzo,LI,12,19,0,0,0,19,27,0,0,0,27
2020,49018,San Vincenzo,LI,13,29,0,0,0,29,23,0,0,0,23
2020,49018,San Vincenzo,LI,14,28,0,0,0,28,23,0,0,0,23
2020,49018,San Vincenzo,LI,15,22,0,0,0,22,18,0,0,0,18
2020,49018,San Vincenzo,LI,16,18,0,0,0,18,21,0,0,0,21
2020,49018,San Vincenzo,LI,17,26,0,0,0,26,28,0,0,0,28
2020,49018,San Vincenzo,LI,18,26,0,0,0,26,19,0,0,0,19
2020,49018,San Vincenzo,LI,19,29,0,0,0,29,26,0,0,0,26
2020,49018,San Vincenzo,LI,20,29,0,0,0,29,12,0,0,0,12
2020,49018,San Vincenzo,LI,21,32,0,0,0,32,31,0,0,0,31
2020,49018,San Vincenzo,LI,22,28,0,0,0,28,28,2,0,0,30
2020,49018,San Vincenzo,LI,23,20,0,0,0,20,21,0,0,0,21
2020,49018,San Vincenzo,LI,24,27,0,0,0,27,30,1,0,0,31
2020,49018,San Vincenzo,LI,25,10,0,0,0,10,27,2,0,0,29
2020,49018,San Vincenzo,LI,26,25,0,0,0,25,21,2,0,0,23
2020,49018,San Vincenzo,LI,27,28,0,0,0,28,21,2,0,0,23
2020,49018,San Vincenzo,LI,28,25,2,0,0,27,22,1,0,0,23
2020,49018,San Vincenzo,LI,29,28,0,0,0,28,17,4,0,0,21
2020,49018,San Vincenzo,LI,30,26,2,0,0,28,23,9,1,0,33
2020,49018,San Vincenzo,LI,31,13,1,0,0,14,16,6,1,0,23
2020,49018,San Vincenzo,LI,32,27,7,0,0,34,8,10,0,0,18
2020,49018,San Vincenzo,LI,33,20,6,0,0,26,19,7,0,1,27
2020,49018,San Vincenzo,LI,34,19,7,1,0,27,19,13,0,0,32
2020,49018,San Vincenzo,LI,35,9,6,0,0,15,11,16,0,0,27
2020,49018,San Vincenzo,LI,36,17,12,0,0,29,19,7,0,0,26
2020,49018,San Vincenzo,LI,37,15,9,0,0,24,15,14,2,0,31
2020,49018,San Vincenzo,LI,38,14,11,0,0,25,13,21,0,0,34
2020,49018,San Vincenzo,LI,39,19,9,0,0,28,16,21,3,0,40
2020,49018,San Vincenzo,LI,40,19,17,2,0,38,18,15,3,0,36
2020,49018,San Vincenzo,LI,41,21,23,2,0,46,13,23,3,0,39
2020,49018,San Vincenzo,LI,42,22,30,0,0,52,22,23,2,1,48
2020,49018,San Vincenzo,LI,43,12,27,1,0,40,14,32,0,0,46
2020,49018,San Vincenzo,LI,44,19,18,0,0,37,13,32,6,0,51
2020,49018,San Vincenzo,LI,45,17,25,2,0,44,10,37,8,0,55
2020,49018,San Vincenzo,LI,46,24,23,2,0,49,12,27,2,1,42
2020,49018,San Vincenzo,LI,47,16,29,7,0,52,13,37,3,0,53
2020,49018,San Vincenzo,LI,48,15,28,4,0,47,19,33,5,0,57
2020,49018,San Vincenzo,LI,49,13,42,2,0,57,13,34,5,1,53
2020,49018,San Vincenzo,LI,50,12,37,8,0,57,12,34,6,0,52
2020,49018,San Vincenzo,LI,51,14,41,6,0,61,7,40,5,2,54
2020,49018,San Vincenzo,LI,52,12,31,2,0,45,5,33,3,2,43
2020,49018,San Vincenzo,LI,53,14,38,4,1,57,9,34,7,2,52
2020,49018,San Vincenzo,LI,54,10,36,11,1,58,10,45,10,0,65
2020,49018,San Vincenzo,LI,55,7,40,8,2,57,8,39,8,4,59
2020,49018,San Vincenzo,LI,56,11,52,6,2,71,12,46,13,4,75
2020,49018,San Vincenzo,LI,57,10,31,9,1,51,2,41,7,4,54
2020,49018,San Vincenzo,LI,58,8,27,7,1,43,7,38,9,2,56
2020,49018,San Vincenzo,LI,59,4,36,6,0,46,2,36,3,4,45
2020,49018,San Vincenzo,LI,60,4,40,4,0,48,3,29,3,3,38
2020,49018,San Vincenzo,LI,61,6,31,3,1,41,4,31,9,5,49
2020,49018,San Vincenzo,LI,62,2,31,3,1,37,4,40,4,3,51
2020,49018,San Vincenzo,LI,63,5,33,9,1,48,3,34,5,4,46
2020,49018,San Vincenzo,LI,64,7,34,2,2,45,3,45,3,3,54
2020,49018,San Vincenzo,LI,65,4,33,2,1,40,0,36,2,8,46
2020,49018,San Vincenzo,LI,66,5,42,2,0,49,2,40,3,10,55
2020,49018,San Vincenzo,LI,67,2,39,4,0,45,1,33,5,4,43
2020,49018,San Vincenzo,LI,68,2,38,1,2,43,3,46,0,7,56
2020,49018,San Vincenzo,LI,69,5,37,2,1,45,1,31,4,11,47
2020,49018,San Vincenzo,LI,70,1,36,4,4,45,3,31,4,8,46
2020,49018,San Vincenzo,LI,71,5,34,2,1,42,1,37,4,7,49
2020,49018,San Vincenzo,LI,72,3,44,3,2,52,0,45,3,9,57
2020,49018,San Vincenzo,LI,73,4,38,1,3,46,0,31,0,20,51
2020,49018,San Vincenzo,LI,74,0,35,1,4,40,2,47,1,18,68
2020,49018,San Vincenzo,LI,75,1,31,0,2,34,2,29,2,19,52
2020,49018,San Vincenzo,LI,76,0,35,3,4,42,1,25,1,18,45
2020,49018,San Vincenzo,LI,77,1,28,2,3,34,1,25,0,21,47
2020,49018,San Vincenzo,LI,78,1,22,3,5,31,0,34,2,16,52
2020,49018,San Vincenzo,LI,79,1,24,1,0,26,2,22,1,16,41
2020,49018,San Vincenzo,LI,80,1,28,0,2,31,0,24,3,12,39
2020,49018,San Vincenzo,LI,81,2,35,1,4,42,1,21,1,22,45
2020,49018,San Vincenzo,LI,82,2,32,3,3,40,1,20,2,22,45
2020,49018,San Vincenzo,LI,83,1,19,2,5,27,0,18,2,22,42
2020,49018,San Vincenzo,LI,84,0,24,0,5,29,2,16,0,24,42
2020,49018,San Vincenzo,LI,85,0,24,2,8,34,1,10,1,40,52
2020,49018,San Vincenzo,LI,86,3,11,0,2,16,0,1,0,20,21
2020,49018,San Vincenzo,LI,87,1,16,0,7,24,3,1,0,26,30
2020,49018,San Vincenzo,LI,88,0,11,1,4,16,0,0,0,26,26
2020,49018,San Vincenzo,LI,89,0,7,0,2,9,1,2,0,17,20
2020,49018,San Vincenzo,LI,90,0,6,0,6,12,1,2,0,17,20
2020,49018,San Vincenzo,LI,91,0,1,0,1,2,1,1,0,13,15
2020,49018,San Vincenzo,LI,92,0,2,0,1,3,1,1,0,12,14
2020,49018,San Vincenzo,LI,93,1,0,0,1,2,1,0,0,14,15
2020,49018,San Vincenzo,LI,94,0,2,0,5,7,0,0,0,5,5
2020,49018,San Vincenzo,LI,95,0,0,0,1,1,0,0,0,6,6
2020,49018,San Vincenzo,LI,96,0,0,0,0,0,0,2,0,2,4
2020,49018,San Vincenzo,LI,97,0,0,0,0,0,0,0,0,0,0
2020,49018,San Vincenzo,LI,98,0,0,0,1,1,0,0,0,2,2
2020,49018,San Vincenzo,LI,99,0,0,0,0,0,0,0,0,0,0
2020,49018,San Vincenzo,LI,100 e più,0,0,0,1,1,0,0,0,0,0
2020,49019,Sassetta,LI,0,3,0,0,0,3,0,0,0,0,0
2020,49019,Sassetta,LI,1,1,0,0,0,1,1,0,0,0,1
2020,49019,Sassetta,LI,2,2,0,0,0,2,1,0,0,0,1
2020,49019,Sassetta,LI,3,1,0,0,0,1,2,0,0,0,2
2020,49019,Sassetta,LI,4,1,0,0,0,1,3,0,0,0,3
2020,49019,Sassetta,LI,5,5,0,0,0,5,0,0,0,0,0
2020,49019,Sassetta,LI,6,1,0,0,0,1,1,0,0,0,1
2020,49019,Sassetta,LI,7,0,0,0,0,0,2,0,0,0,2
2020,49019,Sassetta,LI,8,1,0,0,0,1,1,0,0,0,1
2020,49019,Sassetta,LI,9,4,0,0,0,4,3,0,0,0,3
2020,49019,Sassetta,LI,10,1,0,0,0,1,2,0,0,0,2
2020,49019,Sassetta,LI,11,1,0,0,0,1,4,0,0,0,4
2020,49019,Sassetta,LI,12,3,0,0,0,3,3,0,0,0,3
2020,49019,Sassetta,LI,13,1,0,0,0,1,2,0,0,0,2
2020,49019,Sassetta,LI,14,0,0,0,0,0,2,0,0,0,2
2020,49019,Sassetta,LI,15,1,0,0,0,1,5,0,0,0,5
2020,49019,Sassetta,LI,16,2,0,0,0,2,3,0,0,0,3
2020,49019,Sassetta,LI,17,3,0,0,0,3,3,0,0,0,3
2020,49019,Sassetta,LI,18,2,0,0,0,2,1,0,0,0,1
2020,49019,Sassetta,LI,19,1,0,0,0,1,2,0,0,0,2
2020,49019,Sassetta,LI,20,1,0,0,0,1,0,0,0,0,0
2020,49019,Sassetta,LI,21,1,0,0,0,1,1,0,0,0,1
2020,49019,Sassetta,LI,22,5,0,0,0,5,3,0,0,0,3
2020,49019,Sassetta,LI,23,3,0,0,0,3,0,0,0,0,0
2020,49019,Sassetta,LI,24,3,0,0,0,3,1,1,0,0,2
2020,49019,Sassetta,LI,25,2,0,0,0,2,2,0,0,0,2
2020,49019,Sassetta,LI,26,4,0,0,0,4,6,0,0,0,6
2020,49019,Sassetta,LI,27,3,0,0,0,3,2,1,0,0,3
2020,49019,Sassetta,LI,28,1,0,0,0,1,2,0,0,0,2
2020,49019,Sassetta,LI,29,6,0,0,0,6,1,0,0,0,1
2020,49019,Sassetta,LI,30,1,0,0,0,1,0,0,0,0,0
2020,49019,Sassetta,LI,31,1,4,0,0,5,1,2,0,0,3
2020,49019,Sassetta,LI,32,3,0,0,0,3,1,3,0,0,4
2020,49019,Sassetta,LI,33,1,0,0,0,1,0,0,0,0,0
2020,49019,Sassetta,LI,34,3,1,0,0,4,0,0,0,0,0
2020,49019,Sassetta,LI,35,0,0,1,0,1,3,1,0,0,4
2020,49019,Sassetta,LI,36,5,1,0,0,6,1,0,0,0,1
2020,49019,Sassetta,LI,37,2,2,0,0,4,1,2,0,0,3
2020,49019,Sassetta,LI,38,1,0,0,0,1,0,0,0,0,0
2020,49019,Sassetta,LI,39,1,1,0,0,2,2,3,1,0,6
2020,49019,Sassetta,LI,40,2,1,0,0,3,6,1,0,0,7
2020,49019,Sassetta,LI,41,2,0,1,0,3,2,1,0,0,3
2020,49019,Sassetta,LI,42,2,2,0,0,4,3,3,0,0,6
2020,49019,Sassetta,LI,43,1,0,0,0,1,1,1,0,0,2
2020,49019,Sassetta,LI,44,1,1,0,0,2,1,1,1,0,3
2020,49019,Sassetta,LI,45,6,0,0,0,6,1,4,0,0,5
2020,49019,Sassetta,LI,46,3,5,0,0,8,0,3,0,0,3
2020,49019,Sassetta,LI,47,1,4,0,0,5,0,3,0,0,3
2020,49019,Sassetta,LI,48,2,1,0,0,3,0,2,1,0,3
2020,49019,Sassetta,LI,49,2,2,1,0,5,1,3,0,0,4
2020,49019,Sassetta,LI,50,0,0,0,0,0,0,4,0,0,4
2020,49019,Sassetta,LI,51,0,5,0,0,5,1,0,0,0,1
2020,49019,Sassetta,LI,52,0,1,0,0,1,1,2,0,0,3
2020,49019,Sassetta,LI,53,1,2,1,0,4,3,3,0,0,6
2020,49019,Sassetta,LI,54,1,5,1,0,7,2,2,1,0,5
2020,49019,Sassetta,LI,55,2,3,1,0,6,0,3,0,0,3
2020,49019,Sassetta,LI,56,1,6,0,0,7,1,1,0,0,2
2020,49019,Sassetta,LI,57,0,2,0,0,2,0,5,0,0,5
2020,49019,Sassetta,LI,58,2,3,0,0,5,1,3,0,1,5
2020,49019,Sassetta,LI,59,1,1,3,0,5,0,1,0,0,1
2020,49019,Sassetta,LI,60,1,4,0,0,5,0,2,2,1,5
2020,49019,Sassetta,LI,61,1,0,0,0,1,1,5,0,0,6
2020,49019,Sassetta,LI,62,1,2,0,0,3,2,0,1,0,3
2020,49019,Sassetta,LI,63,0,2,0,1,3,1,3,0,0,4
2020,49019,Sassetta,LI,64,0,3,0,0,3,1,2,2,0,5
2020,49019,Sassetta,LI,65,0,3,1,0,4,0,5,0,1,6
2020,49019,Sassetta,LI,66,1,0,0,0,1,0,2,1,0,3
2020,49019,Sassetta,LI,67,0,5,0,0,5,0,2,0,2,4
2020,49019,Sassetta,LI,68,2,0,1,0,3,1,3,2,0,6
2020,49019,Sassetta,LI,69,0,3,0,0,3,0,1,0,0,1
2020,49019,Sassetta,LI,70,0,2,1,0,3,0,3,0,1,4
2020,49019,Sassetta,LI,71,0,2,0,0,2,0,3,0,0,3
2020,49019,Sassetta,LI,72,0,4,1,0,5,0,2,2,1,5
2020,49019,Sassetta,LI,73,1,2,0,0,3,0,3,0,1,4
2020,49019,Sassetta,LI,74,0,2,0,2,4,0,0,1,2,3
2020,49019,Sassetta,LI,75,0,0,0,0,0,0,0,0,1,1
2020,49019,Sassetta,LI,76,0,0,0,0,0,0,2,0,1,3
2020,49019,Sassetta,LI,77,0,2,0,0,2,0,1,0,0,1
2020,49019,Sassetta,LI,78,1,3,0,0,4,0,1,1,0,2
2020,49019,Sassetta,LI,79,0,1,0,1,2,0,0,0,2,2
2020,49019,Sassetta,LI,80,1,0,0,0,1,0,0,0,0,0
2020,49019,Sassetta,LI,81,0,0,0,0,0,1,2,1,0,4
2020,49019,Sassetta,LI,82,0,3,0,0,3,0,1,0,2,3
2020,49019,Sassetta,LI,83,0,0,0,0,0,0,0,0,0,0
2020,49019,Sassetta,LI,84,0,0,0,0,0,1,0,0,2,3
2020,49019,Sassetta,LI,85,0,0,0,0,0,0,0,0,1,1
2020,49019,Sassetta,LI,86,0,0,0,1,1,0,0,0,2,2
2020,49019,Sassetta,LI,87,0,0,0,0,0,0,0,0,1,1
2020,49019,Sassetta,LI,88,0,1,0,2,3,0,0,0,2,2
2020,49019,Sassetta,LI,89,0,1,0,0,1,0,0,0,1,1
2020,49019,Sassetta,LI,90,0,0,0,0,0,0,0,0,1,1
2020,49019,Sassetta,LI,91,0,0,0,0,0,0,0,0,2,2
2020,49019,Sassetta,LI,92,0,0,0,0,0,0,1,0,0,1
2020,49019,Sassetta,LI,93,1,0,0,0,1,0,0,0,1,1
2020,49019,Sassetta,LI,94,0,0,0,0,0,0,0,0,0,0
2020,49019,Sassetta,LI,95,0,0,0,0,0,0,0,0,0,0
2020,49019,Sassetta,LI,96,0,0,0,0,0,0,0,0,0,0
2020,49019,Sassetta,LI,97,0,0,0,0,0,0,0,0,0,0
2020,49019,Sassetta,LI,98,0,0,0,1,1,0,0,0,0,0
2020,49019,Sassetta,LI,99,0,0,0,0,0,0,0,0,0,0
2020,49019,Sassetta,LI,100 e più,0,0,0,0,0,0,0,0,0,0
2020,49020,Suvereto,LI,0,7,0,0,0,7,4,0,0,0,4
2020,49020,Suvereto,LI,1,9,0,0,0,9,5,0,0,0,5
2020,49020,Suvereto,LI,2,5,0,0,0,5,10,0,0,0,10
2020,49020,Suvereto,LI,3,16,0,0,0,16,14,0,0,0,14
2020,49020,Suvereto,LI,4,9,0,0,0,9,16,0,0,0,16
2020,49020,Suvereto,LI,5,9,0,0,0,9,8,0,0,0,8
2020,49020,Suvereto,LI,6,13,0,0,0,13,12,0,0,0,12
2020,49020,Suvereto,LI,7,8,0,0,0,8,6,0,0,0,6
2020,49020,Suvereto,LI,8,11,0,0,0,11,13,0,0,0,13
2020,49020,Suvereto,LI,9,13,0,0,0,13,10,0,0,0,10
2020,49020,Suvereto,LI,10,12,0,0,0,12,9,0,0,0,9
2020,49020,Suvereto,LI,11,18,0,0,0,18,16,0,0,0,16
2020,49020,Suvereto,LI,12,12,0,0,0,12,8,0,0,0,8
2020,49020,Suvereto,LI,13,14,0,0,0,14,10,0,0,0,10
2020,49020,Suvereto,LI,14,14,0,0,0,14,11,0,0,0,11
2020,49020,Suvereto,LI,15,12,0,0,0,12,18,0,0,0,18
2020,49020,Suvereto,LI,16,17,0,0,0,17,19,0,0,0,19
2020,49020,Suvereto,LI,17,15,0,0,0,15,12,0,0,0,12
2020,49020,Suvereto,LI,18,14,0,0,0,14,12,0,0,0,12
2020,49020,Suvereto,LI,19,15,0,0,0,15,10,0,0,0,10
2020,49020,Suvereto,LI,20,9,0,0,0,9,6,0,0,0,6
2020,49020,Suvereto,LI,21,11,0,0,0,11,20,0,0,0,20
2020,49020,Suvereto,LI,22,19,0,0,0,19,16,2,0,0,18
2020,49020,Suvereto,LI,23,13,0,0,0,13,7,1,0,0,8
2020,49020,Suvereto,LI,24,6,2,0,0,8,19,3,0,0,22
2020,49020,Suvereto,LI,25,14,0,0,0,14,8,1,0,0,9
2020,49020,Suvereto,LI,26,10,2,0,0,12,8,2,0,0,10
2020,49020,Suvereto,LI,27,8,2,0,0,10,9,2,0,0,11
2020,49020,Suvereto,LI,28,12,0,0,0,12,11,1,0,0,12
2020,49020,Suvereto,LI,29,18,3,0,0,21,10,3,0,0,13
2020,49020,Suvereto,LI,30,14,4,0,0,18,6,1,0,0,7
2020,49020,Suvereto,LI,31,11,1,0,0,12,4,4,0,0,8
2020,49020,Suvereto,LI,32,10,0,0,0,10,6,4,0,0,10
2020,49020,Suvereto,LI,33,11,2,0,0,13,6,0,0,0,6
2020,49020,Suvereto,LI,34,6,2,0,0,8,5,6,0,0,11
2020,49020,Suvereto,LI,35,10,2,0,0,12,6,6,0,0,12
2020,49020,Suvereto,LI,36,6,6,1,0,13,9,6,0,0,15
2020,49020,Suvereto,LI,37,8,7,0,0,15,5,8,1,0,14
2020,49020,Suvereto,LI,38,11,5,0,0,16,10,10,1,1,22
2020,49020,Suvereto,LI,39,8,5,0,0,13,9,7,0,0,16
2020,49020,Suvereto,LI,40,13,7,0,0,20,8,10,0,0,18
2020,49020,Suvereto,LI,41,10,11,0,0,21,7,13,2,0,22
2020,49020,Suvereto,LI,42,10,7,1,0,18,3,14,0,0,17
2020,49020,Suvereto,LI,43,6,12,2,0,20,4,11,5,0,20
2020,49020,Suvereto,LI,44,8,15,1,0,24,2,19,3,0,24
2020,49020,Suvereto,LI,45,7,13,1,0,21,14,20,1,1,36
2020,49020,Suvereto,LI,46,13,18,2,0,33,6,15,1,1,23
2020,49020,Suvereto,LI,47,2,13,2,0,17,6,19,2,0,27
2020,49020,Suvereto,LI,48,10,18,4,0,32,5,15,5,1,26
2020,49020,Suvereto,LI,49,8,21,2,0,31,5,16,1,0,22
2020,49020,Suvereto,LI,50,10,12,1,0,23,5,15,2,1,23
2020,49020,Suvereto,LI,51,8,11,1,1,21,2,16,7,0,25
2020,49020,Suvereto,LI,52,3,22,3,1,29,5,16,3,2,26
2020,49020,Suvereto,LI,53,3,12,3,0,18,3,12,0,3,18
2020,49020,Suvereto,LI,54,4,13,2,0,19,1,17,2,2,22
2020,49020,Suvereto,LI,55,4,12,3,1,20,2,16,4,2,24
2020,49020,Suvereto,LI,56,2,15,5,0,22,4,14,2,0,20
2020,49020,Suvereto,LI,57,1,15,3,0,19,4,12,0,0,16
2020,49020,Suvereto,LI,58,3,17,1,1,22,2,19,2,1,24
2020,49020,Suvereto,LI,59,1,14,3,0,18,3,18,2,1,24
2020,49020,Suvereto,LI,60,2,18,1,2,23,3,19,4,1,27
2020,49020,Suvereto,LI,61,4,12,3,1,20,1,12,1,5,19
2020,49020,Suvereto,LI,62,2,21,0,2,25,0,22,2,1,25
2020,49020,Suvereto,LI,63,1,17,3,1,22,0,14,3,0,17
2020,49020,Suvereto,LI,64,1,15,1,0,17,1,21,0,2,24
2020,49020,Suvereto,LI,65,1,9,0,1,11,0,16,0,0,16
2020,49020,Suvereto,LI,66,1,21,1,1,24,0,19,1,2,22
2020,49020,Suvereto,LI,67,1,9,1,0,11,1,9,0,3,13
2020,49020,Suvereto,LI,68,0,16,2,0,18,1,15,1,1,18
2020,49020,Suvereto,LI,69,1,18,0,2,21,0,21,2,3,26
2020,49020,Suvereto,LI,70,1,12,1,1,15,0,15,1,8,24
2020,49020,Suvereto,LI,71,1,21,3,2,27,1,17,2,8,28
2020,49020,Suvereto,LI,72,3,16,1,3,23,0,13,1,4,18
2020,49020,Suvereto,LI,73,1,28,3,2,34,1,11,0,4,16
2020,49020,Suvereto,LI,74,1,15,0,1,17,1,11,1,9,22
2020,49020,Suvereto,LI,75,2,13,0,1,16,0,13,2,3,18
2020,49020,Suvereto,LI,76,1,18,1,0,20,0,12,1,7,20
2020,49020,Suvereto,LI,77,0,14,1,2,17,1,10,0,8,19
2020,49020,Suvereto,LI,78,0,13,0,1,14,1,14,1,8,24
2020,49020,Suvereto,LI,79,2,11,0,1,14,1,9,0,11,21
2020,49020,Suvereto,LI,80,2,13,0,2,17,2,9,0,7,18
2020,49020,Suvereto,LI,81,0,8,0,2,10,2,5,1,4,12
2020,49020,Suvereto,LI,82,0,12,0,2,14,0,11,0,10,21
2020,49020,Suvereto,LI,83,0,13,0,1,14,0,8,0,8,16
2020,49020,Suvereto,LI,84,1,11,0,3,15,2,6,0,5,13
2020,49020,Suvereto,LI,85,1,7,0,3,11,2,6,0,7,15
2020,49020,Suvereto,LI,86,0,7,0,3,10,0,2,0,8,10
2020,49020,Suvereto,LI,87,1,8,1,1,11,0,2,0,6,8
2020,49020,Suvereto,LI,88,0,3,0,3,6,0,3,0,13,16
2020,49020,Suvereto,LI,89,1,3,0,3,7,0,1,0,7,8
2020,49020,Suvereto,LI,90,0,2,0,0,2,0,0,0,7,7
2020,49020,Suvereto,LI,91,1,3,0,2,6,1,1,0,4,6
2020,49020,Suvereto,LI,92,0,2,0,0,2,0,0,0,4,4
2020,49020,Suvereto,LI,93,0,0,0,0,0,0,0,0,3,3
2020,49020,Suvereto,LI,94,1,0,0,2,3,0,0,0,3,3
2020,49020,Suvereto,LI,95,0,0,0,0,0,1,0,0,1,2
2020,49020,Suvereto,LI,96,1,0,0,0,1,0,0,0,2,2
2020,49020,Suvereto,LI,97,0,0,0,0,0,0,0,0,2,2
2020,49020,Suvereto,LI,98,0,0,0,0,0,0,0,0,1,1
2020,49020,Suvereto,LI,99,0,0,1,0,1,0,0,0,1,1
2020,49020,Suvereto,LI,100 e più,0,0,0,0,0,0,0,0,1,1
2020,49021,Rio,LI,0,11,0,0,0,11,5,0,0,0,5
2020,49021,Rio,LI,1,5,0,0,0,5,9,0,0,0,9
2020,49021,Rio,LI,2,9,0,0,0,9,12,0,0,0,12
2020,49021,Rio,LI,3,10,0,0,0,10,10,0,0,0,10
2020,49021,Rio,LI,4,11,0,0,0,11,9,0,0,0,9
2020,49021,Rio,LI,5,5,0,0,0,5,9,0,0,0,9
2020,49021,Rio,LI,6,8,0,0,0,8,12,0,0,0,12
2020,49021,Rio,LI,7,19,0,0,0,19,14,0,0,0,14
2020,49021,Rio,LI,8,12,0,0,0,12,12,0,0,0,12
2020,49021,Rio,LI,9,9,0,0,0,9,12,0,0,0,12
2020,49021,Rio,LI,10,13,0,0,0,13,17,0,0,0,17
2020,49021,Rio,LI,11,10,0,0,0,10,13,0,0,0,13
2020,49021,Rio,LI,12,17,0,0,0,17,12,0,0,0,12
2020,49021,Rio,LI,13,10,0,0,0,10,13,0,0,0,13
2020,49021,Rio,LI,14,12,0,0,0,12,11,0,0,0,11
2020,49021,Rio,LI,15,12,0,0,0,12,14,0,0,0,14
2020,49021,Rio,LI,16,8,0,0,0,8,12,0,0,0,12
2020,49021,Rio,LI,17,13,0,0,0,13,4,0,0,0,4
2020,49021,Rio,LI,18,6,0,0,0,6,13,0,0,0,13
2020,49021,Rio,LI,19,17,0,0,0,17,11,0,0,0,11
2020,49021,Rio,LI,20,13,0,0,0,13,17,0,0,0,17
2020,49021,Rio,LI,21,10,0,0,0,10,11,1,0,0,12
2020,49021,Rio,LI,22,11,0,0,0,11,15,0,0,0,15
2020,49021,Rio,LI,23,15,0,0,0,15,10,1,0,0,11
2020,49021,Rio,LI,24,13,0,0,0,13,6,0,0,0,6
2020,49021,Rio,LI,25,17,0,0,0,17,12,0,0,0,12
2020,49021,Rio,LI,26,12,0,0,0,12,17,0,0,0,17
2020,49021,Rio,LI,27,9,0,0,0,9,10,1,0,0,11
2020,49021,Rio,LI,28,12,0,0,0,12,17,3,0,0,20
2020,49021,Rio,LI,29,12,1,0,0,13,9,2,0,0,11
2020,49021,Rio,LI,30,15,1,0,0,16,18,3,0,0,21
2020,49021,Rio,LI,31,10,2,0,0,12,6,2,0,0,8
2020,49021,Rio,LI,32,10,2,0,0,12,6,0,0,0,6
2020,49021,Rio,LI,33,13,0,0,0,13,7,4,0,0,11
2020,49021,Rio,LI,34,10,4,0,0,14,14,9,0,0,23
2020,49021,Rio,LI,35,18,3,1,0,22,7,8,0,0,15
2020,49021,Rio,LI,36,14,4,0,0,18,3,3,1,0,7
2020,49021,Rio,LI,37,13,3,1,0,17,7,5,1,0,13
2020,49021,Rio,LI,38,14,8,1,0,23,13,11,0,0,24
2020,49021,Rio,LI,39,10,5,0,0,15,16,12,0,0,28
2020,49021,Rio,LI,40,10,7,0,0,17,9,12,0,0,21
2020,49021,Rio,LI,41,13,7,0,0,20,7,15,1,0,23
2020,49021,Rio,LI,42,16,17,1,0,34,11,9,1,0,21
2020,49021,Rio,LI,43,14,11,2,0,27,8,9,1,0,18
2020,49021,Rio,LI,44,10,13,0,0,23,5,20,0,0,25
2020,49021,Rio,LI,45,12,14,1,0,27,7,15,1,0,23
2020,49021,Rio,LI,46,12,12,0,0,24,18,12,2,0,32
2020,49021,Rio,LI,47,21,18,0,0,39,6,12,1,0,19
2020,49021,Rio,LI,48,16,18,1,0,35,6,20,4,2,32
2020,49021,Rio,LI,49,13,5,1,0,19,5,15,3,0,23
2020,49021,Rio,LI,50,12,17,2,0,31,7,16,2,0,25
2020,49021,Rio,LI,51,4,13,0,0,17,4,18,6,1,29
2020,49021,Rio,LI,52,15,17,3,0,35,5,25,1,1,32
2020,49021,Rio,LI,53,7,17,1,1,26,3,18,2,0,23
2020,49021,Rio,LI,54,3,22,3,1,29,3,6,6,1,16
2020,49021,Rio,LI,55,8,21,3,0,32,4,20,5,2,31
2020,49021,Rio,LI,56,6,19,3,1,29,2,20,3,1,26
2020,49021,Rio,LI,57,7,20,4,0,31,4,29,4,0,37
2020,49021,Rio,LI,58,2,27,6,0,35,3,17,2,2,24
2020,49021,Rio,LI,59,7,22,1,0,30,1,20,6,0,27
2020,49021,Rio,LI,60,5,19,2,0,26,3,13,4,5,25
2020,49021,Rio,LI,61,5,14,2,1,22,3,23,5,3,34
2020,49021,Rio,LI,62,3,16,2,0,21,1,17,5,2,25
2020,49021,Rio,LI,63,3,26,5,0,34,2,16,1,1,20
2020,49021,Rio,LI,64,5,21,10,1,37,5,24,2,3,34
2020,49021,Rio,LI,65,3,23,1,1,28,3,17,4,5,29
2020,49021,Rio,LI,66,2,16,2,1,21,1,17,2,10,30
2020,49021,Rio,LI,67,2,16,1,0,19,1,18,2,2,23
2020,49021,Rio,LI,68,2,23,0,0,25,0,21,0,7,28
2020,49021,Rio,LI,69,1,19,3,0,23,1,10,3,3,17
2020,49021,Rio,LI,70,5,23,1,0,29,1,11,1,4,17
2020,49021,Rio,LI,71,1,24,3,1,29,3,16,0,5,24
2020,49021,Rio,LI,72,2,12,2,1,17,1,12,2,5,20
2020,49021,Rio,LI,73,2,18,1,2,23,1,16,2,8,27
2020,49021,Rio,LI,74,1,24,1,3,29,0,13,0,18,31
2020,49021,Rio,LI,75,3,14,2,2,21,1,8,0,8,17
2020,49021,Rio,LI,76,0,17,2,2,21,0,11,1,6,18
2020,49021,Rio,LI,77,2,13,0,2,17,1,16,0,6,23
2020,49021,Rio,LI,78,0,19,1,1,21,0,16,0,6,22
2020,49021,Rio,LI,79,3,18,1,2,24,1,10,1,9,21
2020,49021,Rio,LI,80,4,12,0,2,18,1,5,2,5,13
2020,49021,Rio,LI,81,0,13,1,2,16,0,9,0,8,17
2020,49021,Rio,LI,82,0,12,0,1,13,0,11,2,7,20
2020,49021,Rio,LI,83,0,9,0,5,14,0,3,0,7,10
2020,49021,Rio,LI,84,1,11,0,2,14,1,11,1,11,24
2020,49021,Rio,LI,85,0,3,0,0,3,2,2,1,4,9
2020,49021,Rio,LI,86,1,2,1,2,6,0,2,0,6,8
2020,49021,Rio,LI,87,0,5,0,1,6,0,3,0,9,12
2020,49021,Rio,LI,88,0,2,0,2,4,1,3,0,5,9
2020,49021,Rio,LI,89,1,5,0,0,6,0,1,0,7,8
2020,49021,Rio,LI,90,0,4,0,2,6,0,0,0,12,12
2020,49021,Rio,LI,91,0,2,0,1,3,0,1,0,8,9
2020,49021,Rio,LI,92,0,4,0,0,4,1,1,0,3,5
2020,49021,Rio,LI,93,0,3,0,0,3,0,3,0,4,7
2020,49021,Rio,LI,94,0,0,0,0,0,0,0,0,1,1
2020,49021,Rio,LI,95,0,0,0,1,1,0,0,0,4,4
2020,49021,Rio,LI,96,0,0,0,0,0,0,0,0,3,3
2020,49021,Rio,LI,97,0,0,0,0,0,0,0,0,0,0
2020,49021,Rio,LI,98,0,0,0,1,1,1,0,0,2,3
2020,49021,Rio,LI,99,0,0,0,0,0,0,0,0,0,0
2020,49021,Rio,LI,100 e più,0,0,0,0,0,0,0,0,1,1
2020,46001,Altopascio,LU,0,78,0,0,0,78,52,0,0,0,52
2020,46001,Altopascio,LU,1,71,0,0,0,71,65,0,0,0,65
2020,46001,Altopascio,LU,2,70,0,0,0,70,73,0,0,0,73
2020,46001,Altopascio,LU,3,71,0,0,0,71,57,0,0,0,57
2020,46001,Altopascio,LU,4,67,0,0,0,67,69,0,0,0,69
2020,46001,Altopascio,LU,5,74,0,0,0,74,79,0,0,0,79
2020,46001,Altopascio,LU,6,76,0,0,0,76,88,0,0,0,88
2020,46001,Altopascio,LU,7,77,0,0,0,77,81,0,0,0,81
2020,46001,Altopascio,LU,8,85,0,0,0,85,90,0,0,0,90
2020,46001,Altopascio,LU,9,89,0,0,0,89,86,0,0,0,86
2020,46001,Altopascio,LU,10,76,0,0,0,76,84,0,0,0,84
2020,46001,Altopascio,LU,11,86,0,0,0,86,78,0,0,0,78
2020,46001,Altopascio,LU,12,93,0,0,0,93,103,0,0,0,103
2020,46001,Altopascio,LU,13,85,0,0,0,85,84,0,0,0,84
2020,46001,Altopascio,LU,14,95,0,0,0,95,62,0,0,0,62
2020,46001,Altopascio,LU,15,92,0,0,0,92,69,0,0,0,69
2020,46001,Altopascio,LU,16,93,0,0,0,93,80,0,0,0,80
2020,46001,Altopascio,LU,17,60,0,0,0,60,77,0,0,0,77
2020,46001,Altopascio,LU,18,73,0,0,0,73,84,0,0,0,84
2020,46001,Altopascio,LU,19,83,0,0,0,83,75,1,0,0,76
2020,46001,Altopascio,LU,20,65,0,0,0,65,73,3,0,0,76
2020,46001,Altopascio,LU,21,64,0,0,0,64,62,5,0,0,67
2020,46001,Altopascio,LU,22,72,1,0,0,73,66,8,0,0,74
2020,46001,Altopascio,LU,23,66,1,0,0,67,58,8,0,0,66
2020,46001,Altopascio,LU,24,65,1,0,0,66,51,8,1,0,60
2020,46001,Altopascio,LU,25,69,0,0,0,69,50,18,0,0,68
2020,46001,Altopascio,LU,26,65,5,1,0,71,49,11,0,0,60
2020,46001,Altopascio,LU,27,71,9,0,0,80,54,23,0,0,77
2020,46001,Altopascio,LU,28,57,12,2,0,71,54,25,0,0,79
2020,46001,Altopascio,LU,29,69,25,1,0,95,50,25,0,0,75
2020,46001,Altopascio,LU,30,68,17,0,0,85,66,41,1,0,108
2020,46001,Altopascio,LU,31,76,16,0,0,92,51,47,2,0,100
2020,46001,Altopascio,LU,32,61,24,2,0,87,41,49,0,0,90
2020,46001,Altopascio,LU,33,60,35,1,0,96,36,59,1,0,96
2020,46001,Altopascio,LU,34,54,41,3,0,98,27,56,0,0,83
2020,46001,Altopascio,LU,35,51,52,4,0,107,25,65,3,0,93
2020,46001,Altopascio,LU,36,49,47,3,0,99,38,66,1,0,105
2020,46001,Altopascio,LU,37,36,64,3,0,103,42,58,8,0,108
2020,46001,Altopascio,LU,38,47,51,3,0,101,28,80,3,0,111
2020,46001,Altopascio,LU,39,35,67,4,0,106,38,80,8,0,126
2020,46001,Altopascio,LU,40,37,77,4,0,118,36,70,7,2,115
2020,46001,Altopascio,LU,41,48,82,1,0,131,31,64,6,0,101
2020,46001,Altopascio,LU,42,40,82,3,0,125,32,72,9,0,113
2020,46001,Altopascio,LU,43,38,76,4,0,118,22,99,9,2,132
2020,46001,Altopascio,LU,44,48,94,2,0,144,27,100,4,0,131
2020,46001,Altopascio,LU,45,36,108,10,0,154,28,114,8,4,154
2020,46001,Altopascio,LU,46,36,89,12,0,137,24,99,18,6,147
2020,46001,Altopascio,LU,47,31,113,8,0,152,25,86,18,2,131
2020,46001,Altopascio,LU,48,28,93,13,2,136,15,101,11,1,128
2020,46001,Altopascio,LU,49,30,89,11,1,131,14,84,12,4,114
2020,46001,Altopascio,LU,50,26,92,5,1,124,19,100,12,0,131
2020,46001,Altopascio,LU,51,25,105,10,0,140,9,95,15,4,123
2020,46001,Altopascio,LU,52,32,97,7,0,136,13,102,19,7,141
2020,46001,Altopascio,LU,53,28,93,17,1,139,13,93,10,4,120
2020,46001,Altopascio,LU,54,20,99,16,2,137,14,90,13,4,121
2020,46001,Altopascio,LU,55,18,90,15,2,125,14,79,14,7,114
2020,46001,Altopascio,LU,56,19,90,4,3,116,6,99,13,8,126
2020,46001,Altopascio,LU,57,10,85,13,0,108,7,85,17,8,117
2020,46001,Altopascio,LU,58,16,88,9,1,114,18,68,9,7,102
2020,46001,Altopascio,LU,59,12,87,12,1,112,5,88,12,5,110
2020,46001,Altopascio,LU,60,15,57,6,1,79,7,70,9,5,91
2020,46001,Altopascio,LU,61,7,71,8,1,87,7,63,11,7,88
2020,46001,Altopascio,LU,62,10,77,9,2,98,5,71,1,11,88
2020,46001,Altopascio,LU,63,7,72,6,1,86,3,81,5,8,97
2020,46001,Altopascio,LU,64,6,66,7,1,80,4,75,4,5,88
2020,46001,Altopascio,LU,65,2,78,5,2,87,1,73,4,11,89
2020,46001,Altopascio,LU,66,5,75,6,2,88,3,79,6,8,96
2020,46001,Altopascio,LU,67,5,77,4,2,88,3,56,3,18,80
2020,46001,Altopascio,LU,68,3,63,0,2,68,11,55,4,12,82
2020,46001,Altopascio,LU,69,2,81,5,1,89,2,67,5,24,98
2020,46001,Altopascio,LU,70,9,64,3,2,78,4,51,7,17,79
2020,46001,Altopascio,LU,71,1,76,5,3,85,2,44,4,15,65
2020,46001,Altopascio,LU,72,4,57,6,4,71,3,60,4,18,85
2020,46001,Altopascio,LU,73,7,53,3,6,69,0,61,3,21,85
2020,46001,Altopascio,LU,74,1,53,7,8,69,2,45,6,20,73
2020,46001,Altopascio,LU,75,2,43,3,9,57,2,32,3,19,56
2020,46001,Altopascio,LU,76,3,38,0,6,47,3,28,2,26,59
2020,46001,Altopascio,LU,77,1,43,0,10,54,3,25,2,28,58
2020,46001,Altopascio,LU,78,2,45,2,7,56,3,22,1,22,48
2020,46001,Altopascio,LU,79,2,41,2,6,51,2,30,1,28,61
2020,46001,Altopascio,LU,80,2,29,1,7,39,1,30,1,39,71
2020,46001,Altopascio,LU,81,2,34,1,4,41,3,25,0,28,56
2020,46001,Altopascio,LU,82,3,29,1,6,39,4,15,3,27,49
2020,46001,Altopascio,LU,83,4,24,2,7,37,3,20,1,38,62
2020,46001,Altopascio,LU,84,2,32,0,10,44,2,14,2,31,49
2020,46001,Altopascio,LU,85,0,14,0,10,24,2,12,1,22,37
2020,46001,Altopascio,LU,86,1,15,0,8,24,2,11,0,31,44
2020,46001,Altopascio,LU,87,0,15,0,5,20,2,5,1,26,34
2020,46001,Altopascio,LU,88,0,14,0,10,24,0,8,0,21,29
2020,46001,Altopascio,LU,89,0,8,0,5,13,1,3,0,28,32
2020,46001,Altopascio,LU,90,4,12,2,5,23,4,5,0,30,39
2020,46001,Altopascio,LU,91,0,2,0,4,6,0,2,0,22,24
2020,46001,Altopascio,LU,92,0,6,0,4,10,0,2,0,15,17
2020,46001,Altopascio,LU,93,0,3,0,3,6,1,0,0,12,13
2020,46001,Altopascio,LU,94,0,0,0,2,2,0,0,0,13,13
2020,46001,Altopascio,LU,95,0,1,0,0,1,1,0,0,4,5
2020,46001,Altopascio,LU,96,0,0,0,1,1,0,0,0,7,7
2020,46001,Altopascio,LU,97,0,1,0,2,3,1,1,0,4,6
2020,46001,Altopascio,LU,98,0,0,0,0,0,1,0,0,1,2
2020,46001,Altopascio,LU,99,0,0,0,0,0,0,0,0,2,2
2020,46001,Altopascio,LU,100 e più,0,0,0,0,0,0,0,0,2,2
2020,46002,Bagni di Lucca,LU,0,7,0,0,0,7,12,0,0,0,12
2020,46002,Bagni di Lucca,LU,1,13,0,0,0,13,7,0,0,0,7
2020,46002,Bagni di Lucca,LU,2,15,0,0,0,15,17,0,0,0,17
2020,46002,Bagni di Lucca,LU,3,17,0,0,0,17,16,0,0,0,16
2020,46002,Bagni di Lucca,LU,4,12,0,0,0,12,22,0,0,0,22
2020,46002,Bagni di Lucca,LU,5,18,0,0,0,18,12,0,0,0,12
2020,46002,Bagni di Lucca,LU,6,21,0,0,0,21,12,0,0,0,12
2020,46002,Bagni di Lucca,LU,7,18,0,0,0,18,16,0,0,0,16
2020,46002,Bagni di Lucca,LU,8,22,0,0,0,22,16,0,0,0,16
2020,46002,Bagni di Lucca,LU,9,23,0,0,0,23,19,0,0,0,19
2020,46002,Bagni di Lucca,LU,10,25,0,0,0,25,21,0,0,0,21
2020,46002,Bagni di Lucca,LU,11,19,0,0,0,19,32,0,0,0,32
2020,46002,Bagni di Lucca,LU,12,11,0,0,0,11,21,0,0,0,21
2020,46002,Bagni di Lucca,LU,13,32,0,0,0,32,17,0,0,0,17
2020,46002,Bagni di Lucca,LU,14,20,0,0,0,20,20,0,0,0,20
2020,46002,Bagni di Lucca,LU,15,21,0,0,0,21,28,0,0,0,28
2020,46002,Bagni di Lucca,LU,16,22,0,0,0,22,28,0,0,0,28
2020,46002,Bagni di Lucca,LU,17,24,0,0,0,24,16,0,0,0,16
2020,46002,Bagni di Lucca,LU,18,28,0,0,0,28,25,0,0,0,25
2020,46002,Bagni di Lucca,LU,19,30,0,0,0,30,23,0,0,0,23
2020,46002,Bagni di Lucca,LU,20,22,0,0,0,22,16,0,0,0,16
2020,46002,Bagni di Lucca,LU,21,29,0,0,0,29,26,0,0,0,26
2020,46002,Bagni di Lucca,LU,22,36,0,0,0,36,21,0,0,0,21
2020,46002,Bagni di Lucca,LU,23,33,0,0,0,33,18,2,0,0,20
2020,46002,Bagni di Lucca,LU,24,30,0,0,0,30,26,1,0,0,27
2020,46002,Bagni di Lucca,LU,25,23,0,0,0,23,16,0,0,0,16
2020,46002,Bagni di Lucca,LU,26,31,0,0,0,31,22,1,0,0,23
2020,46002,Bagni di Lucca,LU,27,22,0,0,0,22,20,3,0,0,23
2020,46002,Bagni di Lucca,LU,28,37,0,0,0,37,13,3,0,0,16
2020,46002,Bagni di Lucca,LU,29,23,3,0,0,26,21,2,0,0,23
2020,46002,Bagni di Lucca,LU,30,23,0,0,0,23,23,3,0,0,26
2020,46002,Bagni di Lucca,LU,31,22,3,0,0,25,13,6,0,0,19
2020,46002,Bagni di Lucca,LU,32,22,4,0,0,26,4,10,1,0,15
2020,46002,Bagni di Lucca,LU,33,24,6,0,0,30,9,15,0,0,24
2020,46002,Bagni di Lucca,LU,34,29,7,0,0,36,16,8,0,0,24
2020,46002,Bagni di Lucca,LU,35,15,8,1,0,24,16,7,1,0,24
2020,46002,Bagni di Lucca,LU,36,15,9,1,0,25,6,15,0,0,21
2020,46002,Bagni di Lucca,LU,37,13,7,0,0,20,16,15,0,0,31
2020,46002,Bagni di Lucca,LU,38,18,6,1,0,25,14,15,1,0,30
2020,46002,Bagni di Lucca,LU,39,24,18,2,0,44,10,8,2,0,20
2020,46002,Bagni di Lucca,LU,40,14,6,0,0,20,14,15,0,1,30
2020,46002,Bagni di Lucca,LU,41,18,9,1,0,28,7,17,4,0,28
2020,46002,Bagni di Lucca,LU,42,13,13,3,0,29,15,14,4,1,34
2020,46002,Bagni di Lucca,LU,43,11,13,1,0,25,11,15,0,0,26
2020,46002,Bagni di Lucca,LU,44,16,25,0,0,41,14,21,1,1,37
2020,46002,Bagni di Lucca,LU,45,23,14,3,0,40,15,24,3,0,42
2020,46002,Bagni di Lucca,LU,46,16,28,1,0,45,9,31,3,0,43
2020,46002,Bagni di Lucca,LU,47,22,14,1,1,38,8,26,5,0,39
2020,46002,Bagni di Lucca,LU,48,15,21,0,0,36,9,31,3,1,44
2020,46002,Bagni di Lucca,LU,49,10,15,0,0,25,9,27,5,1,42
2020,46002,Bagni di Lucca,LU,50,22,25,2,1,50,7,29,3,1,40
2020,46002,Bagni di Lucca,LU,51,17,22,6,0,45,16,33,6,0,55
2020,46002,Bagni di Lucca,LU,52,6,41,3,1,51,9,45,7,1,62
2020,46002,Bagni di Lucca,LU,53,13,39,7,0,59,10,29,5,4,48
2020,46002,Bagni di Lucca,LU,54,19,36,8,1,64,5,32,6,2,45
2020,46002,Bagni di Lucca,LU,55,10,28,5,1,44,5,40,6,2,53
2020,46002,Bagni di Lucca,LU,56,13,37,3,0,53,7,33,1,2,43
2020,46002,Bagni di Lucca,LU,57,10,38,6,0,54,5,25,5,2,37
2020,46002,Bagni di Lucca,LU,58,11,25,1,0,37,5,39,5,3,52
2020,46002,Bagni di Lucca,LU,59,8,32,3,0,43,9,42,3,4,58
2020,46002,Bagni di Lucca,LU,60,6,36,4,0,46,5,32,3,3,43
2020,46002,Bagni di Lucca,LU,61,6,27,2,0,35,1,23,7,5,36
2020,46002,Bagni di Lucca,LU,62,6,34,3,1,44,3,36,6,5,50
2020,46002,Bagni di Lucca,LU,63,4,29,5,1,39,4,28,8,8,48
2020,46002,Bagni di Lucca,LU,64,2,36,2,0,40,3,34,2,5,44
2020,46002,Bagni di Lucca,LU,65,8,23,1,1,33,3,26,2,5,36
2020,46002,Bagni di Lucca,LU,66,7,29,3,2,41,4,28,1,7,40
2020,46002,Bagni di Lucca,LU,67,3,44,4,0,51,5,26,3,6,40
2020,46002,Bagni di Lucca,LU,68,4,30,3,4,41,6,28,3,8,45
2020,46002,Bagni di Lucca,LU,69,5,37,4,4,50,2,35,3,7,47
2020,46002,Bagni di Lucca,LU,70,4,45,6,2,57,1,32,0,9,42
2020,46002,Bagni di Lucca,LU,71,2,39,1,4,46,2,22,2,19,45
2020,46002,Bagni di Lucca,LU,72,9,29,4,1,43,3,33,2,11,49
2020,46002,Bagni di Lucca,LU,73,3,32,5,2,42,4,23,2,8,37
2020,46002,Bagni di Lucca,LU,74,3,23,0,3,29,3,21,2,11,37
2020,46002,Bagni di Lucca,LU,75,2,19,0,3,24,1,19,3,6,29
2020,46002,Bagni di Lucca,LU,76,6,31,5,1,43,2,17,1,12,32
2020,46002,Bagni di Lucca,LU,77,3,18,2,2,25,1,11,0,16,28
2020,46002,Bagni di Lucca,LU,78,3,21,0,6,30,2,11,1,18,32
2020,46002,Bagni di Lucca,LU,79,5,21,0,3,29,0,16,0,14,30
2020,46002,Bagni di Lucca,LU,80,4,24,0,4,32,2,11,0,20,33
2020,46002,Bagni di Lucca,LU,81,3,16,1,5,25,0,11,0,20,31
2020,46002,Bagni di Lucca,LU,82,2,6,3,5,16,3,11,1,20,35
2020,46002,Bagni di Lucca,LU,83,2,15,0,2,19,0,11,0,22,33
2020,46002,Bagni di Lucca,LU,84,2,9,1,2,14,1,11,2,13,27
2020,46002,Bagni di Lucca,LU,85,2,14,0,1,17,0,4,1,21,26
2020,46002,Bagni di Lucca,LU,86,2,12,0,2,16,0,7,0,22,29
2020,46002,Bagni di Lucca,LU,87,1,10,0,0,11,0,3,1,19,23
2020,46002,Bagni di Lucca,LU,88,1,7,0,5,13,2,4,0,20,26
2020,46002,Bagni di Lucca,LU,89,0,6,0,2,8,1,3,0,17,21
2020,46002,Bagni di Lucca,LU,90,0,6,0,1,7,1,2,0,14,17
2020,46002,Bagni di Lucca,LU,91,0,2,0,1,3,2,0,2,11,15
2020,46002,Bagni di Lucca,LU,92,1,4,0,1,6,1,1,0,17,19
2020,46002,Bagni di Lucca,LU,93,0,3,0,1,4,0,0,1,3,4
2020,46002,Bagni di Lucca,LU,94,1,1,0,1,3,0,0,0,4,4
2020,46002,Bagni di Lucca,LU,95,1,0,0,3,4,0,0,0,14,14
2020,46002,Bagni di Lucca,LU,96,0,1,0,0,1,0,0,0,6,6
2020,46002,Bagni di Lucca,LU,97,0,0,0,1,1,1,0,0,5,6
2020,46002,Bagni di Lucca,LU,98,0,0,0,0,0,0,1,0,4,5
2020,46002,Bagni di Lucca,LU,99,0,0,0,0,0,0,0,0,1,1
2020,46002,Bagni di Lucca,LU,100 e più,0,0,0,0,0,0,0,0,1,1
2020,46003,Barga,LU,0,22,0,0,0,22,30,0,0,0,30
2020,46003,Barga,LU,1,21,0,0,0,21,37,0,0,0,37
2020,46003,Barga,LU,2,39,0,0,0,39,26,0,0,0,26
2020,46003,Barga,LU,3,28,0,0,0,28,31,0,0,0,31
2020,46003,Barga,LU,4,37,0,0,0,37,33,0,0,0,33
2020,46003,Barga,LU,5,42,0,0,0,42,35,0,0,0,35
2020,46003,Barga,LU,6,34,0,0,0,34,33,0,0,0,33
2020,46003,Barga,LU,7,29,0,0,0,29,49,0,0,0,49
2020,46003,Barga,LU,8,53,0,0,0,53,32,0,0,0,32
2020,46003,Barga,LU,9,38,0,0,0,38,35,0,0,0,35
2020,46003,Barga,LU,10,44,0,0,0,44,38,0,0,0,38
2020,46003,Barga,LU,11,42,0,0,0,42,45,0,0,0,45
2020,46003,Barga,LU,12,56,0,0,0,56,37,0,0,0,37
2020,46003,Barga,LU,13,48,0,0,0,48,45,0,0,0,45
2020,46003,Barga,LU,14,52,0,0,0,52,39,0,0,0,39
2020,46003,Barga,LU,15,38,0,0,0,38,39,0,0,0,39
2020,46003,Barga,LU,16,39,0,0,0,39,39,0,0,0,39
2020,46003,Barga,LU,17,46,0,0,0,46,40,0,0,0,40
2020,46003,Barga,LU,18,34,0,0,0,34,39,0,0,0,39
2020,46003,Barga,LU,19,53,0,0,0,53,39,0,0,0,39
2020,46003,Barga,LU,20,44,0,0,0,44,43,0,0,0,43
2020,46003,Barga,LU,21,50,0,0,0,50,50,0,0,0,50
2020,46003,Barga,LU,22,41,0,0,0,41,44,1,0,0,45
2020,46003,Barga,LU,23,52,0,0,0,52,48,2,0,0,50
2020,46003,Barga,LU,24,35,0,0,0,35,48,2,0,0,50
2020,46003,Barga,LU,25,48,2,1,0,51,46,7,0,0,53
2020,46003,Barga,LU,26,46,2,0,0,48,32,9,0,0,41
2020,46003,Barga,LU,27,34,4,0,0,38,31,12,0,0,43
2020,46003,Barga,LU,28,38,4,0,0,42,38,12,0,0,50
2020,46003,Barga,LU,29,30,2,0,0,32,27,13,1,0,41
2020,46003,Barga,LU,30,41,3,0,0,44,26,18,1,0,45
2020,46003,Barga,LU,31,39,7,1,0,47,17,17,0,0,34
2020,46003,Barga,LU,32,29,17,0,0,46,17,22,0,0,39
2020,46003,Barga,LU,33,28,17,0,0,45,23,19,0,0,42
2020,46003,Barga,LU,34,28,12,0,0,40,11,23,2,0,36
2020,46003,Barga,LU,35,29,11,0,0,40,21,22,4,0,47
2020,46003,Barga,LU,36,21,23,3,0,47,12,19,3,0,34
2020,46003,Barga,LU,37,28,17,1,0,46,8,18,1,0,27
2020,46003,Barga,LU,38,25,34,2,0,61,24,32,1,0,57
2020,46003,Barga,LU,39,27,20,1,0,48,16,32,1,0,49
2020,46003,Barga,LU,40,22,26,3,0,51,11,41,2,1,55
2020,46003,Barga,LU,41,22,26,2,0,50,14,40,2,0,56
2020,46003,Barga,LU,42,16,38,2,0,56,17,38,1,1,57
2020,46003,Barga,LU,43,22,27,6,0,55,21,42,5,0,68
2020,46003,Barga,LU,44,20,38,2,0,60,9,47,8,0,64
2020,46003,Barga,LU,45,27,40,1,0,68,19,47,3,1,70
2020,46003,Barga,LU,46,31,52,2,0,85,19,55,7,0,81
2020,46003,Barga,LU,47,20,41,2,1,64,10,58,9,0,77
2020,46003,Barga,LU,48,27,43,3,0,73,12,52,8,0,72
2020,46003,Barga,LU,49,24,43,12,0,79,17,62,12,1,92
2020,46003,Barga,LU,50,20,45,3,0,68,5,57,10,0,72
2020,46003,Barga,LU,51,22,46,11,0,79,14,59,13,1,87
2020,46003,Barga,LU,52,15,55,9,1,80,5,57,6,1,69
2020,46003,Barga,LU,53,17,54,8,0,79,4,62,7,2,75
2020,46003,Barga,LU,54,20,70,1,0,91,8,53,5,3,69
2020,46003,Barga,LU,55,17,64,6,1,88,8,58,6,2,74
2020,46003,Barga,LU,56,6,73,3,0,82,11,62,10,2,85
2020,46003,Barga,LU,57,14,48,3,0,65,5,54,5,4,68
2020,46003,Barga,LU,58,10,52,6,0,68,12,59,10,2,83
2020,46003,Barga,LU,59,6,54,3,1,64,14,53,5,8,80
2020,46003,Barga,LU,60,12,64,4,1,81,4,59,6,2,71
2020,46003,Barga,LU,61,11,66,7,0,84,8,57,2,9,76
2020,46003,Barga,LU,62,9,48,5,1,63,3,38,4,5,50
2020,46003,Barga,LU,63,6,51,3,2,62,7,47,8,4,66
2020,46003,Barga,LU,64,9,54,5,2,70,1,41,2,7,51
2020,46003,Barga,LU,65,6,51,4,4,65,2,50,4,12,68
2020,46003,Barga,LU,66,5,42,3,0,50,3,46,4,6,59
2020,46003,Barga,LU,67,7,44,2,3,56,3,53,6,12,74
2020,46003,Barga,LU,68,4,45,1,9,59,0,58,0,7,65
2020,46003,Barga,LU,69,6,37,3,3,49,4,39,3,10,56
2020,46003,Barga,LU,70,4,47,3,3,57,1,43,3,11,58
2020,46003,Barga,LU,71,4,53,1,6,64,2,39,2,20,63
2020,46003,Barga,LU,72,10,55,5,3,73,3,44,2,16,65
2020,46003,Barga,LU,73,9,62,3,5,79,5,54,2,7,68
2020,46003,Barga,LU,74,8,63,3,5,79,3,48,1,28,80
2020,46003,Barga,LU,75,1,40,1,7,49,1,32,4,16,53
2020,46003,Barga,LU,76,4,32,2,3,41,3,36,2,22,63
2020,46003,Barga,LU,77,6,44,2,5,57,2,32,2,14,50
2020,46003,Barga,LU,78,5,41,1,3,50,3,24,1,30,58
2020,46003,Barga,LU,79,3,40,2,9,54,1,19,1,28,49
2020,46003,Barga,LU,80,3,33,0,10,46,2,33,1,31,67
2020,46003,Barga,LU,81,5,32,1,1,39,0,22,0,25,47
2020,46003,Barga,LU,82,3,42,0,9,54,1,21,0,31,53
2020,46003,Barga,LU,83,4,20,0,10,34,2,12,1,30,45
2020,46003,Barga,LU,84,1,12,1,8,22,3,12,0,30,45
2020,46003,Barga,LU,85,3,19,0,7,29,2,4,0,26,32
2020,46003,Barga,LU,86,1,18,0,5,24,1,13,0,28,42
2020,46003,Barga,LU,87,3,9,1,7,20,1,4,0,30,35
2020,46003,Barga,LU,88,2,14,0,6,22,3,2,0,33,38
2020,46003,Barga,LU,89,1,5,0,6,12,3,5,0,16,24
2020,46003,Barga,LU,90,1,6,0,1,8,0,1,0,22,23
2020,46003,Barga,LU,91,2,7,0,4,13,1,3,0,22,26
2020,46003,Barga,LU,92,0,2,0,7,9,1,2,0,19,22
2020,46003,Barga,LU,93,0,4,0,4,8,1,0,0,13,14
2020,46003,Barga,LU,94,0,2,0,1,3,0,1,0,16,17
2020,46003,Barga,LU,95,0,1,0,3,4,0,0,0,5,5
2020,46003,Barga,LU,96,1,0,0,1,2,2,1,0,7,10
2020,46003,Barga,LU,97,0,1,0,0,1,1,0,0,7,8
2020,46003,Barga,LU,98,0,0,0,0,0,0,1,0,3,4
2020,46003,Barga,LU,99,0,0,0,1,1,0,0,0,4,4
2020,46003,Barga,LU,100 e più,0,0,0,1,1,0,0,0,8,8
2020,46004,Borgo a Mozzano,LU,0,22,0,0,0,22,19,0,0,0,19
2020,46004,Borgo a Mozzano,LU,1,13,0,0,0,13,18,0,0,0,18
2020,46004,Borgo a Mozzano,LU,2,22,0,0,0,22,20,0,0,0,20
2020,46004,Borgo a Mozzano,LU,3,17,0,0,0,17,11,0,0,0,11
2020,46004,Borgo a Mozzano,LU,4,24,0,0,0,24,21,0,0,0,21
2020,46004,Borgo a Mozzano,LU,5,23,0,0,0,23,30,0,0,0,30
2020,46004,Borgo a Mozzano,LU,6,22,0,0,0,22,19,0,0,0,19
2020,46004,Borgo a Mozzano,LU,7,36,0,0,0,36,33,0,0,0,33
2020,46004,Borgo a Mozzano,LU,8,27,0,0,0,27,19,0,0,0,19
2020,46004,Borgo a Mozzano,LU,9,19,0,0,0,19,26,0,0,0,26
2020,46004,Borgo a Mozzano,LU,10,29,0,0,0,29,34,0,0,0,34
2020,46004,Borgo a Mozzano,LU,11,28,0,0,0,28,24,0,0,0,24
2020,46004,Borgo a Mozzano,LU,12,19,0,0,0,19,23,0,0,0,23
2020,46004,Borgo a Mozzano,LU,13,26,0,0,0,26,33,0,0,0,33
2020,46004,Borgo a Mozzano,LU,14,28,0,0,0,28,29,0,0,0,29
2020,46004,Borgo a Mozzano,LU,15,28,0,0,0,28,30,0,0,0,30
2020,46004,Borgo a Mozzano,LU,16,29,0,0,0,29,31,0,0,0,31
2020,46004,Borgo a Mozzano,LU,17,31,0,0,0,31,27,0,0,0,27
2020,46004,Borgo a Mozzano,LU,18,31,0,0,0,31,31,0,0,0,31
2020,46004,Borgo a Mozzano,LU,19,23,0,0,0,23,30,1,0,0,31
2020,46004,Borgo a Mozzano,LU,20,36,0,0,0,36,18,0,0,0,18
2020,46004,Borgo a Mozzano,LU,21,29,1,0,0,30,29,1,0,0,30
2020,46004,Borgo a Mozzano,LU,22,35,0,0,0,35,31,1,0,0,32
2020,46004,Borgo a Mozzano,LU,23,28,1,0,0,29,41,1,0,0,42
2020,46004,Borgo a Mozzano,LU,24,27,0,0,0,27,25,0,0,0,25
2020,46004,Borgo a Mozzano,LU,25,34,0,0,0,34,29,0,0,0,29
2020,46004,Borgo a Mozzano,LU,26,27,0,0,0,27,22,2,0,0,24
2020,46004,Borgo a Mozzano,LU,27,32,0,0,0,32,18,4,0,0,22
2020,46004,Borgo a Mozzano,LU,28,32,2,0,0,34,32,3,0,0,35
2020,46004,Borgo a Mozzano,LU,29,42,0,0,0,42,22,5,0,0,27
2020,46004,Borgo a Mozzano,LU,30,22,5,0,0,27,25,7,0,0,32
2020,46004,Borgo a Mozzano,LU,31,33,5,1,0,39,17,11,0,0,28
2020,46004,Borgo a Mozzano,LU,32,27,3,0,0,30,23,13,0,0,36
2020,46004,Borgo a Mozzano,LU,33,26,8,1,0,35,14,18,0,0,32
2020,46004,Borgo a Mozzano,LU,34,10,12,0,0,22,17,13,0,0,30
2020,46004,Borgo a Mozzano,LU,35,34,13,0,0,47,13,22,0,1,36
2020,46004,Borgo a Mozzano,LU,36,26,20,0,0,46,16,23,0,0,39
2020,46004,Borgo a Mozzano,LU,37,18,8,0,0,26,7,28,0,0,35
2020,46004,Borgo a Mozzano,LU,38,22,22,0,0,44,13,18,1,0,32
2020,46004,Borgo a Mozzano,LU,39,18,12,0,0,30,12,16,4,0,32
2020,46004,Borgo a Mozzano,LU,40,9,10,3,0,22,14,19,1,0,34
2020,46004,Borgo a Mozzano,LU,41,20,24,2,0,46,7,16,1,0,24
2020,46004,Borgo a Mozzano,LU,42,13,12,2,0,27,10,29,0,0,39
2020,46004,Borgo a Mozzano,LU,43,25,23,1,0,49,11,32,1,0,44
2020,46004,Borgo a Mozzano,LU,44,21,36,1,0,58,13,32,1,0,46
2020,46004,Borgo a Mozzano,LU,45,21,39,3,0,63,19,28,5,1,53
2020,46004,Borgo a Mozzano,LU,46,17,25,2,1,45,10,37,3,0,50
2020,46004,Borgo a Mozzano,LU,47,19,35,5,0,59,16,32,1,1,50
2020,46004,Borgo a Mozzano,LU,48,22,27,6,0,55,14,38,5,2,59
2020,46004,Borgo a Mozzano,LU,49,22,36,5,0,63,12,47,5,2,66
2020,46004,Borgo a Mozzano,LU,50,27,46,2,0,75,9,47,3,1,60
2020,46004,Borgo a Mozzano,LU,51,13,45,2,0,60,10,32,5,1,48
2020,46004,Borgo a Mozzano,LU,52,13,47,3,0,63,9,42,5,0,56
2020,46004,Borgo a Mozzano,LU,53,15,32,8,0,55,2,47,6,3,58
2020,46004,Borgo a Mozzano,LU,54,13,44,2,1,60,5,41,8,1,55
2020,46004,Borgo a Mozzano,LU,55,6,40,2,2,50,10,45,5,4,64
2020,46004,Borgo a Mozzano,LU,56,12,40,5,2,59,4,42,4,2,52
2020,46004,Borgo a Mozzano,LU,57,15,44,2,0,61,4,44,1,2,51
2020,46004,Borgo a Mozzano,LU,58,5,50,3,1,59,3,48,2,1,54
2020,46004,Borgo a Mozzano,LU,59,6,48,5,0,59,6,48,6,5,65
2020,46004,Borgo a Mozzano,LU,60,10,42,6,0,58,6,39,3,0,48
2020,46004,Borgo a Mozzano,LU,61,10,41,4,0,55,2,48,3,3,56
2020,46004,Borgo a Mozzano,LU,62,3,44,3,1,51,5,37,1,5,48
2020,46004,Borgo a Mozzano,LU,63,3,40,1,1,45,3,36,2,4,45
2020,46004,Borgo a Mozzano,LU,64,11,36,3,2,52,5,25,2,3,35
2020,46004,Borgo a Mozzano,LU,65,4,40,4,3,51,1,25,3,10,39
2020,46004,Borgo a Mozzano,LU,66,6,28,3,0,37,2,25,6,6,39
2020,46004,Borgo a Mozzano,LU,67,4,29,1,0,34,3,32,0,9,44
2020,46004,Borgo a Mozzano,LU,68,8,36,0,1,45,4,35,2,4,45
2020,46004,Borgo a Mozzano,LU,69,7,36,3,1,47,0,30,2,9,41
2020,46004,Borgo a Mozzano,LU,70,4,22,1,3,30,3,30,3,8,44
2020,46004,Borgo a Mozzano,LU,71,1,28,4,3,36,1,33,0,13,47
2020,46004,Borgo a Mozzano,LU,72,2,41,2,3,48,1,28,3,8,40
2020,46004,Borgo a Mozzano,LU,73,2,30,2,5,39,0,33,0,18,51
2020,46004,Borgo a Mozzano,LU,74,3,41,0,2,46,0,36,3,25,64
2020,46004,Borgo a Mozzano,LU,75,5,23,1,4,33,3,27,1,15,46
2020,46004,Borgo a Mozzano,LU,76,3,22,0,2,27,1,17,0,15,33
2020,46004,Borgo a Mozzano,LU,77,4,34,0,1,39,0,11,0,18,29
2020,46004,Borgo a Mozzano,LU,78,4,27,1,4,36,2,20,1,17,40
2020,46004,Borgo a Mozzano,LU,79,1,23,0,4,28,2,13,0,20,35
2020,46004,Borgo a Mozzano,LU,80,2,17,0,7,26,0,23,0,18,41
2020,46004,Borgo a Mozzano,LU,81,3,25,2,1,31,4,9,0,27,40
2020,46004,Borgo a Mozzano,LU,82,0,18,1,5,24,2,8,0,19,29
2020,46004,Borgo a Mozzano,LU,83,2,13,0,4,19,0,8,0,29,37
2020,46004,Borgo a Mozzano,LU,84,3,11,0,3,17,2,9,0,21,32
2020,46004,Borgo a Mozzano,LU,85,3,11,0,3,17,3,5,0,17,25
2020,46004,Borgo a Mozzano,LU,86,1,12,0,2,15,2,5,0,21,28
2020,46004,Borgo a Mozzano,LU,87,1,9,0,7,17,2,5,0,25,32
2020,46004,Borgo a Mozzano,LU,88,1,5,0,5,11,1,1,0,16,18
2020,46004,Borgo a Mozzano,LU,89,2,2,0,3,7,5,2,0,18,25
2020,46004,Borgo a Mozzano,LU,90,0,5,0,2,7,2,3,0,14,19
2020,46004,Borgo a Mozzano,LU,91,0,3,1,3,7,0,2,0,14,16
2020,46004,Borgo a Mozzano,LU,92,0,1,0,1,2,1,3,0,11,15
2020,46004,Borgo a Mozzano,LU,93,0,0,0,3,3,2,0,0,10,12
2020,46004,Borgo a Mozzano,LU,94,0,2,0,0,2,0,0,0,3,3
2020,46004,Borgo a Mozzano,LU,95,0,0,0,2,2,3,0,0,7,10
2020,46004,Borgo a Mozzano,LU,96,0,0,0,1,1,0,0,0,5,5
2020,46004,Borgo a Mozzano,LU,97,0,0,0,0,0,0,0,0,3,3
2020,46004,Borgo a Mozzano,LU,98,1,1,0,0,2,0,0,0,2,2
2020,46004,Borgo a Mozzano,LU,99,0,0,0,0,0,0,0,0,1,1
2020,46004,Borgo a Mozzano,LU,100 e più,0,0,0,0,0,0,0,0,0,0
2020,46005,Camaiore,LU,0,95,0,0,0,95,83,0,0,0,83
2020,46005,Camaiore,LU,1,103,0,0,0,103,95,0,0,0,95
2020,46005,Camaiore,LU,2,96,0,0,0,96,93,0,0,0,93
2020,46005,Camaiore,LU,3,100,0,0,0,100,80,0,0,0,80
2020,46005,Camaiore,LU,4,101,0,0,0,101,109,0,0,0,109
2020,46005,Camaiore,LU,5,112,0,0,0,112,99,0,0,0,99
2020,46005,Camaiore,LU,6,108,0,0,0,108,111,0,0,0,111
2020,46005,Camaiore,LU,7,113,0,0,0,113,108,0,0,0,108
2020,46005,Camaiore,LU,8,123,0,0,0,123,121,0,0,0,121
2020,46005,Camaiore,LU,9,128,0,0,0,128,124,0,0,0,124
2020,46005,Camaiore,LU,10,142,0,0,0,142,123,0,0,0,123
2020,46005,Camaiore,LU,11,146,0,0,0,146,131,0,0,0,131
2020,46005,Camaiore,LU,12,163,0,0,0,163,144,0,0,0,144
2020,46005,Camaiore,LU,13,150,0,0,0,150,139,0,0,0,139
2020,46005,Camaiore,LU,14,171,0,0,0,171,131,0,0,0,131
2020,46005,Camaiore,LU,15,163,0,0,0,163,113,0,0,0,113
2020,46005,Camaiore,LU,16,120,0,0,0,120,135,0,0,0,135
2020,46005,Camaiore,LU,17,143,0,0,0,143,145,0,0,0,145
2020,46005,Camaiore,LU,18,129,0,0,0,129,133,0,0,0,133
2020,46005,Camaiore,LU,19,149,0,0,0,149,128,0,0,0,128
2020,46005,Camaiore,LU,20,142,0,0,0,142,128,0,0,0,128
2020,46005,Camaiore,LU,21,148,0,0,0,148,121,0,0,0,121
2020,46005,Camaiore,LU,22,134,0,0,0,134,136,1,0,0,137
2020,46005,Camaiore,LU,23,146,0,0,0,146,133,2,0,0,135
2020,46005,Camaiore,LU,24,154,0,0,0,155,150,4,0,1,155
2020,46005,Camaiore,LU,25,146,0,0,0,146,113,5,0,0,118
2020,46005,Camaiore,LU,26,145,1,0,0,146,125,8,0,0,133
2020,46005,Camaiore,LU,27,127,5,0,0,132,131,12,1,0,144
2020,46005,Camaiore,LU,28,154,6,0,0,160,144,20,0,0,164
2020,46005,Camaiore,LU,29,137,13,0,0,150,121,25,0,0,146
2020,46005,Camaiore,LU,30,140,15,1,0,156,109,33,1,0,143
2020,46005,Camaiore,LU,31,119,21,1,0,141,101,49,2,0,152
2020,46005,Camaiore,LU,32,127,28,3,0,158,111,41,3,0,155
2020,46005,Camaiore,LU,33,132,33,2,0,167,99,63,3,0,165
2020,46005,Camaiore,LU,34,111,52,1,0,164,87,62,3,0,152
2020,46005,Camaiore,LU,35,114,46,2,0,162,98,79,5,1,184
2020,46005,Camaiore,LU,36,105,58,1,0,164,89,72,6,0,168
2020,46005,Camaiore,LU,37,80,58,3,0,141,86,93,9,2,191
2020,46005,Camaiore,LU,38,104,67,6,0,178,72,104,6,2,184
2020,46005,Camaiore,LU,39,89,78,7,0,174,63,100,8,0,172
2020,46005,Camaiore,LU,40,101,93,8,1,203,71,108,15,1,196
2020,46005,Camaiore,LU,41,73,85,13,0,172,68,119,10,0,197
2020,46005,Camaiore,LU,42,70,105,9,0,185,66,132,16,1,215
2020,46005,Camaiore,LU,43,100,101,9,0,210,50,128,13,3,196
2020,46005,Camaiore,LU,44,96,141,13,0,250,72,170,20,2,264
2020,46005,Camaiore,LU,45,102,130,11,1,247,68,148,31,2,249
2020,46005,Camaiore,LU,46,91,130,18,0,242,58,161,15,5,240
2020,46005,Camaiore,LU,47,111,168,15,1,295,54,180,26,2,264
2020,46005,Camaiore,LU,48,78,147,24,0,249,42,176,44,4,266
2020,46005,Camaiore,LU,49,85,155,22,0,263,62,203,37,4,306
2020,46005,Camaiore,LU,50,79,159,19,2,259,52,196,34,5,288
2020,46005,Camaiore,LU,51,70,154,30,1,255,49,187,28,5,269
2020,46005,Camaiore,LU,52,68,185,28,2,283,58,199,28,7,293
2020,46005,Camaiore,LU,53,51,176,25,1,253,44,207,42,11,304
2020,46005,Camaiore,LU,54,57,180,27,3,268,42,192,35,15,284
2020,46005,Camaiore,LU,55,57,202,21,3,284,43,234,38,20,336
2020,46005,Camaiore,LU,56,52,184,28,1,265,34,232,45,21,332
2020,46005,Camaiore,LU,57,47,213,22,5,287,29,198,31,17,275
2020,46005,Camaiore,LU,58,36,193,29,2,261,14,176,37,21,248
2020,46005,Camaiore,LU,59,40,169,25,3,237,25,188,33,22,268
2020,46005,Camaiore,LU,60,33,197,31,10,273,27,192,38,24,281
2020,46005,Camaiore,LU,61,27,171,18,0,218,18,173,30,28,249
2020,46005,Camaiore,LU,62,29,188,23,8,249,13,164,22,20,219
2020,46005,Camaiore,LU,63,18,155,25,4,202,18,149,22,17,206
2020,46005,Camaiore,LU,64,27,170,14,6,217,8,160,21,23,212
2020,46005,Camaiore,LU,65,20,139,23,5,188,12,152,18,18,200
2020,46005,Camaiore,LU,66,19,155,20,6,200,17,128,22,43,210
2020,46005,Camaiore,LU,67,19,156,11,7,193,10,143,14,29,196
2020,46005,Camaiore,LU,68,18,151,13,8,190,9,134,8,35,186
2020,46005,Camaiore,LU,69,16,146,18,6,187,11,149,6,43,209
2020,46005,Camaiore,LU,70,12,123,10,7,153,7,119,14,38,178
2020,46005,Camaiore,LU,71,12,129,13,8,163,10,122,9,45,186
2020,46005,Camaiore,LU,72,15,163,9,9,196,14,146,9,61,230
2020,46005,Camaiore,LU,73,13,134,8,13,169,10,144,9,51,214
2020,46005,Camaiore,LU,74,22,181,7,19,229,7,122,7,73,209
2020,46005,Camaiore,LU,75,13,115,8,10,146,2,81,17,63,163
2020,46005,Camaiore,LU,76,8,117,7,10,142,9,89,6,68,172
2020,46005,Camaiore,LU,77,14,83,8,15,120,5,99,9,77,190
2020,46005,Camaiore,LU,78,8,101,5,19,133,2,82,10,75,169
2020,46005,Camaiore,LU,79,12,125,3,14,154,8,81,5,74,168
2020,46005,Camaiore,LU,80,13,104,2,16,135,4,76,7,95,182
2020,46005,Camaiore,LU,81,10,105,4,15,134,7,73,4,88,172
2020,46005,Camaiore,LU,82,5,97,5,19,126,3,68,6,104,181
2020,46005,Camaiore,LU,83,10,72,1,17,100,4,37,4,81,126
2020,46005,Camaiore,LU,84,4,65,2,20,91,5,37,10,105,157
2020,46005,Camaiore,LU,85,12,51,1,14,78,5,33,3,101,142
2020,46005,Camaiore,LU,86,3,44,1,22,70,9,22,4,79,114
2020,46005,Camaiore,LU,87,3,38,2,16,59,7,17,1,82,107
2020,46005,Camaiore,LU,88,3,29,0,13,45,4,15,2,83,104
2020,46005,Camaiore,LU,89,2,29,1,14,46,5,8,2,60,75
2020,46005,Camaiore,LU,90,0,22,1,9,32,8,10,2,52,72
2020,46005,Camaiore,LU,91,4,13,0,10,27,5,4,0,48,57
2020,46005,Camaiore,LU,92,0,11,1,7,19,5,3,1,46,55
2020,46005,Camaiore,LU,93,1,8,0,5,14,6,1,1,42,50
2020,46005,Camaiore,LU,94,0,2,0,4,6,1,1,1,35,38
2020,46005,Camaiore,LU,95,2,1,0,4,7,3,0,1,27,31
2020,46005,Camaiore,LU,96,0,2,0,2,4,3,1,0,19,23
2020,46005,Camaiore,LU,97,0,3,0,3,6,0,0,0,15,15
2020,46005,Camaiore,LU,98,0,0,0,2,2,0,1,0,10,11
2020,46005,Camaiore,LU,99,0,0,0,1,1,0,0,0,4,4
2020,46005,Camaiore,LU,100 e più,0,0,0,1,1,0,0,0,4,4
2020,46006,Camporgiano,LU,0,5,0,0,0,5,6,0,0,0,6
2020,46006,Camporgiano,LU,1,3,0,0,0,3,6,0,0,0,6
2020,46006,Camporgiano,LU,2,4,0,0,0,4,3,0,0,0,3
2020,46006,Camporgiano,LU,3,7,0,0,0,7,7,0,0,0,7
2020,46006,Camporgiano,LU,4,3,0,0,0,3,5,0,0,0,5
2020,46006,Camporgiano,LU,5,4,0,0,0,4,8,0,0,0,8
2020,46006,Camporgiano,LU,6,4,0,0,0,4,5,0,0,0,5
2020,46006,Camporgiano,LU,7,10,0,0,0,10,5,0,0,0,5
2020,46006,Camporgiano,LU,8,10,0,0,0,10,4,0,0,0,4
2020,46006,Camporgiano,LU,9,6,0,0,0,6,7,0,0,0,7
2020,46006,Camporgiano,LU,10,11,0,0,0,11,9,0,0,0,9
2020,46006,Camporgiano,LU,11,8,0,0,0,8,8,0,0,0,8
2020,46006,Camporgiano,LU,12,8,0,0,0,8,14,0,0,0,14
2020,46006,Camporgiano,LU,13,12,0,0,0,12,11,0,0,0,11
2020,46006,Camporgiano,LU,14,10,0,0,0,10,5,0,0,0,5
2020,46006,Camporgiano,LU,15,8,0,0,0,8,10,0,0,0,10
2020,46006,Camporgiano,LU,16,3,0,0,0,3,7,0,0,0,7
2020,46006,Camporgiano,LU,17,12,0,0,0,12,5,0,0,0,5
2020,46006,Camporgiano,LU,18,9,0,0,0,9,6,0,0,0,6
2020,46006,Camporgiano,LU,19,11,0,0,0,11,5,0,0,0,5
2020,46006,Camporgiano,LU,20,6,0,0,0,6,13,0,0,0,13
2020,46006,Camporgiano,LU,21,6,0,0,0,6,5,0,0,0,5
2020,46006,Camporgiano,LU,22,13,0,0,0,13,12,0,0,0,12
2020,46006,Camporgiano,LU,23,15,0,0,0,15,7,0,0,0,7
2020,46006,Camporgiano,LU,24,12,0,0,0,12,4,0,0,0,4
2020,46006,Camporgiano,LU,25,13,0,0,0,13,7,0,0,0,7
2020,46006,Camporgiano,LU,26,4,0,0,0,4,9,0,0,0,9
2020,46006,Camporgiano,LU,27,5,0,0,0,5,6,2,0,0,8
2020,46006,Camporgiano,LU,28,5,0,0,0,5,11,0,0,0,11
2020,46006,Camporgiano,LU,29,5,0,0,0,5,0,2,0,0,2
2020,46006,Camporgiano,LU,30,10,2,0,0,12,6,1,0,0,7
2020,46006,Camporgiano,LU,31,9,3,0,0,12,7,1,0,0,8
2020,46006,Camporgiano,LU,32,2,1,0,0,3,2,3,0,0,5
2020,46006,Camporgiano,LU,33,2,3,0,0,5,2,3,0,0,5
2020,46006,Camporgiano,LU,34,9,0,0,0,9,8,5,0,0,13
2020,46006,Camporgiano,LU,35,6,5,0,0,11,5,5,0,0,10
2020,46006,Camporgiano,LU,36,8,2,0,0,10,5,7,0,0,12
2020,46006,Camporgiano,LU,37,3,1,0,0,4,5,3,1,0,9
2020,46006,Camporgiano,LU,38,2,6,0,0,8,1,4,0,0,5
2020,46006,Camporgiano,LU,39,6,2,0,0,8,4,7,0,0,11
2020,46006,Camporgiano,LU,40,9,8,0,0,17,6,7,0,0,13
2020,46006,Camporgiano,LU,41,5,5,1,0,11,4,6,1,0,11
2020,46006,Camporgiano,LU,42,9,6,2,0,17,4,6,1,0,11
2020,46006,Camporgiano,LU,43,9,7,0,0,16,1,12,0,0,13
2020,46006,Camporgiano,LU,44,5,9,0,1,15,5,12,1,0,18
2020,46006,Camporgiano,LU,45,13,13,0,0,26,6,13,1,0,20
2020,46006,Camporgiano,LU,46,7,10,0,0,17,0,14,0,0,14
2020,46006,Camporgiano,LU,47,6,13,1,0,20,4,8,1,0,13
2020,46006,Camporgiano,LU,48,3,16,1,0,20,5,10,1,0,16
2020,46006,Camporgiano,LU,49,4,16,1,0,21,2,13,1,0,16
2020,46006,Camporgiano,LU,50,3,10,0,0,13,2,11,0,0,13
2020,46006,Camporgiano,LU,51,5,7,1,0,13,3,9,0,0,12
2020,46006,Camporgiano,LU,52,1,13,1,0,15,1,13,0,0,14
2020,46006,Camporgiano,LU,53,2,6,0,2,10,0,17,2,0,19
2020,46006,Camporgiano,LU,54,2,16,1,0,19,0,9,2,0,11
2020,46006,Camporgiano,LU,55,3,21,0,0,24,2,14,3,1,20
2020,46006,Camporgiano,LU,56,7,15,1,1,24,2,21,0,1,24
2020,46006,Camporgiano,LU,57,4,15,4,0,23,1,8,1,0,10
2020,46006,Camporgiano,LU,58,3,7,0,0,10,1,7,0,2,10
2020,46006,Camporgiano,LU,59,1,11,0,1,13,1,13,2,0,16
2020,46006,Camporgiano,LU,60,2,12,2,0,16,2,11,1,1,15
2020,46006,Camporgiano,LU,61,1,9,1,0,11,2,8,1,2,13
2020,46006,Camporgiano,LU,62,3,5,0,2,10,3,13,1,0,17
2020,46006,Camporgiano,LU,63,5,7,0,0,12,2,5,0,2,9
2020,46006,Camporgiano,LU,64,5,8,0,0,13,0,13,0,2,15
2020,46006,Camporgiano,LU,65,2,10,0,0,12,1,15,0,3,19
2020,46006,Camporgiano,LU,66,1,10,1,0,12,1,14,0,1,16
2020,46006,Camporgiano,LU,67,0,8,1,1,10,1,8,2,2,13
2020,46006,Camporgiano,LU,68,0,17,2,0,19,1,9,1,5,16
2020,46006,Camporgiano,LU,69,0,9,2,0,11,2,9,1,1,13
2020,46006,Camporgiano,LU,70,2,14,0,1,17,0,13,0,1,14
2020,46006,Camporgiano,LU,71,2,11,0,1,14,0,10,0,9,19
2020,46006,Camporgiano,LU,72,4,17,1,0,22,0,10,0,2,12
2020,46006,Camporgiano,LU,73,4,6,0,1,11,1,12,0,9,22
2020,46006,Camporgiano,LU,74,2,11,0,3,16,2,8,0,2,12
2020,46006,Camporgiano,LU,75,0,9,0,1,10,1,9,0,4,14
2020,46006,Camporgiano,LU,76,2,7,1,1,11,0,4,0,6,10
2020,46006,Camporgiano,LU,77,1,14,0,1,16,0,9,0,1,10
2020,46006,Camporgiano,LU,78,0,14,1,1,16,0,12,1,7,20
2020,46006,Camporgiano,LU,79,0,11,0,0,11,1,5,0,5,11
2020,46006,Camporgiano,LU,80,1,11,0,3,15,1,13,0,5,19
2020,46006,Camporgiano,LU,81,2,6,0,2,10,0,7,0,4,11
2020,46006,Camporgiano,LU,82,0,7,0,2,9,1,6,0,6,13
2020,46006,Camporgiano,LU,83,0,7,0,3,10,0,8,0,7,15
2020,46006,Camporgiano,LU,84,2,5,0,2,9,2,4,0,5,11
2020,46006,Camporgiano,LU,85,0,9,0,1,10,0,1,0,5,6
2020,46006,Camporgiano,LU,86,1,4,0,2,7,2,3,0,7,12
2020,46006,Camporgiano,LU,87,0,5,0,1,6,0,5,0,7,12
2020,46006,Camporgiano,LU,88,0,5,0,2,7,0,0,0,6,6
2020,46006,Camporgiano,LU,89,0,3,0,0,3,0,4,0,6,10
2020,46006,Camporgiano,LU,90,0,5,0,1,6,0,0,0,8,8
2020,46006,Camporgiano,LU,91,0,4,0,0,4,0,0,0,6,6
2020,46006,Camporgiano,LU,92,0,0,0,2,2,0,0,0,2,2
2020,46006,Camporgiano,LU,93,1,1,0,1,3,0,1,1,4,6
2020,46006,Camporgiano,LU,94,0,0,0,1,1,0,0,0,3,3
2020,46006,Camporgiano,LU,95,0,1,0,0,1,0,0,0,2,2
2020,46006,Camporgiano,LU,96,0,0,0,0,0,1,1,0,2,4
2020,46006,Camporgiano,LU,97,0,0,0,0,0,0,0,0,2,2
2020,46006,Camporgiano,LU,98,0,0,0,0,0,0,0,0,0,0
2020,46006,Camporgiano,LU,99,0,0,0,0,0,0,0,0,0,0
2020,46006,Camporgiano,LU,100 e più,0,0,0,0,0,0,0,0,0,0
2020,46007,Capannori,LU,0,133,0,0,0,133,131,0,0,0,131
2020,46007,Capannori,LU,1,191,0,0,0,191,149,0,0,0,149
2020,46007,Capannori,LU,2,177,0,0,0,177,156,0,0,0,156
2020,46007,Capannori,LU,3,175,0,0,0,175,182,0,0,0,182
2020,46007,Capannori,LU,4,201,0,0,0,201,189,0,0,0,189
2020,46007,Capannori,LU,5,189,0,0,0,189,192,0,0,0,192
2020,46007,Capannori,LU,6,210,0,0,0,210,170,0,0,0,170
2020,46007,Capannori,LU,7,241,0,0,0,241,211,0,0,0,211
2020,46007,Capannori,LU,8,258,0,0,0,258,236,0,0,0,236
2020,46007,Capannori,LU,9,225,0,0,0,225,210,0,0,0,210
2020,46007,Capannori,LU,10,255,0,0,0,255,216,0,0,0,216
2020,46007,Capannori,LU,11,214,0,0,0,214,206,0,0,0,206
2020,46007,Capannori,LU,12,260,0,0,0,260,256,0,0,0,256
2020,46007,Capannori,LU,13,258,0,0,0,258,248,0,0,0,248
2020,46007,Capannori,LU,14,233,0,0,0,233,233,0,0,0,233
2020,46007,Capannori,LU,15,250,0,0,0,250,210,0,0,0,210
2020,46007,Capannori,LU,16,204,0,0,0,204,200,0,0,0,200
2020,46007,Capannori,LU,17,250,0,0,0,250,232,0,0,0,232
2020,46007,Capannori,LU,18,233,0,0,0,233,198,0,0,0,198
2020,46007,Capannori,LU,19,242,0,0,0,242,191,1,0,0,192
2020,46007,Capannori,LU,20,238,0,0,0,238,192,2,0,0,194
2020,46007,Capannori,LU,21,238,0,0,0,238,195,2,0,0,197
2020,46007,Capannori,LU,22,231,0,0,0,231,184,5,0,0,189
2020,46007,Capannori,LU,23,213,3,0,0,216,183,7,0,0,190
2020,46007,Capannori,LU,24,233,2,0,0,235,169,7,0,0,176
2020,46007,Capannori,LU,25,218,7,1,0,226,168,12,0,0,180
2020,46007,Capannori,LU,26,207,8,0,0,215,162,28,0,0,190
2020,46007,Capannori,LU,27,213,7,0,0,220,151,22,1,0,174
2020,46007,Capannori,LU,28,201,11,0,0,212,169,41,2,0,212
2020,46007,Capannori,LU,29,195,19,0,0,214,152,55,1,0,209
2020,46007,Capannori,LU,30,198,32,1,0,231,136,59,4,0,199
2020,46007,Capannori,LU,31,160,29,1,0,190,141,75,4,1,222
2020,46007,Capannori,LU,32,160,53,0,0,213,149,93,0,0,242
2020,46007,Capannori,LU,33,147,63,0,0,210,98,102,5,0,207
2020,46007,Capannori,LU,34,151,88,3,1,243,101,105,7,0,214
2020,46007,Capannori,LU,35,136,81,2,0,219,118,129,6,0,254
2020,46007,Capannori,LU,36,124,98,5,0,228,88,134,7,2,232
2020,46007,Capannori,LU,37,133,105,8,0,247,101,149,13,1,264
2020,46007,Capannori,LU,38,137,103,4,0,244,103,159,8,2,273
2020,46007,Capannori,LU,39,130,141,8,0,279,101,185,18,1,305
2020,46007,Capannori,LU,40,124,154,15,0,293,93,183,13,2,292
2020,46007,Capannori,LU,41,131,146,9,1,287,94,194,18,3,309
2020,46007,Capannori,LU,42,136,187,8,0,332,101,216,16,2,336
2020,46007,Capannori,LU,43,150,208,17,0,375,103,227,24,2,356
2020,46007,Capannori,LU,44,115,210,9,0,335,110,222,14,3,350
2020,46007,Capannori,LU,45,126,227,8,1,363,89,254,29,1,373
2020,46007,Capannori,LU,46,137,231,25,3,396,102,265,37,4,408
2020,46007,Capannori,LU,47,128,267,23,1,419,81,312,31,4,428
2020,46007,Capannori,LU,48,115,278,24,0,418,71,306,34,6,418
2020,46007,Capannori,LU,49,90,269,32,0,392,63,269,44,7,383
2020,46007,Capannori,LU,50,119,280,34,1,435,47,288,40,6,381
2020,46007,Capannori,LU,51,87,290,30,2,412,48,310,43,12,413
2020,46007,Capannori,LU,52,75,292,33,0,400,42,268,27,10,347
2020,46007,Capannori,LU,53,79,268,34,3,385,41,285,45,7,378
2020,46007,Capannori,LU,54,73,241,30,5,350,47,291,39,6,383
2020,46007,Capannori,LU,55,54,294,36,2,386,34,287,32,12,365
2020,46007,Capannori,LU,56,55,292,31,5,383,41,284,30,19,375
2020,46007,Capannori,LU,57,46,275,20,3,346,30,264,43,14,351
2020,46007,Capannori,LU,58,46,230,24,8,308,24,241,28,17,311
2020,46007,Capannori,LU,59,38,247,15,3,303,17,256,32,19,325
2020,46007,Capannori,LU,60,37,284,25,10,356,25,233,21,19,298
2020,46007,Capannori,LU,61,36,245,13,4,299,26,256,22,18,323
2020,46007,Capannori,LU,62,36,213,20,6,275,28,251,21,15,315
2020,46007,Capannori,LU,63,19,205,24,5,253,15,234,21,27,297
2020,46007,Capannori,LU,64,23,230,18,4,276,21,224,16,25,286
2020,46007,Capannori,LU,65,24,200,15,11,250,16,209,15,27,268
2020,46007,Capannori,LU,66,18,230,15,11,274,9,217,16,42,284
2020,46007,Capannori,LU,67,25,220,14,13,272,13,182,27,34,256
2020,46007,Capannori,LU,68,22,185,11,9,227,4,256,16,42,318
2020,46007,Capannori,LU,69,25,187,13,13,239,6,201,15,52,274
2020,46007,Capannori,LU,70,24,215,7,10,256,12,204,12,60,288
2020,46007,Capannori,LU,71,24,219,12,9,264,7,197,12,67,283
2020,46007,Capannori,LU,72,26,229,10,20,285,9,206,13,76,304
2020,46007,Capannori,LU,73,13,242,11,15,281,14,187,13,89,303
2020,46007,Capannori,LU,74,17,241,4,30,292,11,201,9,74,296
2020,46007,Capannori,LU,75,14,161,10,25,210,10,148,11,72,241
2020,46007,Capannori,LU,76,19,177,1,21,218,11,138,6,81,237
2020,46007,Capannori,LU,77,12,189,7,20,228,9,141,4,88,242
2020,46007,Capannori,LU,78,7,143,1,25,176,13,124,4,103,244
2020,46007,Capannori,LU,79,18,159,4,16,197,9,119,6,91,225
2020,46007,Capannori,LU,80,20,149,2,29,200,14,116,6,116,252
2020,46007,Capannori,LU,81,16,141,0,25,182,10,101,2,123,236
2020,46007,Capannori,LU,82,12,147,3,33,195,9,85,5,140,239
2020,46007,Capannori,LU,83,16,103,2,22,143,12,55,3,127,197
2020,46007,Capannori,LU,84,11,105,1,37,154,10,45,2,98,156
2020,46007,Capannori,LU,85,7,92,1,36,136,13,55,2,111,181
2020,46007,Capannori,LU,86,8,68,2,28,106,7,20,2,129,158
2020,46007,Capannori,LU,87,10,50,0,16,76,9,20,0,112,141
2020,46007,Capannori,LU,88,3,45,0,19,67,11,18,2,112,143
2020,46007,Capannori,LU,89,6,27,0,15,48,13,14,0,90,117
2020,46007,Capannori,LU,90,5,24,1,13,43,4,14,0,84,102
2020,46007,Capannori,LU,91,5,18,0,11,34,7,5,0,78,90
2020,46007,Capannori,LU,92,4,13,0,8,25,6,6,0,67,79
2020,46007,Capannori,LU,93,3,9,0,19,31,4,2,1,48,55
2020,46007,Capannori,LU,94,1,6,0,7,14,7,1,1,51,60
2020,46007,Capannori,LU,95,1,6,0,3,10,2,2,0,24,28
2020,46007,Capannori,LU,96,1,3,0,5,9,3,0,0,23,26
2020,46007,Capannori,LU,97,1,4,0,3,8,0,0,0,13,13
2020,46007,Capannori,LU,98,0,0,0,1,1,0,0,0,14,14
2020,46007,Capannori,LU,99,0,0,0,1,1,0,0,0,13,13
2020,46007,Capannori,LU,100 e più,0,0,0,1,1,0,0,0,7,7
2020,46008,Careggine,LU,0,0,0,0,0,0,0,0,0,0,0
2020,46008,Careggine,LU,1,1,0,0,0,1,1,0,0,0,1
2020,46008,Careggine,LU,2,1,0,0,0,1,3,0,0,0,3
2020,46008,Careggine,LU,3,2,0,0,0,2,2,0,0,0,2
2020,46008,Careggine,LU,4,0,0,0,0,0,1,0,0,0,1
2020,46008,Careggine,LU,5,1,0,0,0,1,2,0,0,0,2
2020,46008,Careggine,LU,6,1,0,0,0,1,1,0,0,0,1
2020,46008,Careggine,LU,7,2,0,0,0,2,2,0,0,0,2
2020,46008,Careggine,LU,8,2,0,0,0,2,2,0,0,0,2
2020,46008,Careggine,LU,9,1,0,0,0,1,1,0,0,0,1
2020,46008,Careggine,LU,10,5,0,0,0,5,2,0,0,0,2
2020,46008,Careggine,LU,11,0,0,0,0,0,2,0,0,0,2
2020,46008,Careggine,LU,12,0,0,0,0,0,1,0,0,0,1
2020,46008,Careggine,LU,13,2,0,0,0,2,5,0,0,0,5
2020,46008,Careggine,LU,14,1,0,0,0,1,2,0,0,0,2
2020,46008,Careggine,LU,15,4,0,0,0,4,1,0,0,0,1
2020,46008,Careggine,LU,16,2,0,0,0,2,1,0,0,0,1
2020,46008,Careggine,LU,17,1,0,0,0,1,1,0,0,0,1
2020,46008,Careggine,LU,18,0,0,0,0,0,0,0,0,0,0
2020,46008,Careggine,LU,19,2,0,0,0,2,1,0,0,0,1
2020,46008,Careggine,LU,20,3,0,0,0,3,5,0,0,0,5
2020,46008,Careggine,LU,21,2,0,0,0,2,2,0,0,0,2
2020,46008,Careggine,LU,22,2,0,0,0,2,0,0,0,0,0
2020,46008,Careggine,LU,23,2,0,0,0,2,0,0,0,0,0
2020,46008,Careggine,LU,24,1,0,0,0,1,3,0,0,0,3
2020,46008,Careggine,LU,25,4,0,0,0,4,0,0,0,0,0
2020,46008,Careggine,LU,26,0,0,0,0,0,2,0,0,0,2
2020,46008,Careggine,LU,27,2,0,0,0,2,0,0,0,0,0
2020,46008,Careggine,LU,28,1,0,0,0,1,0,1,0,0,1
2020,46008,Careggine,LU,29,2,0,0,0,2,2,0,0,0,2
2020,46008,Careggine,LU,30,1,0,0,0,1,0,0,0,0,0
2020,46008,Careggine,LU,31,1,0,0,0,1,1,0,0,0,1
2020,46008,Careggine,LU,32,1,1,0,0,2,1,1,0,0,2
2020,46008,Careggine,LU,33,1,0,0,0,1,2,0,0,0,2
2020,46008,Careggine,LU,34,2,1,0,0,3,1,1,0,0,2
2020,46008,Careggine,LU,35,1,0,0,0,1,1,2,0,0,3
2020,46008,Careggine,LU,36,0,0,0,0,0,2,2,0,0,4
2020,46008,Careggine,LU,37,3,0,0,0,3,0,1,0,0,1
2020,46008,Careggine,LU,38,1,2,0,0,3,1,1,0,0,2
2020,46008,Careggine,LU,39,2,1,1,0,4,3,0,0,0,3
2020,46008,Careggine,LU,40,1,1,0,0,2,1,3,0,0,4
2020,46008,Careggine,LU,41,3,0,0,0,3,2,1,0,0,3
2020,46008,Careggine,LU,42,1,1,0,0,2,2,3,0,0,5
2020,46008,Careggine,LU,43,2,2,1,0,5,1,2,0,0,3
2020,46008,Careggine,LU,44,2,3,0,0,5,0,3,2,0,5
2020,46008,Careggine,LU,45,1,0,0,0,1,2,3,0,0,5
2020,46008,Careggine,LU,46,1,2,0,0,3,0,2,0,0,2
2020,46008,Careggine,LU,47,3,2,0,0,5,2,3,1,0,6
2020,46008,Careggine,LU,48,3,4,0,0,7,2,1,0,0,3
2020,46008,Careggine,LU,49,1,5,0,0,6,1,4,0,0,5
2020,46008,Careggine,LU,50,1,4,0,0,5,1,2,1,0,4
2020,46008,Careggine,LU,51,4,1,0,0,5,0,2,0,0,2
2020,46008,Careggine,LU,52,2,3,1,0,6,0,1,0,0,1
2020,46008,Careggine,LU,53,1,3,0,0,4,2,4,0,0,6
2020,46008,Careggine,LU,54,3,0,1,0,4,0,1,0,0,1
2020,46008,Careggine,LU,55,0,5,1,0,6,0,2,0,0,2
2020,46008,Careggine,LU,56,3,1,0,0,4,0,7,0,0,7
2020,46008,Careggine,LU,57,0,2,1,0,3,1,2,0,0,3
2020,46008,Careggine,LU,58,3,3,0,0,6,0,4,0,1,5
2020,46008,Careggine,LU,59,2,2,1,0,5,0,1,0,0,1
2020,46008,Careggine,LU,60,2,2,0,0,4,0,0,0,0,0
2020,46008,Careggine,LU,61,1,1,0,0,2,0,3,0,1,4
2020,46008,Careggine,LU,62,0,4,1,0,5,0,5,1,0,6
2020,46008,Careggine,LU,63,1,4,0,0,5,0,5,0,0,5
2020,46008,Careggine,LU,64,2,4,0,1,7,0,4,1,0,5
2020,46008,Careggine,LU,65,1,6,0,0,7,1,3,0,1,5
2020,46008,Careggine,LU,66,1,1,0,0,2,0,1,0,1,2
2020,46008,Careggine,LU,67,2,3,0,0,5,0,3,0,0,3
2020,46008,Careggine,LU,68,2,5,0,0,7,0,3,0,1,4
2020,46008,Careggine,LU,69,0,2,0,0,2,0,5,0,2,7
2020,46008,Careggine,LU,70,1,0,0,0,1,0,3,0,0,3
2020,46008,Careggine,LU,71,0,3,0,1,4,1,3,0,1,5
2020,46008,Careggine,LU,72,2,6,0,0,8,0,3,0,0,3
2020,46008,Careggine,LU,73,2,2,0,1,5,1,3,0,0,4
2020,46008,Careggine,LU,74,1,2,0,0,3,0,3,1,2,6
2020,46008,Careggine,LU,75,0,3,0,0,3,1,2,0,1,4
2020,46008,Careggine,LU,76,0,2,0,1,3,0,0,0,2,2
2020,46008,Careggine,LU,77,2,3,0,0,5,0,2,0,1,3
2020,46008,Careggine,LU,78,2,0,0,1,3,0,2,0,2,4
2020,46008,Careggine,LU,79,2,3,0,0,5,0,1,0,2,3
2020,46008,Careggine,LU,80,3,3,0,0,6,0,1,0,3,4
2020,46008,Careggine,LU,81,0,2,0,0,2,0,2,0,5,7
2020,46008,Careggine,LU,82,1,3,0,0,4,0,2,0,3,5
2020,46008,Careggine,LU,83,0,3,0,0,3,0,0,0,2,2
2020,46008,Careggine,LU,84,0,2,0,0,2,0,0,0,5,5
2020,46008,Careggine,LU,85,1,2,0,0,3,0,1,0,0,1
2020,46008,Careggine,LU,86,0,1,0,0,1,0,1,0,1,2
2020,46008,Careggine,LU,87,0,0,0,0,0,0,0,0,1,1
2020,46008,Careggine,LU,88,0,0,0,0,0,0,0,0,1,1
2020,46008,Careggine,LU,89,0,0,0,0,0,0,1,0,2,3
2020,46008,Careggine,LU,90,0,0,0,0,0,1,0,0,0,1
2020,46008,Careggine,LU,91,0,1,0,0,1,0,0,0,3,3
2020,46008,Careggine,LU,92,0,0,0,1,1,0,0,0,2,2
2020,46008,Careggine,LU,93,0,0,0,1,1,0,0,0,0,0
2020,46008,Careggine,LU,94,0,0,0,0,0,0,1,0,1,2
2020,46008,Careggine,LU,95,0,0,0,0,0,0,0,0,0,0
2020,46008,Careggine,LU,96,0,0,0,0,0,0,0,0,0,0
2020,46008,Careggine,LU,97,0,0,0,0,0,0,0,0,2,2
2020,46008,Careggine,LU,98,0,0,0,0,0,0,0,0,0,0
2020,46008,Careggine,LU,99,0,0,0,0,0,0,0,0,1,1
2020,46008,Careggine,LU,100 e più,0,0,0,0,0,0,0,0,0,0
2020,46009,Castelnuovo di Garfagnana,LU,0,13,0,0,0,13,15,0,0,0,15
2020,46009,Castelnuovo di Garfagnana,LU,1,21,0,0,0,21,16,0,0,0,16
2020,46009,Castelnuovo di Garfagnana,LU,2,8,0,0,0,8,22,0,0,0,22
2020,46009,Castelnuovo di Garfagnana,LU,3,24,0,0,0,24,20,0,0,0,20
2020,46009,Castelnuovo di Garfagnana,LU,4,18,0,0,0,18,24,0,0,0,24
2020,46009,Castelnuovo di Garfagnana,LU,5,25,0,0,0,25,20,0,0,0,20
2020,46009,Castelnuovo di Garfagnana,LU,6,29,0,0,0,29,20,0,0,0,20
2020,46009,Castelnuovo di Garfagnana,LU,7,16,0,0,0,16,27,0,0,0,27
2020,46009,Castelnuovo di Garfagnana,LU,8,22,0,0,0,22,31,0,0,0,31
2020,46009,Castelnuovo di Garfagnana,LU,9,24,0,0,0,24,24,0,0,0,24
2020,46009,Castelnuovo di Garfagnana,LU,10,25,0,0,0,25,29,0,0,0,29
2020,46009,Castelnuovo di Garfagnana,LU,11,26,0,0,0,26,22,0,0,0,22
2020,46009,Castelnuovo di Garfagnana,LU,12,25,0,0,0,25,24,0,0,0,24
2020,46009,Castelnuovo di Garfagnana,LU,13,19,0,0,0,19,30,0,0,0,30
2020,46009,Castelnuovo di Garfagnana,LU,14,25,0,0,0,25,28,0,0,0,28
2020,46009,Castelnuovo di Garfagnana,LU,15,31,0,0,0,31,22,0,0,0,22
2020,46009,Castelnuovo di Garfagnana,LU,16,14,0,0,0,14,29,0,0,0,29
2020,46009,Castelnuovo di Garfagnana,LU,17,26,0,0,0,26,34,0,0,0,34
2020,46009,Castelnuovo di Garfagnana,LU,18,24,0,0,0,24,29,0,0,0,29
2020,46009,Castelnuovo di Garfagnana,LU,19,27,0,0,0,27,29,0,0,0,29
2020,46009,Castelnuovo di Garfagnana,LU,20,16,0,0,0,16,30,0,0,0,30
2020,46009,Castelnuovo di Garfagnana,LU,21,25,0,0,0,25,25,0,0,0,25
2020,46009,Castelnuovo di Garfagnana,LU,22,28,0,0,0,28,25,1,0,0,26
2020,46009,Castelnuovo di Garfagnana,LU,23,23,0,0,0,23,16,0,0,0,16
2020,46009,Castelnuovo di Garfagnana,LU,24,23,0,0,0,23,32,0,0,0,32
2020,46009,Castelnuovo di Garfagnana,LU,25,18,0,0,0,18,28,4,0,0,32
2020,46009,Castelnuovo di Garfagnana,LU,26,26,3,0,0,29,25,2,0,0,27
2020,46009,Castelnuovo di Garfagnana,LU,27,30,0,0,0,30,20,3,0,0,23
2020,46009,Castelnuovo di Garfagnana,LU,28,34,2,0,0,36,18,2,0,0,20
2020,46009,Castelnuovo di Garfagnana,LU,29,25,6,0,0,31,19,3,0,0,22
2020,46009,Castelnuovo di Garfagnana,LU,30,25,2,0,0,27,13,5,0,0,18
2020,46009,Castelnuovo di Garfagnana,LU,31,28,3,2,0,33,19,11,0,0,30
2020,46009,Castelnuovo di Garfagnana,LU,32,25,5,0,0,30,14,9,0,0,23
2020,46009,Castelnuovo di Garfagnana,LU,33,17,4,0,0,21,9,8,2,0,19
2020,46009,Castelnuovo di Garfagnana,LU,34,14,4,0,0,18,16,12,0,0,28
2020,46009,Castelnuovo di Garfagnana,LU,35,12,11,0,0,23,9,21,0,0,30
2020,46009,Castelnuovo di Garfagnana,LU,36,25,10,1,0,36,8,12,0,0,20
2020,46009,Castelnuovo di Garfagnana,LU,37,9,13,0,0,22,9,19,0,0,28
2020,46009,Castelnuovo di Garfagnana,LU,38,12,19,0,0,31,12,18,0,0,30
2020,46009,Castelnuovo di Garfagnana,LU,39,13,13,1,0,27,11,14,1,0,26
2020,46009,Castelnuovo di Garfagnana,LU,40,22,18,1,0,41,7,20,1,0,28
2020,46009,Castelnuovo di Garfagnana,LU,41,18,28,0,0,46,11,27,1,0,39
2020,46009,Castelnuovo di Garfagnana,LU,42,19,18,0,0,37,5,27,1,0,33
2020,46009,Castelnuovo di Garfagnana,LU,43,10,32,0,0,42,8,32,5,0,45
2020,46009,Castelnuovo di Garfagnana,LU,44,16,26,2,0,44,11,33,4,1,49
2020,46009,Castelnuovo di Garfagnana,LU,45,14,30,1,0,45,9,39,0,0,48
2020,46009,Castelnuovo di Garfagnana,LU,46,15,31,2,0,48,12,32,2,0,46
2020,46009,Castelnuovo di Garfagnana,LU,47,14,32,1,0,47,12,24,6,0,42
2020,46009,Castelnuovo di Garfagnana,LU,48,13,29,2,1,45,8,40,2,1,51
2020,46009,Castelnuovo di Garfagnana,LU,49,12,28,5,0,45,7,30,4,0,41
2020,46009,Castelnuovo di Garfagnana,LU,50,12,23,3,0,38,11,35,2,1,49
2020,46009,Castelnuovo di Garfagnana,LU,51,11,30,3,0,44,8,29,3,4,44
2020,46009,Castelnuovo di Garfagnana,LU,52,8,32,1,1,42,6,39,1,0,46
2020,46009,Castelnuovo di Garfagnana,LU,53,10,39,0,0,49,6,33,5,1,45
2020,46009,Castelnuovo di Garfagnana,LU,54,6,28,1,0,35,8,34,5,4,51
2020,46009,Castelnuovo di Garfagnana,LU,55,10,29,1,0,40,10,39,2,4,55
2020,46009,Castelnuovo di Garfagnana,LU,56,5,29,4,1,39,3,35,6,0,44
2020,46009,Castelnuovo di Garfagnana,LU,57,11,26,5,0,42,4,28,5,1,38
2020,46009,Castelnuovo di Garfagnana,LU,58,6,31,1,0,38,7,39,4,1,51
2020,46009,Castelnuovo di Garfagnana,LU,59,4,36,3,3,46,3,31,2,4,40
2020,46009,Castelnuovo di Garfagnana,LU,60,4,24,2,0,30,0,33,4,2,39
2020,46009,Castelnuovo di Garfagnana,LU,61,5,34,2,1,42,0,31,2,6,39
2020,46009,Castelnuovo di Garfagnana,LU,62,6,31,3,0,40,1,26,2,5,34
2020,46009,Castelnuovo di Garfagnana,LU,63,2,31,2,0,35,2,41,1,5,49
2020,46009,Castelnuovo di Garfagnana,LU,64,2,28,2,0,32,1,34,1,3,39
2020,46009,Castelnuovo di Garfagnana,LU,65,2,30,1,1,34,1,24,0,5,30
2020,46009,Castelnuovo di Garfagnana,LU,66,5,24,1,0,30,1,32,1,11,45
2020,46009,Castelnuovo di Garfagnana,LU,67,6,35,4,3,48,1,22,3,2,28
2020,46009,Castelnuovo di Garfagnana,LU,68,2,38,1,4,45,2,30,0,6,38
2020,46009,Castelnuovo di Garfagnana,LU,69,3,31,4,1,39,2,36,1,5,44
2020,46009,Castelnuovo di Garfagnana,LU,70,1,32,2,2,37,3,32,2,12,49
2020,46009,Castelnuovo di Garfagnana,LU,71,4,30,1,3,38,0,24,2,8,34
2020,46009,Castelnuovo di Garfagnana,LU,72,4,35,1,0,40,2,27,0,13,42
2020,46009,Castelnuovo di Garfagnana,LU,73,6,42,3,2,53,1,31,1,9,42
2020,46009,Castelnuovo di Garfagnana,LU,74,0,34,1,1,36,0,37,1,18,56
2020,46009,Castelnuovo di Garfagnana,LU,75,3,15,2,0,20,1,11,2,4,18
2020,46009,Castelnuovo di Garfagnana,LU,76,4,18,0,1,23,2,16,0,6,24
2020,46009,Castelnuovo di Garfagnana,LU,77,0,21,2,4,27,2,11,1,7,21
2020,46009,Castelnuovo di Garfagnana,LU,78,3,24,2,2,31,1,22,1,20,44
2020,46009,Castelnuovo di Garfagnana,LU,79,4,23,0,3,30,4,16,0,26,46
2020,46009,Castelnuovo di Garfagnana,LU,80,2,21,0,8,31,3,19,1,18,41
2020,46009,Castelnuovo di Garfagnana,LU,81,1,18,0,5,24,2,13,0,16,31
2020,46009,Castelnuovo di Garfagnana,LU,82,5,23,0,4,32,2,15,0,14,31
2020,46009,Castelnuovo di Garfagnana,LU,83,1,17,0,5,23,3,10,0,11,24
2020,46009,Castelnuovo di Garfagnana,LU,84,1,15,0,3,19,0,7,0,16,23
2020,46009,Castelnuovo di Garfagnana,LU,85,2,12,0,2,16,1,5,0,19,25
2020,46009,Castelnuovo di Garfagnana,LU,86,1,12,0,3,16,1,5,0,17,23
2020,46009,Castelnuovo di Garfagnana,LU,87,0,8,0,1,9,1,2,0,22,25
2020,46009,Castelnuovo di Garfagnana,LU,88,1,4,0,3,8,4,4,0,9,17
2020,46009,Castelnuovo di Garfagnana,LU,89,1,0,0,4,5,2,1,0,9,12
2020,46009,Castelnuovo di Garfagnana,LU,90,1,3,0,2,6,0,1,0,18,19
2020,46009,Castelnuovo di Garfagnana,LU,91,0,3,0,1,4,0,2,0,7,9
2020,46009,Castelnuovo di Garfagnana,LU,92,0,2,0,1,3,0,1,0,5,6
2020,46009,Castelnuovo di Garfagnana,LU,93,0,1,0,0,1,0,2,0,2,4
2020,46009,Castelnuovo di Garfagnana,LU,94,1,2,0,0,3,0,0,0,2,2
2020,46009,Castelnuovo di Garfagnana,LU,95,0,1,0,0,1,0,0,0,2,2
2020,46009,Castelnuovo di Garfagnana,LU,96,0,0,0,0,0,1,0,0,3,4
2020,46009,Castelnuovo di Garfagnana,LU,97,0,0,0,0,0,0,0,0,1,1
2020,46009,Castelnuovo di Garfagnana,LU,98,0,1,0,0,1,0,0,0,3,3
2020,46009,Castelnuovo di Garfagnana,LU,99,0,0,0,0,0,0,0,0,2,2
2020,46009,Castelnuovo di Garfagnana,LU,100 e più,0,0,0,0,0,0,0,0,1,1
2020,46010,Castiglione di Garfagnana,LU,0,8,0,0,0,8,6,0,0,0,6
2020,46010,Castiglione di Garfagnana,LU,1,2,0,0,0,2,6,0,0,0,6
2020,46010,Castiglione di Garfagnana,LU,2,5,0,0,0,5,3,0,0,0,3
2020,46010,Castiglione di Garfagnana,LU,3,5,0,0,0,5,4,0,0,0,4
2020,46010,Castiglione di Garfagnana,LU,4,5,0,0,0,5,5,0,0,0,5
2020,46010,Castiglione di Garfagnana,LU,5,7,0,0,0,7,4,0,0,0,4
2020,46010,Castiglione di Garfagnana,LU,6,8,0,0,0,8,6,0,0,0,6
2020,46010,Castiglione di Garfagnana,LU,7,7,0,0,0,7,9,0,0,0,9
2020,46010,Castiglione di Garfagnana,LU,8,7,0,0,0,7,4,0,0,0,4
2020,46010,Castiglione di Garfagnana,LU,9,5,0,0,0,5,8,0,0,0,8
2020,46010,Castiglione di Garfagnana,LU,10,7,0,0,0,7,8,0,0,0,8
2020,46010,Castiglione di Garfagnana,LU,11,7,0,0,0,7,9,0,0,0,9
2020,46010,Castiglione di Garfagnana,LU,12,5,0,0,0,5,10,0,0,0,10
2020,46010,Castiglione di Garfagnana,LU,13,9,0,0,0,9,14,0,0,0,14
2020,46010,Castiglione di Garfagnana,LU,14,8,0,0,0,8,6,0,0,0,6
2020,46010,Castiglione di Garfagnana,LU,15,7,0,0,0,7,3,0,0,0,3
2020,46010,Castiglione di Garfagnana,LU,16,4,0,0,0,4,3,0,0,0,3
2020,46010,Castiglione di Garfagnana,LU,17,4,0,0,0,4,6,0,0,0,6
2020,46010,Castiglione di Garfagnana,LU,18,4,0,0,0,4,10,0,0,0,10
2020,46010,Castiglione di Garfagnana,LU,19,5,0,0,0,5,6,0,0,0,6
2020,46010,Castiglione di Garfagnana,LU,20,11,0,0,0,11,4,0,0,0,4
2020,46010,Castiglione di Garfagnana,LU,21,7,0,0,0,7,9,0,0,0,9
2020,46010,Castiglione di Garfagnana,LU,22,8,0,0,0,8,4,0,0,0,4
2020,46010,Castiglione di Garfagnana,LU,23,6,0,0,0,6,8,0,0,0,8
2020,46010,Castiglione di Garfagnana,LU,24,7,0,0,0,7,9,1,0,0,10
2020,46010,Castiglione di Garfagnana,LU,25,13,0,0,0,13,7,1,0,0,8
2020,46010,Castiglione di Garfagnana,LU,26,2,1,0,0,3,8,0,0,0,8
2020,46010,Castiglione di Garfagnana,LU,27,8,0,0,0,8,9,1,0,0,10
2020,46010,Castiglione di Garfagnana,LU,28,12,0,0,0,12,8,3,0,0,11
2020,46010,Castiglione di Garfagnana,LU,29,6,0,0,0,6,2,2,0,0,4
2020,46010,Castiglione di Garfagnana,LU,30,4,2,0,0,6,6,1,0,0,7
2020,46010,Castiglione di Garfagnana,LU,31,8,3,0,0,11,4,1,0,0,5
2020,46010,Castiglione di Garfagnana,LU,32,7,1,0,0,8,3,4,0,0,7
2020,46010,Castiglione di Garfagnana,LU,33,5,2,0,0,7,2,2,0,0,4
2020,46010,Castiglione di Garfagnana,LU,34,8,1,0,0,9,2,8,0,0,10
2020,46010,Castiglione di Garfagnana,LU,35,2,3,0,0,5,1,4,1,0,6
2020,46010,Castiglione di Garfagnana,LU,36,10,5,0,0,15,2,7,0,0,9
2020,46010,Castiglione di Garfagnana,LU,37,4,2,0,0,6,3,2,0,0,5
2020,46010,Castiglione di Garfagnana,LU,38,9,7,1,0,17,4,2,2,0,8
2020,46010,Castiglione di Garfagnana,LU,39,3,4,0,0,7,1,8,0,0,9
2020,46010,Castiglione di Garfagnana,LU,40,4,6,0,0,10,1,11,0,0,12
2020,46010,Castiglione di Garfagnana,LU,41,5,5,0,0,10,5,6,0,1,12
2020,46010,Castiglione di Garfagnana,LU,42,2,5,1,0,8,3,14,0,1,18
2020,46010,Castiglione di Garfagnana,LU,43,2,6,3,0,11,3,8,1,0,12
2020,46010,Castiglione di Garfagnana,LU,44,5,6,0,0,11,6,7,0,0,13
2020,46010,Castiglione di Garfagnana,LU,45,6,7,1,0,14,3,4,0,0,7
2020,46010,Castiglione di Garfagnana,LU,46,5,11,1,0,17,0,10,2,0,12
2020,46010,Castiglione di Garfagnana,LU,47,4,12,0,0,16,2,8,1,0,11
2020,46010,Castiglione di Garfagnana,LU,48,3,5,1,0,9,2,10,0,0,12
2020,46010,Castiglione di Garfagnana,LU,49,4,12,0,0,16,0,12,1,0,13
2020,46010,Castiglione di Garfagnana,LU,50,6,10,1,0,17,5,6,0,0,11
2020,46010,Castiglione di Garfagnana,LU,51,5,6,0,0,11,1,11,0,0,12
2020,46010,Castiglione di Garfagnana,LU,52,4,13,0,0,17,1,15,1,0,17
2020,46010,Castiglione di Garfagnana,LU,53,2,9,0,0,11,1,9,0,0,10
2020,46010,Castiglione di Garfagnana,LU,54,6,11,1,0,18,0,11,1,1,13
2020,46010,Castiglione di Garfagnana,LU,55,3,15,1,0,19,2,10,2,1,15
2020,46010,Castiglione di Garfagnana,LU,56,3,10,0,1,14,1,16,1,0,18
2020,46010,Castiglione di Garfagnana,LU,57,3,7,0,1,11,1,10,0,0,11
2020,46010,Castiglione di Garfagnana,LU,58,0,12,0,0,12,0,8,0,0,8
2020,46010,Castiglione di Garfagnana,LU,59,4,11,2,0,17,0,11,3,1,15
2020,46010,Castiglione di Garfagnana,LU,60,1,9,1,0,11,0,10,1,1,12
2020,46010,Castiglione di Garfagnana,LU,61,5,8,1,0,14,2,12,0,4,18
2020,46010,Castiglione di Garfagnana,LU,62,2,6,1,0,9,1,12,1,0,14
2020,46010,Castiglione di Garfagnana,LU,63,3,6,1,0,10,1,11,0,1,13
2020,46010,Castiglione di Garfagnana,LU,64,1,13,2,0,16,0,9,0,0,9
2020,46010,Castiglione di Garfagnana,LU,65,2,11,0,0,13,1,10,1,0,12
2020,46010,Castiglione di Garfagnana,LU,66,3,10,0,0,13,3,9,1,1,14
2020,46010,Castiglione di Garfagnana,LU,67,3,9,1,0,13,1,7,0,1,9
2020,46010,Castiglione di Garfagnana,LU,68,3,15,0,0,18,2,10,0,4,16
2020,46010,Castiglione di Garfagnana,LU,69,0,10,0,0,10,1,8,0,0,9
2020,46010,Castiglione di Garfagnana,LU,70,2,7,1,0,10,0,10,0,1,11
2020,46010,Castiglione di Garfagnana,LU,71,3,12,0,1,16,0,3,0,0,3
2020,46010,Castiglione di Garfagnana,LU,72,1,1,0,0,2,0,12,0,7,19
2020,46010,Castiglione di Garfagnana,LU,73,2,10,1,0,13,0,5,0,2,7
2020,46010,Castiglione di Garfagnana,LU,74,2,14,1,2,19,0,5,0,0,5
2020,46010,Castiglione di Garfagnana,LU,75,0,2,0,0,2,1,2,0,1,4
2020,46010,Castiglione di Garfagnana,LU,76,1,11,0,0,12,0,4,1,3,8
2020,46010,Castiglione di Garfagnana,LU,77,1,7,0,0,8,0,11,1,1,13
2020,46010,Castiglione di Garfagnana,LU,78,1,6,0,0,7,1,5,0,1,7
2020,46010,Castiglione di Garfagnana,LU,79,2,6,0,1,9,0,7,0,4,11
2020,46010,Castiglione di Garfagnana,LU,80,1,7,0,0,8,0,1,0,8,9
2020,46010,Castiglione di Garfagnana,LU,81,1,8,0,1,10,0,5,0,9,14
2020,46010,Castiglione di Garfagnana,LU,82,1,3,0,1,5,0,4,0,8,12
2020,46010,Castiglione di Garfagnana,LU,83,1,2,0,1,4,0,3,0,6,9
2020,46010,Castiglione di Garfagnana,LU,84,1,6,0,1,8,1,1,0,1,3
2020,46010,Castiglione di Garfagnana,LU,85,1,1,0,3,5,1,4,0,7,12
2020,46010,Castiglione di Garfagnana,LU,86,0,6,0,2,8,0,1,0,6,7
2020,46010,Castiglione di Garfagnana,LU,87,1,0,0,0,1,1,1,0,5,7
2020,46010,Castiglione di Garfagnana,LU,88,0,3,0,1,4,0,3,0,4,7
2020,46010,Castiglione di Garfagnana,LU,89,0,3,0,2,5,0,1,0,6,7
2020,46010,Castiglione di Garfagnana,LU,90,1,0,0,1,2,0,1,0,4,5
2020,46010,Castiglione di Garfagnana,LU,91,0,0,0,1,1,0,0,0,2,2
2020,46010,Castiglione di Garfagnana,LU,92,0,1,0,0,1,0,0,0,1,1
2020,46010,Castiglione di Garfagnana,LU,93,0,0,0,0,0,0,0,0,4,4
2020,46010,Castiglione di Garfagnana,LU,94,0,0,0,0,0,0,0,0,6,6
2020,46010,Castiglione di Garfagnana,LU,95,0,0,0,1,1,0,0,0,1,1
2020,46010,Castiglione di Garfagnana,LU,96,0,0,0,1,1,0,0,0,1,1
2020,46010,Castiglione di Garfagnana,LU,97,0,0,0,0,0,0,0,0,1,1
2020,46010,Castiglione di Garfagnana,LU,98,0,0,0,0,0,0,0,0,1,1
2020,46010,Castiglione di Garfagnana,LU,99,0,0,0,0,0,0,0,0,0,0
2020,46010,Castiglione di Garfagnana,LU,100 e più,0,0,0,0,0,0,0,0,0,0
2020,46011,Coreglia Antelminelli,LU,0,17,0,0,0,17,15,0,0,0,15
2020,46011,Coreglia Antelminelli,LU,1,8,0,0,0,8,16,0,0,0,16
2020,46011,Coreglia Antelminelli,LU,2,11,0,0,0,11,12,0,0,0,12
2020,46011,Coreglia Antelminelli,LU,3,11,0,0,0,11,11,0,0,0,11
2020,46011,Coreglia Antelminelli,LU,4,8,0,0,0,8,20,0,0,0,20
2020,46011,Coreglia Antelminelli,LU,5,16,0,0,0,16,18,0,0,0,18
2020,46011,Coreglia Antelminelli,LU,6,26,0,0,0,26,19,0,0,0,19
2020,46011,Coreglia Antelminelli,LU,7,21,0,0,0,21,18,0,0,0,18
2020,46011,Coreglia Antelminelli,LU,8,25,0,0,0,25,20,0,0,0,20
2020,46011,Coreglia Antelminelli,LU,9,23,0,0,0,23,26,0,0,0,26
2020,46011,Coreglia Antelminelli,LU,10,31,0,0,0,31,17,0,0,0,17
2020,46011,Coreglia Antelminelli,LU,11,29,0,0,0,29,27,0,0,0,27
2020,46011,Coreglia Antelminelli,LU,12,20,0,0,0,20,27,0,0,0,27
2020,46011,Coreglia Antelminelli,LU,13,23,0,0,0,23,20,0,0,0,20
2020,46011,Coreglia Antelminelli,LU,14,25,0,0,0,25,36,0,0,0,36
2020,46011,Coreglia Antelminelli,LU,15,24,0,0,0,24,29,0,0,0,29
2020,46011,Coreglia Antelminelli,LU,16,27,0,0,0,27,26,0,0,0,26
2020,46011,Coreglia Antelminelli,LU,17,28,0,0,0,28,30,0,0,0,30
2020,46011,Coreglia Antelminelli,LU,18,24,0,0,0,24,13,1,0,0,14
2020,46011,Coreglia Antelminelli,LU,19,22,0,0,0,22,25,0,0,0,25
2020,46011,Coreglia Antelminelli,LU,20,27,0,0,0,27,30,0,0,0,30
2020,46011,Coreglia Antelminelli,LU,21,23,0,0,0,23,20,0,0,0,20
2020,46011,Coreglia Antelminelli,LU,22,30,0,0,0,30,31,0,0,0,31
2020,46011,Coreglia Antelminelli,LU,23,26,1,0,0,27,17,1,0,0,18
2020,46011,Coreglia Antelminelli,LU,24,31,0,0,0,31,22,1,0,0,23
2020,46011,Coreglia Antelminelli,LU,25,27,0,0,0,27,18,3,0,0,21
2020,46011,Coreglia Antelminelli,LU,26,26,2,0,0,28,23,1,0,0,24
2020,46011,Coreglia Antelminelli,LU,27,40,2,0,0,42,21,2,0,0,23
2020,46011,Coreglia Antelminelli,LU,28,19,0,0,0,19,20,7,0,0,27
2020,46011,Coreglia Antelminelli,LU,29,22,0,0,0,22,9,5,0,0,14
2020,46011,Coreglia Antelminelli,LU,30,35,0,0,0,35,22,3,0,0,25
2020,46011,Coreglia Antelminelli,LU,31,21,5,0,0,26,19,6,0,0,25
2020,46011,Coreglia Antelminelli,LU,32,19,3,0,0,22,8,15,0,0,23
2020,46011,Coreglia Antelminelli,LU,33,18,4,1,0,23,13,12,2,0,27
2020,46011,Coreglia Antelminelli,LU,34,16,6,0,0,22,16,13,0,0,29
2020,46011,Coreglia Antelminelli,LU,35,10,10,0,0,20,13,14,2,0,29
2020,46011,Coreglia Antelminelli,LU,36,24,16,0,0,40,7,14,0,0,21
2020,46011,Coreglia Antelminelli,LU,37,7,18,1,0,26,18,16,2,0,36
2020,46011,Coreglia Antelminelli,LU,38,19,11,1,0,31,15,22,1,0,38
2020,46011,Coreglia Antelminelli,LU,39,13,17,0,0,30,12,21,0,0,33
2020,46011,Coreglia Antelminelli,LU,40,12,20,0,0,32,6,12,2,0,20
2020,46011,Coreglia Antelminelli,LU,41,11,12,0,0,23,10,24,0,0,34
2020,46011,Coreglia Antelminelli,LU,42,19,25,0,0,44,12,27,2,0,41
2020,46011,Coreglia Antelminelli,LU,43,18,21,0,0,39,4,17,0,0,21
2020,46011,Coreglia Antelminelli,LU,44,15,21,0,0,36,4,27,4,0,35
2020,46011,Coreglia Antelminelli,LU,45,7,24,1,0,32,14,29,2,1,46
2020,46011,Coreglia Antelminelli,LU,46,11,24,0,0,35,7,36,3,0,46
2020,46011,Coreglia Antelminelli,LU,47,16,25,1,0,42,5,34,5,0,44
2020,46011,Coreglia Antelminelli,LU,48,6,29,1,0,36,9,33,5,1,48
2020,46011,Coreglia Antelminelli,LU,49,8,26,6,0,40,8,36,2,1,47
2020,46011,Coreglia Antelminelli,LU,50,16,30,7,0,53,6,27,5,3,41
2020,46011,Coreglia Antelminelli,LU,51,9,35,2,0,46,1,33,2,0,36
2020,46011,Coreglia Antelminelli,LU,52,7,35,2,0,44,6,35,7,1,49
2020,46011,Coreglia Antelminelli,LU,53,8,43,1,2,54,4,29,7,3,43
2020,46011,Coreglia Antelminelli,LU,54,6,28,4,0,38,7,35,4,1,47
2020,46011,Coreglia Antelminelli,LU,55,5,39,2,0,46,6,33,5,2,46
2020,46011,Coreglia Antelminelli,LU,56,5,26,5,1,37,5,42,1,2,50
2020,46011,Coreglia Antelminelli,LU,57,9,44,7,0,60,1,34,1,1,37
2020,46011,Coreglia Antelminelli,LU,58,12,21,1,1,35,4,27,6,0,37
2020,46011,Coreglia Antelminelli,LU,59,7,25,0,1,33,5,41,3,2,51
2020,46011,Coreglia Antelminelli,LU,60,1,30,5,0,36,1,25,3,1,30
2020,46011,Coreglia Antelminelli,LU,61,8,31,3,0,42,0,30,2,4,36
2020,46011,Coreglia Antelminelli,LU,62,4,26,1,1,32,2,26,3,2,33
2020,46011,Coreglia Antelminelli,LU,63,7,30,4,1,42,0,12,5,3,20
2020,46011,Coreglia Antelminelli,LU,64,1,32,5,1,39,1,21,2,7,31
2020,46011,Coreglia Antelminelli,LU,65,4,23,1,0,28,4,24,3,6,37
2020,46011,Coreglia Antelminelli,LU,66,3,27,2,2,34,2,26,3,3,34
2020,46011,Coreglia Antelminelli,LU,67,2,22,3,0,27,4,22,2,5,33
2020,46011,Coreglia Antelminelli,LU,68,5,18,0,3,26,2,26,1,4,33
2020,46011,Coreglia Antelminelli,LU,69,6,30,0,3,39,1,18,2,5,26
2020,46011,Coreglia Antelminelli,LU,70,5,26,0,2,33,1,17,1,5,24
2020,46011,Coreglia Antelminelli,LU,71,4,27,1,4,36,1,20,2,7,30
2020,46011,Coreglia Antelminelli,LU,72,2,13,2,2,19,3,20,2,8,33
2020,46011,Coreglia Antelminelli,LU,73,2,33,1,3,39,2,13,1,6,22
2020,46011,Coreglia Antelminelli,LU,74,4,21,1,1,27,1,24,1,12,38
2020,46011,Coreglia Antelminelli,LU,75,1,9,1,1,12,1,15,1,8,25
2020,46011,Coreglia Antelminelli,LU,76,0,23,1,1,25,2,14,0,11,27
2020,46011,Coreglia Antelminelli,LU,77,1,15,0,2,18,1,9,0,10,20
2020,46011,Coreglia Antelminelli,LU,78,4,21,0,4,29,0,23,0,11,34
2020,46011,Coreglia Antelminelli,LU,79,2,19,0,3,24,3,16,0,17,36
2020,46011,Coreglia Antelminelli,LU,80,5,16,1,2,24,0,12,0,15,27
2020,46011,Coreglia Antelminelli,LU,81,0,15,0,2,17,2,14,0,13,29
2020,46011,Coreglia Antelminelli,LU,82,2,14,0,3,19,0,10,0,18,28
2020,46011,Coreglia Antelminelli,LU,83,2,16,0,3,21,3,13,0,15,31
2020,46011,Coreglia Antelminelli,LU,84,2,12,1,5,20,1,6,1,8,16
2020,46011,Coreglia Antelminelli,LU,85,1,6,0,2,9,0,4,0,16,20
2020,46011,Coreglia Antelminelli,LU,86,0,9,0,5,14,0,5,1,8,14
2020,46011,Coreglia Antelminelli,LU,87,0,7,0,3,10,0,3,0,6,9
2020,46011,Coreglia Antelminelli,LU,88,1,5,0,0,6,1,5,0,10,16
2020,46011,Coreglia Antelminelli,LU,89,0,5,0,2,7,0,1,0,11,12
2020,46011,Coreglia Antelminelli,LU,90,0,3,0,0,3,0,1,0,8,9
2020,46011,Coreglia Antelminelli,LU,91,0,1,0,1,2,0,1,0,9,10
2020,46011,Coreglia Antelminelli,LU,92,0,0,1,0,1,0,1,0,2,3
2020,46011,Coreglia Antelminelli,LU,93,0,3,0,0,3,1,0,0,4,5
2020,46011,Coreglia Antelminelli,LU,94,0,1,0,1,2,0,1,0,5,6
2020,46011,Coreglia Antelminelli,LU,95,0,1,0,2,3,0,0,0,4,4
2020,46011,Coreglia Antelminelli,LU,96,0,0,0,1,1,0,0,0,1,1
2020,46011,Coreglia Antelminelli,LU,97,0,1,0,0,1,1,1,0,1,3
2020,46011,Coreglia Antelminelli,LU,98,0,1,0,0,1,0,0,0,2,2
2020,46011,Coreglia Antelminelli,LU,99,0,0,0,0,0,0,0,0,3,3
2020,46011,Coreglia Antelminelli,LU,100 e più,0,0,0,0,0,0,0,0,3,3
2020,46013,Forte dei Marmi,LU,0,12,0,0,0,12,10,0,0,0,10
2020,46013,Forte dei Marmi,LU,1,8,0,0,0,8,19,0,0,0,19
2020,46013,Forte dei Marmi,LU,2,22,0,0,0,22,14,0,0,0,14
2020,46013,Forte dei Marmi,LU,3,17,0,0,0,17,22,0,0,0,22
2020,46013,Forte dei Marmi,LU,4,17,0,0,0,17,10,0,0,0,10
2020,46013,Forte dei Marmi,LU,5,22,0,0,0,22,20,0,0,0,20
2020,46013,Forte dei Marmi,LU,6,14,0,0,0,14,26,0,0,0,26
2020,46013,Forte dei Marmi,LU,7,19,0,0,0,19,17,0,0,0,17
2020,46013,Forte dei Marmi,LU,8,25,0,0,0,25,29,0,0,0,29
2020,46013,Forte dei Marmi,LU,9,22,0,0,0,22,37,0,0,0,37
2020,46013,Forte dei Marmi,LU,10,21,0,0,0,21,22,0,0,0,22
2020,46013,Forte dei Marmi,LU,11,24,0,0,0,24,36,0,0,0,36
2020,46013,Forte dei Marmi,LU,12,28,0,0,0,28,27,0,0,0,27
2020,46013,Forte dei Marmi,LU,13,22,0,0,0,22,26,0,0,0,26
2020,46013,Forte dei Marmi,LU,14,18,0,0,0,18,31,0,0,0,31
2020,46013,Forte dei Marmi,LU,15,23,0,0,0,23,23,0,0,0,23
2020,46013,Forte dei Marmi,LU,16,27,0,0,0,27,21,0,0,0,21
2020,46013,Forte dei Marmi,LU,17,31,0,0,0,31,16,0,0,0,16
2020,46013,Forte dei Marmi,LU,18,33,0,0,0,33,18,0,0,0,18
2020,46013,Forte dei Marmi,LU,19,41,0,0,0,41,28,0,0,0,28
2020,46013,Forte dei Marmi,LU,20,26,0,0,0,26,29,0,0,0,29
2020,46013,Forte dei Marmi,LU,21,21,0,0,0,21,30,0,0,0,30
2020,46013,Forte dei Marmi,LU,22,28,0,0,0,28,21,0,0,0,21
2020,46013,Forte dei Marmi,LU,23,35,0,0,0,35,23,0,0,0,23
2020,46013,Forte dei Marmi,LU,24,30,0,0,0,30,27,0,0,0,27
2020,46013,Forte dei Marmi,LU,25,31,0,0,0,31,20,0,1,0,21
2020,46013,Forte dei Marmi,LU,26,32,0,0,0,32,26,0,0,0,26
2020,46013,Forte dei Marmi,LU,27,34,0,0,0,34,30,3,0,0,33
2020,46013,Forte dei Marmi,LU,28,30,0,0,0,30,22,0,0,0,22
2020,46013,Forte dei Marmi,LU,29,31,3,0,0,34,28,4,0,0,32
2020,46013,Forte dei Marmi,LU,30,24,3,0,0,27,24,2,0,0,26
2020,46013,Forte dei Marmi,LU,31,21,2,0,0,23,24,3,0,0,27
2020,46013,Forte dei Marmi,LU,32,24,8,1,0,33,20,11,0,0,31
2020,46013,Forte dei Marmi,LU,33,23,3,0,0,26,19,9,0,0,28
2020,46013,Forte dei Marmi,LU,34,27,5,0,0,32,14,10,2,1,27
2020,46013,Forte dei Marmi,LU,35,15,7,0,0,22,13,11,0,2,26
2020,46013,Forte dei Marmi,LU,36,17,9,3,0,29,17,16,1,0,34
2020,46013,Forte dei Marmi,LU,37,22,15,0,0,37,15,15,2,0,32
2020,46013,Forte dei Marmi,LU,38,19,11,1,0,31,14,18,0,0,32
2020,46013,Forte dei Marmi,LU,39,14,18,0,0,32,16,18,1,0,35
2020,46013,Forte dei Marmi,LU,40,11,18,1,0,30,14,26,0,0,40
2020,46013,Forte dei Marmi,LU,41,25,14,1,0,40,26,30,0,1,57
2020,46013,Forte dei Marmi,LU,42,32,17,0,0,49,12,29,2,0,43
2020,46013,Forte dei Marmi,LU,43,19,20,1,0,40,15,23,4,0,42
2020,46013,Forte dei Marmi,LU,44,27,25,4,0,56,20,22,2,2,46
2020,46013,Forte dei Marmi,LU,45,21,24,2,0,47,21,33,1,0,55
2020,46013,Forte dei Marmi,LU,46,28,27,5,0,60,11,19,3,0,33
2020,46013,Forte dei Marmi,LU,47,24,24,2,0,50,16,28,5,1,50
2020,46013,Forte dei Marmi,LU,48,12,33,3,0,48,19,31,5,0,55
2020,46013,Forte dei Marmi,LU,49,14,30,7,0,51,14,38,4,1,57
2020,46013,Forte dei Marmi,LU,50,17,26,4,0,47,16,32,4,2,54
2020,46013,Forte dei Marmi,LU,51,19,31,3,0,53,14,45,14,1,74
2020,46013,Forte dei Marmi,LU,52,17,40,5,1,63,21,44,12,0,77
2020,46013,Forte dei Marmi,LU,53,13,47,5,0,65,17,56,6,0,79
2020,46013,Forte dei Marmi,LU,54,19,42,3,0,64,9,35,13,3,60
2020,46013,Forte dei Marmi,LU,55,21,48,6,0,75,16,48,10,3,77
2020,46013,Forte dei Marmi,LU,56,15,46,9,0,70,15,49,12,2,78
2020,46013,Forte dei Marmi,LU,57,13,29,6,1,49,8,49,7,3,67
2020,46013,Forte dei Marmi,LU,58,14,48,4,1,67,8,54,12,3,77
2020,46013,Forte dei Marmi,LU,59,8,36,11,1,56,11,52,7,5,75
2020,46013,Forte dei Marmi,LU,60,10,49,7,0,66,8,50,6,4,68
2020,46013,Forte dei Marmi,LU,61,9,43,3,1,56,7,48,6,7,68
2020,46013,Forte dei Marmi,LU,62,7,46,2,0,55,5,45,3,4,57
2020,46013,Forte dei Marmi,LU,63,6,40,3,2,51,9,51,6,10,76
2020,46013,Forte dei Marmi,LU,64,6,50,3,2,61,5,45,7,2,59
2020,46013,Forte dei Marmi,LU,65,8,36,3,1,48,8,34,5,5,52
2020,46013,Forte dei Marmi,LU,66,5,35,5,2,47,7,41,2,10,60
2020,46013,Forte dei Marmi,LU,67,2,35,3,0,40,4,32,7,9,52
2020,46013,Forte dei Marmi,LU,68,4,38,1,0,43,4,31,6,10,51
2020,46013,Forte dei Marmi,LU,69,5,28,4,1,38,3,49,9,6,67
2020,46013,Forte dei Marmi,LU,70,6,37,3,3,49,4,36,3,13,56
2020,46013,Forte dei Marmi,LU,71,4,29,3,5,41,6,35,3,8,52
2020,46013,Forte dei Marmi,LU,72,4,53,4,4,65,2,31,4,18,55
2020,46013,Forte dei Marmi,LU,73,3,42,0,2,47,4,37,5,14,60
2020,46013,Forte dei Marmi,LU,74,4,26,2,2,34,3,34,3,28,68
2020,46013,Forte dei Marmi,LU,75,3,28,2,0,33,3,30,1,16,50
2020,46013,Forte dei Marmi,LU,76,2,26,3,7,38,1,24,2,18,45
2020,46013,Forte dei Marmi,LU,77,5,32,0,7,44,1,25,1,20,47
2020,46013,Forte dei Marmi,LU,78,1,24,0,3,28,1,26,1,23,51
2020,46013,Forte dei Marmi,LU,79,2,28,1,10,41,1,21,2,24,48
2020,46013,Forte dei Marmi,LU,80,2,32,0,9,43,2,28,3,25,58
2020,46013,Forte dei Marmi,LU,81,2,23,0,2,27,1,33,0,33,67
2020,46013,Forte dei Marmi,LU,82,3,31,1,5,40,2,19,0,13,34
2020,46013,Forte dei Marmi,LU,83,0,21,0,7,28,0,12,1,39,52
2020,46013,Forte dei Marmi,LU,84,2,18,1,2,23,4,18,1,28,51
2020,46013,Forte dei Marmi,LU,85,0,15,1,6,22,1,6,1,21,29
2020,46013,Forte dei Marmi,LU,86,1,13,0,3,17,4,7,0,24,35
2020,46013,Forte dei Marmi,LU,87,0,16,0,6,22,2,4,0,16,22
2020,46013,Forte dei Marmi,LU,88,1,12,0,7,20,2,9,1,15,27
2020,46013,Forte dei Marmi,LU,89,0,13,0,4,17,3,3,0,24,30
2020,46013,Forte dei Marmi,LU,90,2,5,0,7,14,0,1,0,25,26
2020,46013,Forte dei Marmi,LU,91,0,2,1,3,6,2,1,1,17,21
2020,46013,Forte dei Marmi,LU,92,0,1,0,1,2,0,0,0,19,19
2020,46013,Forte dei Marmi,LU,93,1,0,0,1,2,1,0,0,17,18
2020,46013,Forte dei Marmi,LU,94,0,4,0,2,6,0,0,0,8,8
2020,46013,Forte dei Marmi,LU,95,1,0,0,0,1,0,0,0,10,10
2020,46013,Forte dei Marmi,LU,96,0,1,0,0,1,1,0,1,4,6
2020,46013,Forte dei Marmi,LU,97,0,1,0,1,2,0,0,0,4,4
2020,46013,Forte dei Marmi,LU,98,0,0,0,0,0,1,0,0,4,5
2020,46013,Forte dei Marmi,LU,99,0,0,0,1,1,0,0,0,1,1
2020,46013,Forte dei Marmi,LU,100 e più,0,0,0,0,0,0,0,1,3,4
2020,46014,Fosciandora,LU,0,0,0,0,0,0,3,0,0,0,3
2020,46014,Fosciandora,LU,1,3,0,0,0,3,4,0,0,0,4
2020,46014,Fosciandora,LU,2,2,0,0,0,2,0,0,0,0,0
2020,46014,Fosciandora,LU,3,0,0,0,0,0,2,0,0,0,2
2020,46014,Fosciandora,LU,4,1,0,0,0,1,4,0,0,0,4
2020,46014,Fosciandora,LU,5,5,0,0,0,5,1,0,0,0,1
2020,46014,Fosciandora,LU,6,2,0,0,0,2,0,0,0,0,0
2020,46014,Fosciandora,LU,7,1,0,0,0,1,3,0,0,0,3
2020,46014,Fosciandora,LU,8,1,0,0,0,1,2,0,0,0,2
2020,46014,Fosciandora,LU,9,0,0,0,0,0,2,0,0,0,2
2020,46014,Fosciandora,LU,10,0,0,0,0,0,4,0,0,0,4
2020,46014,Fosciandora,LU,11,3,0,0,0,3,0,0,0,0,0
2020,46014,Fosciandora,LU,12,0,0,0,0,0,1,0,0,0,1
2020,46014,Fosciandora,LU,13,0,0,0,0,0,4,0,0,0,4
2020,46014,Fosciandora,LU,14,4,0,0,0,4,3,0,0,0,3
2020,46014,Fosciandora,LU,15,2,0,0,0,2,2,0,0,0,2
2020,46014,Fosciandora,LU,16,3,0,0,0,3,0,0,0,0,0
2020,46014,Fosciandora,LU,17,0,0,0,0,0,0,0,0,0,0
2020,46014,Fosciandora,LU,18,3,0,0,0,3,0,0,0,0,0
2020,46014,Fosciandora,LU,19,2,0,0,0,2,0,0,0,0,0
2020,46014,Fosciandora,LU,20,2,0,0,0,2,2,0,0,0,2
2020,46014,Fosciandora,LU,21,2,0,0,0,2,3,0,0,0,3
2020,46014,Fosciandora,LU,22,2,0,0,0,2,1,0,0,0,1
2020,46014,Fosciandora,LU,23,4,0,0,0,4,1,0,0,0,1
2020,46014,Fosciandora,LU,24,4,0,0,0,4,2,0,0,0,2
2020,46014,Fosciandora,LU,25,5,0,0,0,5,3,0,0,0,3
2020,46014,Fosciandora,LU,26,3,0,0,0,3,3,0,0,0,3
2020,46014,Fosciandora,LU,27,0,0,0,0,0,4,0,0,0,4
2020,46014,Fosciandora,LU,28,1,0,0,0,1,0,1,0,0,1
2020,46014,Fosciandora,LU,29,3,2,0,0,5,5,1,0,0,6
2020,46014,Fosciandora,LU,30,3,0,0,0,3,1,0,0,0,1
2020,46014,Fosciandora,LU,31,3,1,0,0,4,0,1,0,0,1
2020,46014,Fosciandora,LU,32,3,0,0,0,3,3,1,0,0,4
2020,46014,Fosciandora,LU,33,3,1,0,0,4,2,0,0,0,2
2020,46014,Fosciandora,LU,34,1,1,0,0,2,0,0,0,0,0
2020,46014,Fosciandora,LU,35,2,0,0,0,2,5,0,0,0,5
2020,46014,Fosciandora,LU,36,4,0,0,0,4,1,2,0,0,3
2020,46014,Fosciandora,LU,37,1,1,0,0,2,1,1,0,0,2
2020,46014,Fosciandora,LU,38,1,4,0,0,5,2,4,0,0,6
2020,46014,Fosciandora,LU,39,2,0,0,0,2,0,3,0,0,3
2020,46014,Fosciandora,LU,40,1,0,0,0,1,1,1,0,0,2
2020,46014,Fosciandora,LU,41,2,3,0,0,5,0,6,0,0,6
2020,46014,Fosciandora,LU,42,0,3,0,0,3,0,1,0,0,1
2020,46014,Fosciandora,LU,43,1,1,0,0,2,0,0,0,0,0
2020,46014,Fosciandora,LU,44,2,2,0,0,4,0,3,0,0,3
2020,46014,Fosciandora,LU,45,2,2,0,0,4,1,6,0,0,7
2020,46014,Fosciandora,LU,46,1,2,0,0,3,0,2,1,0,3
2020,46014,Fosciandora,LU,47,1,1,0,0,2,1,1,0,0,2
2020,46014,Fosciandora,LU,48,2,4,0,0,6,1,2,0,0,3
2020,46014,Fosciandora,LU,49,0,3,1,0,4,1,6,0,2,9
2020,46014,Fosciandora,LU,50,1,1,0,0,2,0,4,0,0,4
2020,46014,Fosciandora,LU,51,2,1,0,0,3,1,4,0,0,5
2020,46014,Fosciandora,LU,52,2,4,0,0,6,1,4,0,0,5
2020,46014,Fosciandora,LU,53,1,4,0,0,5,2,4,1,0,7
2020,46014,Fosciandora,LU,54,1,3,0,0,4,1,4,0,0,5
2020,46014,Fosciandora,LU,55,1,2,0,0,3,1,4,0,0,5
2020,46014,Fosciandora,LU,56,0,8,0,0,8,3,2,0,0,5
2020,46014,Fosciandora,LU,57,1,5,0,0,6,0,3,0,0,3
2020,46014,Fosciandora,LU,58,1,3,0,0,4,0,5,0,1,6
2020,46014,Fosciandora,LU,59,1,7,1,0,9,1,4,0,0,5
2020,46014,Fosciandora,LU,60,1,7,0,0,8,2,1,0,0,3
2020,46014,Fosciandora,LU,61,0,1,0,0,1,1,9,0,0,10
2020,46014,Fosciandora,LU,62,1,3,0,0,4,1,5,0,1,7
2020,46014,Fosciandora,LU,63,0,4,0,0,4,0,2,0,0,2
2020,46014,Fosciandora,LU,64,2,4,0,0,6,1,5,0,1,7
2020,46014,Fosciandora,LU,65,2,2,0,0,4,0,5,0,0,5
2020,46014,Fosciandora,LU,66,0,6,0,0,6,1,2,0,0,3
2020,46014,Fosciandora,LU,67,1,4,0,0,5,0,2,0,2,4
2020,46014,Fosciandora,LU,68,0,3,0,0,3,1,2,1,0,4
2020,46014,Fosciandora,LU,69,0,1,0,0,1,2,1,0,0,3
2020,46014,Fosciandora,LU,70,3,1,0,0,4,0,3,0,0,3
2020,46014,Fosciandora,LU,71,0,2,0,0,2,0,3,0,1,4
2020,46014,Fosciandora,LU,72,2,6,1,1,10,1,3,0,2,6
2020,46014,Fosciandora,LU,73,0,1,0,0,1,0,2,0,1,3
2020,46014,Fosciandora,LU,74,1,3,0,0,4,1,1,0,2,4
2020,46014,Fosciandora,LU,75,0,1,0,0,1,0,2,0,1,3
2020,46014,Fosciandora,LU,76,2,4,0,0,6,0,0,0,1,1
2020,46014,Fosciandora,LU,77,0,1,0,1,2,0,1,0,2,3
2020,46014,Fosciandora,LU,78,0,1,0,0,1,1,2,0,2,5
2020,46014,Fosciandora,LU,79,1,2,0,0,3,0,3,0,0,3
2020,46014,Fosciandora,LU,80,2,0,0,1,3,0,2,0,3,5
2020,46014,Fosciandora,LU,81,0,4,0,0,4,0,2,0,1,3
2020,46014,Fosciandora,LU,82,1,5,0,0,6,0,0,0,1,1
2020,46014,Fosciandora,LU,83,0,0,0,1,1,0,0,0,2,2
2020,46014,Fosciandora,LU,84,0,3,0,1,4,1,0,0,2,3
2020,46014,Fosciandora,LU,85,0,0,0,0,0,0,2,1,3,6
2020,46014,Fosciandora,LU,86,0,0,0,0,0,0,0,0,2,2
2020,46014,Fosciandora,LU,87,0,2,0,0,2,0,1,0,3,4
2020,46014,Fosciandora,LU,88,0,0,0,0,0,0,0,0,1,1
2020,46014,Fosciandora,LU,89,0,0,0,1,1,1,0,0,2,3
2020,46014,Fosciandora,LU,90,0,0,0,0,0,0,0,0,1,1
2020,46014,Fosciandora,LU,91,0,1,0,0,1,0,0,0,2,2
2020,46014,Fosciandora,LU,92,0,0,0,0,0,0,0,0,0,0
2020,46014,Fosciandora,LU,93,0,0,0,0,0,0,0,0,1,1
2020,46014,Fosciandora,LU,94,0,0,0,1,1,0,0,0,1,1
2020,46014,Fosciandora,LU,95,0,0,0,0,0,0,1,0,0,1
2020,46014,Fosciandora,LU,96,0,0,0,0,0,0,0,0,0,0
2020,46014,Fosciandora,LU,97,0,0,0,0,0,0,0,0,0,0
2020,46014,Fosciandora,LU,98,0,0,0,0,0,0,0,0,0,0
2020,46014,Fosciandora,LU,99,0,0,0,0,0,0,0,0,0,0
2020,46014,Fosciandora,LU,100 e più,0,0,0,0,0,0,0,0,0,0
2020,46015,Gallicano,LU,0,11,0,0,0,11,12,0,0,0,12
2020,46015,Gallicano,LU,1,13,0,0,0,13,3,0,0,0,3
2020,46015,Gallicano,LU,2,9,0,0,0,9,15,0,0,0,15
2020,46015,Gallicano,LU,3,13,0,0,0,13,9,0,0,0,9
2020,46015,Gallicano,LU,4,16,0,0,0,16,13,0,0,0,13
2020,46015,Gallicano,LU,5,12,0,0,0,12,15,0,0,0,15
2020,46015,Gallicano,LU,6,10,0,0,0,10,11,0,0,0,11
2020,46015,Gallicano,LU,7,22,0,0,0,22,11,0,0,0,11
2020,46015,Gallicano,LU,8,15,0,0,0,15,13,0,0,0,13
2020,46015,Gallicano,LU,9,14,0,0,0,14,13,0,0,0,13
2020,46015,Gallicano,LU,10,16,0,0,0,16,10,0,0,0,10
2020,46015,Gallicano,LU,11,17,0,0,0,17,17,0,0,0,17
2020,46015,Gallicano,LU,12,18,0,0,0,18,14,0,0,0,14
2020,46015,Gallicano,LU,13,14,0,0,0,14,16,0,0,0,16
2020,46015,Gallicano,LU,14,15,0,0,0,15,11,0,0,0,11
2020,46015,Gallicano,LU,15,21,0,0,0,21,14,0,0,0,14
2020,46015,Gallicano,LU,16,19,0,0,0,19,12,0,0,0,12
2020,46015,Gallicano,LU,17,9,0,0,0,9,17,0,0,0,17
2020,46015,Gallicano,LU,18,22,0,0,0,22,16,0,0,0,16
2020,46015,Gallicano,LU,19,16,0,0,0,16,14,0,0,0,14
2020,46015,Gallicano,LU,20,17,0,0,0,17,6,0,0,0,6
2020,46015,Gallicano,LU,21,19,0,0,0,19,22,0,0,0,22
2020,46015,Gallicano,LU,22,15,0,0,0,15,9,0,0,0,9
2020,46015,Gallicano,LU,23,20,0,0,0,20,22,0,0,0,22
2020,46015,Gallicano,LU,24,19,0,0,0,19,8,1,0,0,9
2020,46015,Gallicano,LU,25,14,0,0,0,14,23,1,0,0,24
2020,46015,Gallicano,LU,26,17,0,0,0,17,13,3,0,0,16
2020,46015,Gallicano,LU,27,20,0,0,0,20,12,0,0,0,12
2020,46015,Gallicano,LU,28,16,1,0,0,17,8,3,0,0,11
2020,46015,Gallicano,LU,29,13,2,0,0,15,10,5,0,0,15
2020,46015,Gallicano,LU,30,14,1,0,0,15,10,4,1,0,15
2020,46015,Gallicano,LU,31,8,3,0,0,11,9,6,0,0,15
2020,46015,Gallicano,LU,32,14,4,0,0,18,4,11,0,0,15
2020,46015,Gallicano,LU,33,8,4,0,0,12,14,2,0,0,16
2020,46015,Gallicano,LU,34,11,6,0,0,17,5,5,0,0,10
2020,46015,Gallicano,LU,35,8,5,3,0,16,15,10,1,0,26
2020,46015,Gallicano,LU,36,14,5,0,0,19,10,10,0,0,20
2020,46015,Gallicano,LU,37,14,6,2,0,22,5,12,1,0,18
2020,46015,Gallicano,LU,38,7,7,0,0,14,4,7,3,0,14
2020,46015,Gallicano,LU,39,18,8,1,0,27,8,6,0,0,14
2020,46015,Gallicano,LU,40,8,3,0,0,11,10,8,1,0,19
2020,46015,Gallicano,LU,41,10,12,1,0,23,6,6,1,0,13
2020,46015,Gallicano,LU,42,14,13,2,1,30,8,15,0,0,23
2020,46015,Gallicano,LU,43,12,10,1,0,23,6,19,1,0,26
2020,46015,Gallicano,LU,44,10,11,1,0,22,6,16,0,0,22
2020,46015,Gallicano,LU,45,11,20,1,0,32,7,28,1,0,36
2020,46015,Gallicano,LU,46,8,12,0,0,20,8,19,0,0,27
2020,46015,Gallicano,LU,47,7,17,2,0,26,2,27,3,0,32
2020,46015,Gallicano,LU,48,7,12,4,0,23,2,26,3,0,31
2020,46015,Gallicano,LU,49,3,27,4,0,34,9,22,1,1,33
2020,46015,Gallicano,LU,50,7,21,0,0,28,2,23,2,2,29
2020,46015,Gallicano,LU,51,3,25,2,0,30,6,19,2,2,29
2020,46015,Gallicano,LU,52,13,35,1,0,49,2,28,5,2,37
2020,46015,Gallicano,LU,53,10,30,3,0,43,4,19,2,1,26
2020,46015,Gallicano,LU,54,6,25,7,0,38,6,24,2,0,32
2020,46015,Gallicano,LU,55,5,17,5,1,28,4,29,1,1,35
2020,46015,Gallicano,LU,56,8,32,1,0,41,1,21,3,1,26
2020,46015,Gallicano,LU,57,4,19,1,1,25,4,23,4,2,33
2020,46015,Gallicano,LU,58,2,25,0,0,27,5,27,4,1,37
2020,46015,Gallicano,LU,59,2,21,1,0,24,1,17,2,3,23
2020,46015,Gallicano,LU,60,6,26,0,0,32,1,16,0,4,21
2020,46015,Gallicano,LU,61,1,15,1,0,17,1,19,5,3,28
2020,46015,Gallicano,LU,62,3,19,0,1,23,0,29,2,1,32
2020,46015,Gallicano,LU,63,8,21,1,0,30,2,22,1,3,28
2020,46015,Gallicano,LU,64,5,14,2,0,21,1,13,0,7,21
2020,46015,Gallicano,LU,65,4,15,1,2,22,3,19,0,5,27
2020,46015,Gallicano,LU,66,4,22,3,0,29,0,14,3,5,22
2020,46015,Gallicano,LU,67,2,23,1,0,26,1,18,1,6,26
2020,46015,Gallicano,LU,68,1,18,2,2,23,1,13,3,4,21
2020,46015,Gallicano,LU,69,1,19,0,0,20,0,13,2,4,19
2020,46015,Gallicano,LU,70,2,18,0,2,22,0,16,3,6,25
2020,46015,Gallicano,LU,71,4,20,1,1,26,0,17,1,5,23
2020,46015,Gallicano,LU,72,2,20,3,4,29,0,14,0,7,21
2020,46015,Gallicano,LU,73,2,15,1,2,20,1,21,1,5,28
2020,46015,Gallicano,LU,74,0,16,1,5,22,1,17,0,10,28
2020,46015,Gallicano,LU,75,0,11,0,1,12,1,6,1,8,16
2020,46015,Gallicano,LU,76,2,17,0,5,24,1,10,0,7,18
2020,46015,Gallicano,LU,77,2,15,0,2,19,0,11,0,7,18
2020,46015,Gallicano,LU,78,2,10,0,2,14,0,9,1,16,26
2020,46015,Gallicano,LU,79,0,9,0,2,11,0,7,0,13,20
2020,46015,Gallicano,LU,80,2,11,0,1,14,1,5,0,8,14
2020,46015,Gallicano,LU,81,5,14,1,1,21,0,10,0,11,21
2020,46015,Gallicano,LU,82,1,7,0,2,10,1,4,1,9,15
2020,46015,Gallicano,LU,83,0,6,0,2,8,0,8,0,10,18
2020,46015,Gallicano,LU,84,0,10,0,3,13,1,5,0,21,27
2020,46015,Gallicano,LU,85,0,8,0,3,11,1,3,1,13,18
2020,46015,Gallicano,LU,86,0,6,0,8,14,0,0,0,9,9
2020,46015,Gallicano,LU,87,0,3,1,0,4,0,2,0,6,8
2020,46015,Gallicano,LU,88,0,1,0,1,2,3,2,0,8,13
2020,46015,Gallicano,LU,89,0,6,0,0,6,0,1,0,7,8
2020,46015,Gallicano,LU,90,0,1,0,4,5,1,0,1,7,9
2020,46015,Gallicano,LU,91,0,1,0,2,3,0,0,0,9,9
2020,46015,Gallicano,LU,92,0,0,0,0,0,0,0,0,9,9
2020,46015,Gallicano,LU,93,0,0,0,0,0,1,0,0,5,6
2020,46015,Gallicano,LU,94,0,0,0,1,1,0,0,0,2,2
2020,46015,Gallicano,LU,95,0,0,0,0,0,1,0,0,3,4
2020,46015,Gallicano,LU,96,0,0,0,1,1,0,0,0,2,2
2020,46015,Gallicano,LU,97,0,0,0,2,2,0,0,0,1,1
2020,46015,Gallicano,LU,98,0,0,0,0,0,1,0,0,1,2
2020,46015,Gallicano,LU,99,0,0,0,0,0,0,0,0,1,1
2020,46015,Gallicano,LU,100 e più,0,0,0,0,0,0,0,0,2,2
2020,46017,Lucca,LU,0,254,0,0,0,254,263,0,0,0,263
2020,46017,Lucca,LU,1,295,0,0,0,295,311,0,0,0,311
2020,46017,Lucca,LU,2,283,0,0,0,283,308,0,0,0,308
2020,46017,Lucca,LU,3,346,0,0,0,346,287,0,0,0,287
2020,46017,Lucca,LU,4,352,0,0,0,352,332,0,0,0,332
2020,46017,Lucca,LU,5,326,0,0,0,326,355,0,0,0,355
2020,46017,Lucca,LU,6,373,0,0,0,373,326,0,0,0,326
2020,46017,Lucca,LU,7,378,0,0,0,378,345,0,0,0,345
2020,46017,Lucca,LU,8,376,0,0,0,376,391,0,0,0,391
2020,46017,Lucca,LU,9,353,0,0,0,353,381,0,0,0,381
2020,46017,Lucca,LU,10,387,0,0,0,387,375,0,0,0,375
2020,46017,Lucca,LU,11,411,0,0,0,411,359,0,0,0,359
2020,46017,Lucca,LU,12,419,0,0,0,419,417,0,0,0,417
2020,46017,Lucca,LU,13,415,0,0,0,415,377,0,0,0,377
2020,46017,Lucca,LU,14,403,0,0,0,403,393,0,0,0,393
2020,46017,Lucca,LU,15,417,0,0,0,417,431,0,0,0,431
2020,46017,Lucca,LU,16,415,0,0,0,415,390,0,0,0,390
2020,46017,Lucca,LU,17,406,0,0,0,406,376,0,0,0,376
2020,46017,Lucca,LU,18,396,0,0,0,396,392,0,0,0,392
2020,46017,Lucca,LU,19,420,0,0,0,420,391,1,0,0,392
2020,46017,Lucca,LU,20,430,0,0,0,430,412,6,0,0,418
2020,46017,Lucca,LU,21,438,0,0,0,438,393,2,0,0,395
2020,46017,Lucca,LU,22,444,1,0,0,446,340,6,0,0,346
2020,46017,Lucca,LU,23,418,1,0,0,419,355,11,0,0,366
2020,46017,Lucca,LU,24,413,2,0,0,415,405,17,0,0,422
2020,46017,Lucca,LU,25,419,7,0,0,426,341,27,1,0,369
2020,46017,Lucca,LU,26,379,9,0,0,389,394,32,0,0,426
2020,46017,Lucca,LU,27,389,16,0,0,405,339,45,1,0,385
2020,46017,Lucca,LU,28,401,21,2,0,424,347,84,0,0,431
2020,46017,Lucca,LU,29,425,39,0,0,464,328,96,1,0,426
2020,46017,Lucca,LU,30,440,70,0,0,511,330,114,2,0,446
2020,46017,Lucca,LU,31,369,75,1,1,448,303,124,5,0,433
2020,46017,Lucca,LU,32,367,86,0,0,453,313,171,6,1,493
2020,46017,Lucca,LU,33,321,118,2,0,442,243,204,4,0,454
2020,46017,Lucca,LU,34,329,141,3,0,474,235,191,6,0,433
2020,46017,Lucca,LU,35,306,167,0,0,475,232,224,11,1,468
2020,46017,Lucca,LU,36,297,171,9,0,477,232,253,12,1,499
2020,46017,Lucca,LU,37,263,225,6,1,495,190,282,16,0,491
2020,46017,Lucca,LU,38,270,233,8,0,513,211,305,17,0,535
2020,46017,Lucca,LU,39,295,256,10,1,562,213,289,30,0,533
2020,46017,Lucca,LU,40,253,261,17,0,531,200,341,27,2,572
2020,46017,Lucca,LU,41,260,311,16,0,588,196,381,28,1,607
2020,46017,Lucca,LU,42,247,329,16,0,592,216,392,39,2,651
2020,46017,Lucca,LU,43,272,344,20,2,640,188,415,47,7,658
2020,46017,Lucca,LU,44,251,361,30,3,647,191,410,50,6,658
2020,46017,Lucca,LU,45,268,411,27,2,710,214,447,50,4,715
2020,46017,Lucca,LU,46,262,396,37,5,700,186,459,54,7,706
2020,46017,Lucca,LU,47,242,399,40,3,686,165,463,62,9,700
2020,46017,Lucca,LU,48,211,447,39,3,700,166,482,85,9,745
2020,46017,Lucca,LU,49,205,477,41,1,724,179,496,77,17,769
2020,46017,Lucca,LU,50,199,474,47,6,727,158,499,77,7,742
2020,46017,Lucca,LU,51,153,463,73,2,692,168,539,80,11,798
2020,46017,Lucca,LU,52,188,469,70,5,734,148,518,97,15,779
2020,46017,Lucca,LU,53,166,479,57,11,713,126,540,103,26,796
2020,46017,Lucca,LU,54,165,564,66,5,804,132,527,99,16,774
2020,46017,Lucca,LU,55,156,493,73,3,728,145,553,94,21,813
2020,46017,Lucca,LU,56,131,487,84,7,709,108,563,96,25,792
2020,46017,Lucca,LU,57,106,520,77,7,712,102,498,99,33,732
2020,46017,Lucca,LU,58,98,479,51,8,637,105,464,62,53,684
2020,46017,Lucca,LU,59,97,481,66,9,653,90,462,95,29,676
2020,46017,Lucca,LU,60,85,455,76,9,625,91,475,88,35,690
2020,46017,Lucca,LU,61,85,425,57,10,577,83,460,79,39,661
2020,46017,Lucca,LU,62,59,423,63,9,554,70,437,58,33,598
2020,46017,Lucca,LU,63,72,390,43,8,513,75,404,64,69,613
2020,46017,Lucca,LU,64,75,384,51,17,528,46,404,65,52,567
2020,46017,Lucca,LU,65,63,403,50,14,531,56,456,50,65,627
2020,46017,Lucca,LU,66,51,388,35,9,483,49,435,49,51,585
2020,46017,Lucca,LU,67,46,384,31,21,482,42,384,53,68,548
2020,46017,Lucca,LU,68,56,407,36,21,521,54,379,46,86,565
2020,46017,Lucca,LU,69,31,408,26,24,491,38,341,54,77,510
2020,46017,Lucca,LU,70,49,431,36,24,540,45,377,42,111,575
2020,46017,Lucca,LU,71,45,398,28,27,499,44,388,34,101,567
2020,46017,Lucca,LU,72,39,430,23,29,521,60,393,37,120,610
2020,46017,Lucca,LU,73,40,440,22,38,540,38,407,32,155,632
2020,46017,Lucca,LU,74,47,424,17,51,539,36,401,28,180,645
2020,46017,Lucca,LU,75,30,337,11,43,422,28,300,16,142,486
2020,46017,Lucca,LU,76,34,320,14,32,400,25,285,30,164,504
2020,46017,Lucca,LU,77,28,315,5,45,393,38,258,25,173,494
2020,46017,Lucca,LU,78,34,297,11,44,386,40,246,12,176,474
2020,46017,Lucca,LU,79,28,283,4,44,359,32,218,23,217,490
2020,46017,Lucca,LU,80,30,263,9,57,360,37,205,10,271,523
2020,46017,Lucca,LU,81,24,261,5,51,341,33,199,12,238,482
2020,46017,Lucca,LU,82,17,281,5,66,369,30,173,12,251,466
2020,46017,Lucca,LU,83,30,206,6,47,289,35,116,6,231,388
2020,46017,Lucca,LU,84,23,168,9,56,256,31,112,8,219,370
2020,46017,Lucca,LU,85,18,172,5,61,256,31,77,7,234,349
2020,46017,Lucca,LU,86,13,106,4,43,166,27,59,1,226,313
2020,46017,Lucca,LU,87,11,100,2,52,165,31,48,6,218,303
2020,46017,Lucca,LU,88,9,90,3,51,153,20,37,3,174,234
2020,46017,Lucca,LU,89,5,63,0,37,105,24,21,4,189,238
2020,46017,Lucca,LU,90,7,57,0,26,90,18,21,0,183,222
2020,46017,Lucca,LU,91,2,42,1,29,74,17,17,0,142,176
2020,46017,Lucca,LU,92,4,35,1,27,67,20,9,1,113,143
2020,46017,Lucca,LU,93,3,15,1,13,32,15,14,2,111,142
2020,46017,Lucca,LU,94,1,15,0,15,31,17,4,1,76,98
2020,46017,Lucca,LU,95,2,11,0,13,26,12,1,2,63,78
2020,46017,Lucca,LU,96,2,8,0,13,23,14,1,0,54,69
2020,46017,Lucca,LU,97,0,2,0,10,12,8,1,0,34,43
2020,46017,Lucca,LU,98,0,1,0,5,6,2,0,1,29,32
2020,46017,Lucca,LU,99,1,2,0,2,5,4,0,0,12,16
2020,46017,Lucca,LU,100 e più,0,0,0,0,0,2,1,0,24,27
2020,46018,Massarosa,LU,0,73,0,0,0,73,53,0,0,0,53
2020,46018,Massarosa,LU,1,50,0,0,0,50,54,0,0,0,54
2020,46018,Massarosa,LU,2,79,0,0,0,79,73,0,0,0,73
2020,46018,Massarosa,LU,3,81,0,0,0,81,77,0,0,0,77
2020,46018,Massarosa,LU,4,63,0,0,0,63,86,0,0,0,86
2020,46018,Massarosa,LU,5,93,0,0,0,93,73,0,0,0,73
2020,46018,Massarosa,LU,6,74,0,0,0,74,85,0,0,0,85
2020,46018,Massarosa,LU,7,75,0,0,0,75,83,0,0,0,83
2020,46018,Massarosa,LU,8,98,0,0,0,98,108,0,0,0,108
2020,46018,Massarosa,LU,9,109,0,0,0,109,98,0,0,0,98
2020,46018,Massarosa,LU,10,108,0,0,0,108,90,0,0,0,90
2020,46018,Massarosa,LU,11,112,0,0,0,112,90,0,0,0,90
2020,46018,Massarosa,LU,12,112,0,0,0,112,118,0,0,0,118
2020,46018,Massarosa,LU,13,122,0,0,0,122,95,0,0,0,95
2020,46018,Massarosa,LU,14,98,0,0,0,98,98,0,0,0,98
2020,46018,Massarosa,LU,15,123,0,0,0,123,96,0,0,0,96
2020,46018,Massarosa,LU,16,116,0,0,0,116,100,0,0,0,100
2020,46018,Massarosa,LU,17,100,0,0,0,100,90,0,0,0,90
2020,46018,Massarosa,LU,18,116,0,0,0,116,94,0,0,0,94
2020,46018,Massarosa,LU,19,120,0,0,0,120,89,1,0,0,90
2020,46018,Massarosa,LU,20,92,0,0,0,92,84,2,0,0,86
2020,46018,Massarosa,LU,21,103,0,0,0,103,84,1,0,0,85
2020,46018,Massarosa,LU,22,103,1,0,0,104,96,0,0,0,96
2020,46018,Massarosa,LU,23,85,0,0,0,85,90,3,0,0,93
2020,46018,Massarosa,LU,24,105,2,0,0,107,92,1,0,0,93
2020,46018,Massarosa,LU,25,106,0,0,0,106,80,3,0,0,83
2020,46018,Massarosa,LU,26,113,2,0,0,115,95,8,0,0,103
2020,46018,Massarosa,LU,27,102,5,0,0,107,95,9,0,0,104
2020,46018,Massarosa,LU,28,109,9,1,0,119,64,15,0,0,79
2020,46018,Massarosa,LU,29,85,5,0,0,90,82,17,1,0,100
2020,46018,Massarosa,LU,30,88,12,0,0,100,89,25,0,0,114
2020,46018,Massarosa,LU,31,83,9,1,0,93,70,24,1,0,95
2020,46018,Massarosa,LU,32,80,23,2,0,105,65,35,3,0,103
2020,46018,Massarosa,LU,33,84,24,0,0,108,72,39,3,0,114
2020,46018,Massarosa,LU,34,79,27,0,0,106,48,54,3,0,105
2020,46018,Massarosa,LU,35,64,32,1,0,97,60,47,8,0,115
2020,46018,Massarosa,LU,36,72,37,5,0,114,47,46,3,0,96
2020,46018,Massarosa,LU,37,76,46,2,0,124,43,59,7,1,110
2020,46018,Massarosa,LU,38,66,44,5,0,115,49,75,6,1,131
2020,46018,Massarosa,LU,39,60,57,3,0,121,46,70,12,0,129
2020,46018,Massarosa,LU,40,69,64,3,0,136,64,82,10,0,156
2020,46018,Massarosa,LU,41,56,60,5,0,121,49,79,13,0,142
2020,46018,Massarosa,LU,42,69,77,10,1,157,54,89,18,2,163
2020,46018,Massarosa,LU,43,71,64,6,0,141,50,112,6,3,172
2020,46018,Massarosa,LU,44,65,90,10,1,166,41,100,8,0,150
2020,46018,Massarosa,LU,45,58,75,9,0,142,45,116,17,0,178
2020,46018,Massarosa,LU,46,69,93,13,1,177,57,121,18,2,198
2020,46018,Massarosa,LU,47,69,105,6,1,181,44,128,16,2,191
2020,46018,Massarosa,LU,48,63,126,13,0,202,33,139,23,1,197
2020,46018,Massarosa,LU,49,53,143,16,0,212,44,166,22,2,234
2020,46018,Massarosa,LU,50,42,119,20,0,181,31,126,17,1,176
2020,46018,Massarosa,LU,51,48,123,18,0,189,37,128,29,5,199
2020,46018,Massarosa,LU,52,42,141,18,2,203,22,124,33,7,186
2020,46018,Massarosa,LU,53,44,123,12,1,181,25,130,21,8,184
2020,46018,Massarosa,LU,54,41,129,35,1,206,25,147,25,7,204
2020,46018,Massarosa,LU,55,47,130,18,2,197,24,136,20,7,187
2020,46018,Massarosa,LU,56,34,159,28,3,226,20,145,29,7,201
2020,46018,Massarosa,LU,57,39,141,22,3,205,16,178,29,6,229
2020,46018,Massarosa,LU,58,31,116,25,2,176,13,134,25,13,185
2020,46018,Massarosa,LU,59,19,144,17,3,184,21,128,22,9,180
2020,46018,Massarosa,LU,60,20,143,25,2,193,20,117,18,19,174
2020,46018,Massarosa,LU,61,17,122,13,5,157,8,123,21,18,170
2020,46018,Massarosa,LU,62,15,96,21,2,134,12,126,10,18,166
2020,46018,Massarosa,LU,63,17,121,14,4,156,10,110,16,16,152
2020,46018,Massarosa,LU,64,10,110,10,5,135,7,106,10,21,144
2020,46018,Massarosa,LU,65,13,94,13,3,123,8,113,10,20,151
2020,46018,Massarosa,LU,66,10,112,10,7,140,7,111,9,15,142
2020,46018,Massarosa,LU,67,6,119,15,4,144,10,78,13,20,121
2020,46018,Massarosa,LU,68,11,110,13,6,140,3,91,7,31,132
2020,46018,Massarosa,LU,69,8,92,7,2,109,5,93,11,25,134
2020,46018,Massarosa,LU,70,7,101,7,7,122,6,74,5,25,110
2020,46018,Massarosa,LU,71,11,114,3,8,136,8,92,6,29,135
2020,46018,Massarosa,LU,72,12,104,6,6,128,1,99,2,30,132
2020,46018,Massarosa,LU,73,9,110,3,7,129,5,91,4,46,146
2020,46018,Massarosa,LU,74,9,106,9,9,133,10,97,5,37,149
2020,46018,Massarosa,LU,75,8,86,2,5,101,2,64,4,41,111
2020,46018,Massarosa,LU,76,8,86,3,7,104,6,65,0,55,126
2020,46018,Massarosa,LU,77,5,79,5,8,97,4,48,1,41,94
2020,46018,Massarosa,LU,78,6,64,2,14,86,2,55,3,32,92
2020,46018,Massarosa,LU,79,3,58,5,13,79,2,50,4,50,106
2020,46018,Massarosa,LU,80,5,62,2,4,73,3,49,1,52,105
2020,46018,Massarosa,LU,81,3,66,2,12,83,6,40,2,56,104
2020,46018,Massarosa,LU,82,1,60,1,8,70,4,55,3,56,118
2020,46018,Massarosa,LU,83,8,43,1,11,63,5,42,3,60,110
2020,46018,Massarosa,LU,84,3,51,2,12,68,2,20,2,48,72
2020,46018,Massarosa,LU,85,1,43,2,8,54,3,24,1,52,80
2020,46018,Massarosa,LU,86,5,32,2,14,53,2,18,2,46,68
2020,46018,Massarosa,LU,87,3,26,1,9,39,2,10,0,52,64
2020,46018,Massarosa,LU,88,2,12,0,4,18,5,6,2,39,52
2020,46018,Massarosa,LU,89,3,21,0,7,31,2,3,2,35,42
2020,46018,Massarosa,LU,90,1,5,0,8,14,2,1,0,44,47
2020,46018,Massarosa,LU,91,0,6,0,2,8,1,0,1,33,35
2020,46018,Massarosa,LU,92,1,7,0,4,12,0,4,0,29,33
2020,46018,Massarosa,LU,93,0,3,0,2,5,1,1,0,20,22
2020,46018,Massarosa,LU,94,0,1,0,3,4,0,0,0,14,14
2020,46018,Massarosa,LU,95,0,1,0,0,1,0,0,0,6,6
2020,46018,Massarosa,LU,96,0,1,0,0,1,0,0,0,7,7
2020,46018,Massarosa,LU,97,2,1,0,1,4,2,0,0,7,9
2020,46018,Massarosa,LU,98,0,0,1,0,1,0,0,0,3,3
2020,46018,Massarosa,LU,99,0,1,0,0,1,0,0,0,5,5
2020,46018,Massarosa,LU,100 e più,0,0,0,0,0,0,0,0,6,6
2020,46019,Minucciano,LU,0,1,0,0,0,1,3,0,0,0,3
2020,46019,Minucciano,LU,1,4,0,0,0,4,4,0,0,0,4
2020,46019,Minucciano,LU,2,3,0,0,0,3,4,0,0,0,4
2020,46019,Minucciano,LU,3,4,0,0,0,4,4,0,0,0,4
2020,46019,Minucciano,LU,4,5,0,0,0,5,2,0,0,0,2
2020,46019,Minucciano,LU,5,0,0,0,0,0,3,0,0,0,3
2020,46019,Minucciano,LU,6,8,0,0,0,8,1,0,0,0,1
2020,46019,Minucciano,LU,7,4,0,0,0,4,6,0,0,0,6
2020,46019,Minucciano,LU,8,5,0,0,0,5,10,0,0,0,10
2020,46019,Minucciano,LU,9,7,0,0,0,7,5,0,0,0,5
2020,46019,Minucciano,LU,10,7,0,0,0,7,9,0,0,0,9
2020,46019,Minucciano,LU,11,4,0,0,0,4,2,0,0,0,2
2020,46019,Minucciano,LU,12,3,0,0,0,3,7,0,0,0,7
2020,46019,Minucciano,LU,13,8,0,0,0,8,9,0,0,0,9
2020,46019,Minucciano,LU,14,7,0,0,0,7,4,0,0,0,4
2020,46019,Minucciano,LU,15,5,0,0,0,5,4,0,0,0,4
2020,46019,Minucciano,LU,16,2,0,0,0,2,5,0,0,0,5
2020,46019,Minucciano,LU,17,7,0,0,0,7,1,0,0,0,1
2020,46019,Minucciano,LU,18,13,0,0,0,13,5,0,0,0,5
2020,46019,Minucciano,LU,19,5,0,0,0,5,7,0,0,0,7
2020,46019,Minucciano,LU,20,7,0,0,0,7,4,0,0,0,4
2020,46019,Minucciano,LU,21,2,0,0,0,2,7,0,0,0,7
2020,46019,Minucciano,LU,22,7,0,0,0,7,8,0,0,0,8
2020,46019,Minucciano,LU,23,8,0,0,0,8,6,0,0,0,6
2020,46019,Minucciano,LU,24,8,0,0,0,8,9,0,0,0,9
2020,46019,Minucciano,LU,25,8,0,0,0,8,11,0,0,0,11
2020,46019,Minucciano,LU,26,5,0,0,0,5,7,1,0,0,8
2020,46019,Minucciano,LU,27,10,1,0,0,11,2,1,0,0,3
2020,46019,Minucciano,LU,28,8,0,0,0,8,10,3,0,0,13
2020,46019,Minucciano,LU,29,9,1,0,0,10,5,1,1,0,7
2020,46019,Minucciano,LU,30,8,0,0,0,8,5,1,0,0,6
2020,46019,Minucciano,LU,31,7,1,0,0,8,2,2,0,0,4
2020,46019,Minucciano,LU,32,8,2,0,0,10,4,1,0,0,5
2020,46019,Minucciano,LU,33,11,0,0,0,11,2,1,0,0,3
2020,46019,Minucciano,LU,34,2,1,0,0,3,1,7,0,0,8
2020,46019,Minucciano,LU,35,7,1,0,0,8,3,4,0,0,7
2020,46019,Minucciano,LU,36,8,4,0,0,12,1,2,0,0,3
2020,46019,Minucciano,LU,37,7,4,0,0,11,4,1,0,0,5
2020,46019,Minucciano,LU,38,6,3,0,0,9,4,5,1,0,10
2020,46019,Minucciano,LU,39,4,3,0,0,7,1,2,0,0,3
2020,46019,Minucciano,LU,40,5,4,0,0,9,2,9,0,0,11
2020,46019,Minucciano,LU,41,4,6,0,0,10,6,4,0,0,10
2020,46019,Minucciano,LU,42,7,4,0,0,11,4,8,0,0,12
2020,46019,Minucciano,LU,43,7,8,0,0,15,4,6,0,0,10
2020,46019,Minucciano,LU,44,5,8,1,0,14,2,8,0,0,10
2020,46019,Minucciano,LU,45,3,6,1,0,10,2,8,0,0,10
2020,46019,Minucciano,LU,46,2,5,1,0,8,0,10,1,0,11
2020,46019,Minucciano,LU,47,3,9,0,0,12,6,4,2,0,12
2020,46019,Minucciano,LU,48,3,10,1,0,14,1,12,1,0,14
2020,46019,Minucciano,LU,49,2,9,0,0,11,1,10,2,0,13
2020,46019,Minucciano,LU,50,3,6,0,0,9,3,13,1,1,18
2020,46019,Minucciano,LU,51,1,19,0,0,20,2,10,0,0,12
2020,46019,Minucciano,LU,52,6,12,1,0,19,2,9,0,0,11
2020,46019,Minucciano,LU,53,3,11,2,0,16,2,15,1,1,19
2020,46019,Minucciano,LU,54,1,9,0,0,10,1,10,0,0,11
2020,46019,Minucciano,LU,55,3,17,0,0,20,2,11,1,0,14
2020,46019,Minucciano,LU,56,2,11,2,0,15,1,9,1,2,13
2020,46019,Minucciano,LU,57,2,7,0,0,9,1,13,2,0,16
2020,46019,Minucciano,LU,58,4,16,1,1,22,4,9,2,1,16
2020,46019,Minucciano,LU,59,3,9,0,0,12,1,7,2,2,12
2020,46019,Minucciano,LU,60,3,15,1,0,19,1,13,2,2,18
2020,46019,Minucciano,LU,61,4,9,0,0,13,1,13,1,1,16
2020,46019,Minucciano,LU,62,5,11,0,0,16,3,13,1,1,18
2020,46019,Minucciano,LU,63,5,7,1,0,13,0,16,2,2,20
2020,46019,Minucciano,LU,64,0,4,0,1,5,1,7,0,3,11
2020,46019,Minucciano,LU,65,5,8,3,0,16,0,13,0,4,17
2020,46019,Minucciano,LU,66,2,17,0,0,19,0,12,0,3,15
2020,46019,Minucciano,LU,67,3,12,2,0,17,0,8,2,2,12
2020,46019,Minucciano,LU,68,2,13,0,0,15,3,9,0,2,14
2020,46019,Minucciano,LU,69,0,13,1,2,16,1,13,0,3,17
2020,46019,Minucciano,LU,70,1,13,0,0,14,0,12,0,2,14
2020,46019,Minucciano,LU,71,3,12,0,0,15,0,7,1,2,10
2020,46019,Minucciano,LU,72,1,11,1,1,14,3,10,0,12,25
2020,46019,Minucciano,LU,73,4,13,0,0,17,0,11,1,5,17
2020,46019,Minucciano,LU,74,2,8,0,0,10,0,6,0,5,11
2020,46019,Minucciano,LU,75,0,3,0,1,4,1,9,0,5,15
2020,46019,Minucciano,LU,76,0,11,0,2,13,1,9,0,3,13
2020,46019,Minucciano,LU,77,1,8,0,2,11,0,8,0,4,12
2020,46019,Minucciano,LU,78,3,10,0,1,14,0,11,0,5,16
2020,46019,Minucciano,LU,79,1,5,0,2,8,0,5,0,6,11
2020,46019,Minucciano,LU,80,1,8,2,4,15,0,7,1,10,18
2020,46019,Minucciano,LU,81,2,7,0,1,10,0,10,0,6,16
2020,46019,Minucciano,LU,82,0,10,0,2,12,0,5,0,8,13
2020,46019,Minucciano,LU,83,0,6,0,1,7,0,3,0,5,8
2020,46019,Minucciano,LU,84,1,9,0,0,10,1,2,0,7,10
2020,46019,Minucciano,LU,85,0,4,0,4,8,1,1,0,8,10
2020,46019,Minucciano,LU,86,0,4,0,4,8,0,7,0,9,16
2020,46019,Minucciano,LU,87,1,5,0,0,6,1,3,0,8,12
2020,46019,Minucciano,LU,88,0,3,0,1,4,1,1,0,9,11
2020,46019,Minucciano,LU,89,0,5,0,0,5,0,3,0,9,12
2020,46019,Minucciano,LU,90,0,7,0,1,8,1,2,0,4,7
2020,46019,Minucciano,LU,91,1,0,0,2,3,0,0,0,7,7
2020,46019,Minucciano,LU,92,0,2,0,1,3,0,0,0,10,10
2020,46019,Minucciano,LU,93,0,0,0,0,0,0,0,0,5,5
2020,46019,Minucciano,LU,94,0,0,1,0,1,0,0,0,4,4
2020,46019,Minucciano,LU,95,0,1,0,1,2,0,1,0,3,4
2020,46019,Minucciano,LU,96,0,0,0,0,0,0,0,0,1,1
2020,46019,Minucciano,LU,97,0,0,0,0,0,0,0,0,1,1
2020,46019,Minucciano,LU,98,0,0,0,0,0,0,0,0,6,6
2020,46019,Minucciano,LU,99,0,0,0,0,0,0,0,0,0,0
2020,46019,Minucciano,LU,100 e più,0,0,0,0,0,0,0,0,0,0
2020,46020,Molazzana,LU,0,2,0,0,0,2,3,0,0,0,3
2020,46020,Molazzana,LU,1,5,0,0,0,5,1,0,0,0,1
2020,46020,Molazzana,LU,2,2,0,0,0,2,3,0,0,0,3
2020,46020,Molazzana,LU,3,1,0,0,0,1,7,0,0,0,7
2020,46020,Molazzana,LU,4,4,0,0,0,4,2,0,0,0,2
2020,46020,Molazzana,LU,5,2,0,0,0,2,0,0,0,0,0
2020,46020,Molazzana,LU,6,3,0,0,0,3,5,0,0,0,5
2020,46020,Molazzana,LU,7,1,0,0,0,1,1,0,0,0,1
2020,46020,Molazzana,LU,8,2,0,0,0,2,1,0,0,0,1
2020,46020,Molazzana,LU,9,3,0,0,0,3,1,0,0,0,1
2020,46020,Molazzana,LU,10,3,0,0,0,3,7,0,0,0,7
2020,46020,Molazzana,LU,11,2,0,0,0,2,6,0,0,0,6
2020,46020,Molazzana,LU,12,1,0,0,0,1,3,0,0,0,3
2020,46020,Molazzana,LU,13,4,0,0,0,4,3,0,0,0,3
2020,46020,Molazzana,LU,14,6,0,0,0,6,5,0,0,0,5
2020,46020,Molazzana,LU,15,3,0,0,0,3,5,0,0,0,5
2020,46020,Molazzana,LU,16,1,0,0,0,1,2,0,0,0,2
2020,46020,Molazzana,LU,17,2,0,0,0,2,6,0,0,0,6
2020,46020,Molazzana,LU,18,4,0,0,0,4,2,0,0,0,2
2020,46020,Molazzana,LU,19,4,0,0,0,4,4,0,0,0,4
2020,46020,Molazzana,LU,20,3,0,0,0,3,3,0,0,0,3
2020,46020,Molazzana,LU,21,3,0,0,0,3,5,0,0,0,5
2020,46020,Molazzana,LU,22,9,0,0,0,9,2,0,0,0,2
2020,46020,Molazzana,LU,23,6,0,0,0,6,3,0,0,0,3
2020,46020,Molazzana,LU,24,4,0,0,0,4,3,0,0,0,3
2020,46020,Molazzana,LU,25,3,0,0,0,3,5,0,0,0,5
2020,46020,Molazzana,LU,26,3,0,0,0,3,1,0,0,0,1
2020,46020,Molazzana,LU,27,8,0,0,0,8,2,1,0,0,3
2020,46020,Molazzana,LU,28,5,0,0,0,5,9,1,0,0,10
2020,46020,Molazzana,LU,29,4,0,0,0,4,2,0,0,0,2
2020,46020,Molazzana,LU,30,6,0,0,0,6,4,0,0,0,4
2020,46020,Molazzana,LU,31,2,1,0,0,3,6,1,0,0,7
2020,46020,Molazzana,LU,32,5,1,0,0,6,6,1,0,0,7
2020,46020,Molazzana,LU,33,6,0,0,0,6,1,5,0,0,6
2020,46020,Molazzana,LU,34,3,1,0,0,4,2,0,0,0,2
2020,46020,Molazzana,LU,35,7,2,0,0,9,3,2,0,0,5
2020,46020,Molazzana,LU,36,3,1,0,0,4,1,1,0,0,2
2020,46020,Molazzana,LU,37,2,1,0,0,3,3,4,0,0,7
2020,46020,Molazzana,LU,38,3,3,0,0,6,1,5,0,0,6
2020,46020,Molazzana,LU,39,0,0,0,0,0,0,6,0,0,6
2020,46020,Molazzana,LU,40,5,2,0,0,7,2,1,1,0,4
2020,46020,Molazzana,LU,41,4,2,1,0,7,1,4,0,0,5
2020,46020,Molazzana,LU,42,2,5,0,0,7,0,2,0,0,2
2020,46020,Molazzana,LU,43,6,5,0,0,11,1,6,0,0,7
2020,46020,Molazzana,LU,44,3,2,1,0,6,2,0,0,0,2
2020,46020,Molazzana,LU,45,6,1,0,0,7,3,5,3,0,11
2020,46020,Molazzana,LU,46,1,2,1,0,4,1,4,1,0,6
2020,46020,Molazzana,LU,47,3,3,1,0,7,0,10,0,0,10
2020,46020,Molazzana,LU,48,3,6,0,0,9,2,8,0,0,10
2020,46020,Molazzana,LU,49,3,2,0,0,5,2,2,0,0,4
2020,46020,Molazzana,LU,50,2,3,1,0,6,1,7,1,1,10
2020,46020,Molazzana,LU,51,0,5,1,0,6,1,7,0,0,8
2020,46020,Molazzana,LU,52,0,7,0,0,7,1,4,0,0,5
2020,46020,Molazzana,LU,53,4,3,0,0,7,3,7,0,0,10
2020,46020,Molazzana,LU,54,3,9,1,0,13,3,10,1,0,14
2020,46020,Molazzana,LU,55,1,10,1,0,12,1,8,0,0,9
2020,46020,Molazzana,LU,56,2,5,1,0,8,1,8,0,0,9
2020,46020,Molazzana,LU,57,3,5,1,0,9,0,6,2,0,8
2020,46020,Molazzana,LU,58,4,9,0,0,13,1,7,1,1,10
2020,46020,Molazzana,LU,59,1,7,1,0,9,0,6,1,3,10
2020,46020,Molazzana,LU,60,3,7,1,1,12,0,4,0,0,4
2020,46020,Molazzana,LU,61,0,7,1,0,8,1,4,0,1,6
2020,46020,Molazzana,LU,62,3,6,3,2,14,0,7,1,0,8
2020,46020,Molazzana,LU,63,1,4,0,1,6,0,4,0,1,5
2020,46020,Molazzana,LU,64,0,7,2,1,10,0,6,0,1,7
2020,46020,Molazzana,LU,65,0,6,0,0,6,0,7,0,0,7
2020,46020,Molazzana,LU,66,0,6,0,0,6,1,6,1,0,8
2020,46020,Molazzana,LU,67,2,5,0,0,7,2,6,0,1,9
2020,46020,Molazzana,LU,68,0,5,0,0,5,1,2,1,1,5
2020,46020,Molazzana,LU,69,0,5,1,0,6,0,4,0,3,7
2020,46020,Molazzana,LU,70,1,9,0,1,11,3,5,1,0,9
2020,46020,Molazzana,LU,71,1,9,0,0,10,0,5,0,4,9
2020,46020,Molazzana,LU,72,0,6,0,0,6,0,4,0,2,6
2020,46020,Molazzana,LU,73,3,2,0,2,7,0,5,0,0,5
2020,46020,Molazzana,LU,74,0,4,0,1,5,0,5,0,0,5
2020,46020,Molazzana,LU,75,0,2,0,0,2,1,2,0,0,3
2020,46020,Molazzana,LU,76,3,4,0,0,7,0,5,0,5,10
2020,46020,Molazzana,LU,77,0,3,0,0,3,0,3,0,2,5
2020,46020,Molazzana,LU,78,0,2,0,1,3,0,2,0,1,3
2020,46020,Molazzana,LU,79,0,4,0,0,4,0,4,0,1,5
2020,46020,Molazzana,LU,80,0,2,0,0,2,1,2,0,4,7
2020,46020,Molazzana,LU,81,1,4,0,0,5,0,2,0,6,8
2020,46020,Molazzana,LU,82,0,2,0,2,4,0,4,0,5,9
2020,46020,Molazzana,LU,83,1,3,0,2,6,0,2,1,5,8
2020,46020,Molazzana,LU,84,0,3,0,0,3,2,0,0,4,6
2020,46020,Molazzana,LU,85,0,4,0,2,6,1,3,0,6,10
2020,46020,Molazzana,LU,86,0,4,0,0,4,0,1,0,5,6
2020,46020,Molazzana,LU,87,1,2,0,3,6,0,1,0,3,4
2020,46020,Molazzana,LU,88,1,0,0,2,3,0,0,0,1,1
2020,46020,Molazzana,LU,89,1,0,0,4,5,0,0,0,2,2
2020,46020,Molazzana,LU,90,0,2,0,0,2,0,0,0,4,4
2020,46020,Molazzana,LU,91,0,0,0,0,0,0,0,0,3,3
2020,46020,Molazzana,LU,92,0,1,0,0,1,0,0,0,5,5
2020,46020,Molazzana,LU,93,0,0,0,1,1,1,0,0,4,5
2020,46020,Molazzana,LU,94,0,0,0,0,0,0,0,0,4,4
2020,46020,Molazzana,LU,95,0,0,0,0,0,0,0,0,3,3
2020,46020,Molazzana,LU,96,0,0,0,0,0,0,0,0,0,0
2020,46020,Molazzana,LU,97,0,0,0,0,0,0,0,0,0,0
2020,46020,Molazzana,LU,98,0,0,0,0,0,0,0,0,0,0
2020,46020,Molazzana,LU,99,0,0,0,0,0,1,0,0,0,1
2020,46020,Molazzana,LU,100 e più,0,0,0,0,0,0,0,0,0,0
2020,46021,Montecarlo,LU,0,28,0,0,0,28,19,0,0,0,19
2020,46021,Montecarlo,LU,1,11,0,0,0,11,17,0,0,0,17
2020,46021,Montecarlo,LU,2,9,0,0,0,9,10,0,0,0,10
2020,46021,Montecarlo,LU,3,19,0,0,0,19,17,0,0,0,17
2020,46021,Montecarlo,LU,4,25,0,0,0,25,14,0,0,0,14
2020,46021,Montecarlo,LU,5,16,0,0,0,16,12,0,0,0,12
2020,46021,Montecarlo,LU,6,13,0,0,0,13,18,0,0,0,18
2020,46021,Montecarlo,LU,7,17,0,0,0,17,18,0,0,0,18
2020,46021,Montecarlo,LU,8,21,0,0,0,21,15,0,0,0,15
2020,46021,Montecarlo,LU,9,19,0,0,0,19,18,0,0,0,18
2020,46021,Montecarlo,LU,10,15,0,0,0,15,16,0,0,0,16
2020,46021,Montecarlo,LU,11,28,0,0,0,28,24,0,0,0,24
2020,46021,Montecarlo,LU,12,22,0,0,0,22,20,0,0,0,20
2020,46021,Montecarlo,LU,13,18,0,0,0,18,22,0,0,0,22
2020,46021,Montecarlo,LU,14,20,0,0,0,20,21,0,0,0,21
2020,46021,Montecarlo,LU,15,14,0,0,0,14,34,0,0,0,34
2020,46021,Montecarlo,LU,16,27,0,0,0,27,19,0,0,0,19
2020,46021,Montecarlo,LU,17,22,0,0,0,22,18,0,0,0,18
2020,46021,Montecarlo,LU,18,20,0,0,0,20,16,0,0,0,16
2020,46021,Montecarlo,LU,19,30,0,0,0,30,20,1,0,0,21
2020,46021,Montecarlo,LU,20,20,0,0,0,20,21,1,0,0,22
2020,46021,Montecarlo,LU,21,19,0,0,0,19,16,0,0,0,16
2020,46021,Montecarlo,LU,22,20,1,0,0,21,16,2,0,0,18
2020,46021,Montecarlo,LU,23,20,0,0,0,20,21,1,0,0,22
2020,46021,Montecarlo,LU,24,21,1,0,0,22,13,2,0,0,15
2020,46021,Montecarlo,LU,25,20,0,0,0,20,13,2,0,0,15
2020,46021,Montecarlo,LU,26,20,1,0,0,21,31,0,0,0,31
2020,46021,Montecarlo,LU,27,17,0,0,0,17,17,2,0,0,19
2020,46021,Montecarlo,LU,28,16,0,0,0,16,20,6,0,0,26
2020,46021,Montecarlo,LU,29,21,2,1,0,24,20,2,1,0,23
2020,46021,Montecarlo,LU,30,19,6,0,0,25,15,12,0,0,27
2020,46021,Montecarlo,LU,31,18,6,0,0,24,14,10,0,0,24
2020,46021,Montecarlo,LU,32,11,6,0,0,17,16,15,0,0,31
2020,46021,Montecarlo,LU,33,16,15,0,0,31,16,8,1,0,25
2020,46021,Montecarlo,LU,34,12,5,0,0,17,9,14,1,0,24
2020,46021,Montecarlo,LU,35,11,6,0,0,17,13,6,2,0,21
2020,46021,Montecarlo,LU,36,7,12,0,0,19,8,11,1,0,20
2020,46021,Montecarlo,LU,37,15,11,0,0,26,11,15,0,0,26
2020,46021,Montecarlo,LU,38,10,15,1,0,26,10,17,0,0,27
2020,46021,Montecarlo,LU,39,14,14,1,0,29,9,15,1,0,25
2020,46021,Montecarlo,LU,40,11,10,0,0,21,7,19,0,0,26
2020,46021,Montecarlo,LU,41,18,12,5,0,35,8,15,2,0,25
2020,46021,Montecarlo,LU,42,9,10,1,0,20,8,14,3,0,25
2020,46021,Montecarlo,LU,43,12,23,1,0,36,6,23,0,0,29
2020,46021,Montecarlo,LU,44,11,17,0,0,28,9,20,0,0,29
2020,46021,Montecarlo,LU,45,12,23,2,0,37,12,28,1,0,41
2020,46021,Montecarlo,LU,46,7,25,3,0,35,9,20,2,0,31
2020,46021,Montecarlo,LU,47,5,22,1,0,28,8,20,3,2,33
2020,46021,Montecarlo,LU,48,12,25,2,0,39,6,34,2,0,42
2020,46021,Montecarlo,LU,49,5,21,2,1,29,5,33,2,0,40
2020,46021,Montecarlo,LU,50,6,27,1,0,34,9,26,4,1,40
2020,46021,Montecarlo,LU,51,4,25,5,0,34,5,27,1,1,34
2020,46021,Montecarlo,LU,52,4,26,4,0,34,5,27,1,3,36
2020,46021,Montecarlo,LU,53,5,36,3,0,44,4,29,3,1,37
2020,46021,Montecarlo,LU,54,7,35,1,0,43,3,28,3,1,35
2020,46021,Montecarlo,LU,55,3,20,0,1,24,2,38,4,1,45
2020,46021,Montecarlo,LU,56,6,26,1,0,33,3,28,6,0,37
2020,46021,Montecarlo,LU,57,2,28,5,0,35,3,27,1,1,32
2020,46021,Montecarlo,LU,58,9,29,2,1,41,2,23,2,2,29
2020,46021,Montecarlo,LU,59,2,22,1,0,25,2,31,4,2,39
2020,46021,Montecarlo,LU,60,6,26,5,2,39,2,28,2,3,35
2020,46021,Montecarlo,LU,61,0,22,2,2,26,1,28,3,3,35
2020,46021,Montecarlo,LU,62,3,25,2,0,30,3,29,1,2,35
2020,46021,Montecarlo,LU,63,4,26,2,0,32,0,16,2,2,20
2020,46021,Montecarlo,LU,64,1,25,0,0,26,1,22,1,4,28
2020,46021,Montecarlo,LU,65,3,27,1,0,31,1,23,1,4,29
2020,46021,Montecarlo,LU,66,2,18,0,1,21,3,21,0,5,29
2020,46021,Montecarlo,LU,67,1,22,0,0,23,1,18,3,1,23
2020,46021,Montecarlo,LU,68,1,36,1,0,38,0,22,2,5,29
2020,46021,Montecarlo,LU,69,1,22,1,1,25,5,22,2,9,38
2020,46021,Montecarlo,LU,70,1,20,2,1,24,1,18,4,6,29
2020,46021,Montecarlo,LU,71,0,19,0,0,19,0,23,1,10,34
2020,46021,Montecarlo,LU,72,2,23,1,2,28,2,20,0,4,26
2020,46021,Montecarlo,LU,73,2,23,1,1,27,2,12,2,11,27
2020,46021,Montecarlo,LU,74,0,17,1,3,21,0,15,1,11,27
2020,46021,Montecarlo,LU,75,1,21,1,0,23,1,15,1,7,24
2020,46021,Montecarlo,LU,76,0,10,0,3,13,1,10,1,8,20
2020,46021,Montecarlo,LU,77,0,11,0,1,12,0,11,0,9,20
2020,46021,Montecarlo,LU,78,3,7,1,2,13,0,8,0,8,16
2020,46021,Montecarlo,LU,79,1,20,0,3,24,1,9,0,8,18
2020,46021,Montecarlo,LU,80,1,13,0,1,15,0,7,0,10,17
2020,46021,Montecarlo,LU,81,0,14,0,6,20,0,8,0,8,16
2020,46021,Montecarlo,LU,82,3,7,0,5,15,1,7,0,11,19
2020,46021,Montecarlo,LU,83,0,8,1,4,13,0,10,0,9,19
2020,46021,Montecarlo,LU,84,1,7,0,3,11,0,3,0,7,10
2020,46021,Montecarlo,LU,85,0,13,0,3,16,1,2,2,7,12
2020,46021,Montecarlo,LU,86,0,2,0,6,8,1,5,0,11,17
2020,46021,Montecarlo,LU,87,0,2,0,1,3,2,1,0,9,12
2020,46021,Montecarlo,LU,88,0,6,0,1,7,0,0,0,8,8
2020,46021,Montecarlo,LU,89,0,5,0,2,7,2,1,0,4,7
2020,46021,Montecarlo,LU,90,0,3,0,1,4,3,0,0,11,14
2020,46021,Montecarlo,LU,91,0,2,0,3,5,1,0,0,9,10
2020,46021,Montecarlo,LU,92,0,2,0,0,2,0,1,1,4,6
2020,46021,Montecarlo,LU,93,2,1,0,0,3,0,0,0,9,9
2020,46021,Montecarlo,LU,94,0,0,0,0,0,0,0,0,7,7
2020,46021,Montecarlo,LU,95,0,0,0,0,0,0,0,0,7,7
2020,46021,Montecarlo,LU,96,0,0,0,0,0,1,0,0,1,2
2020,46021,Montecarlo,LU,97,0,0,0,0,0,0,0,0,2,2
2020,46021,Montecarlo,LU,98,0,0,0,0,0,0,0,0,1,1
2020,46021,Montecarlo,LU,99,0,0,0,0,0,0,0,0,0,0
2020,46021,Montecarlo,LU,100 e più,0,0,0,0,0,0,0,0,1,1
2020,46022,Pescaglia,LU,0,4,0,0,0,4,10,0,0,0,10
2020,46022,Pescaglia,LU,1,13,0,0,0,13,7,0,0,0,7
2020,46022,Pescaglia,LU,2,9,0,0,0,9,9,0,0,0,9
2020,46022,Pescaglia,LU,3,6,0,0,0,6,2,0,0,0,2
2020,46022,Pescaglia,LU,4,6,0,0,0,6,7,0,0,0,7
2020,46022,Pescaglia,LU,5,9,0,0,0,9,6,0,0,0,6
2020,46022,Pescaglia,LU,6,13,0,0,0,13,12,0,0,0,12
2020,46022,Pescaglia,LU,7,16,0,0,0,16,10,0,0,0,10
2020,46022,Pescaglia,LU,8,11,0,0,0,11,7,0,0,0,7
2020,46022,Pescaglia,LU,9,13,0,0,0,13,17,0,0,0,17
2020,46022,Pescaglia,LU,10,11,0,0,0,11,14,0,0,0,14
2020,46022,Pescaglia,LU,11,9,0,0,0,9,9,0,0,0,9
2020,46022,Pescaglia,LU,12,14,0,0,0,14,20,0,0,0,20
2020,46022,Pescaglia,LU,13,12,0,0,0,12,17,0,0,0,17
2020,46022,Pescaglia,LU,14,13,0,0,0,13,10,0,0,0,10
2020,46022,Pescaglia,LU,15,15,0,0,0,15,15,0,0,0,15
2020,46022,Pescaglia,LU,16,12,0,0,0,12,18,0,0,0,18
2020,46022,Pescaglia,LU,17,19,0,0,0,19,8,0,0,0,8
2020,46022,Pescaglia,LU,18,13,0,0,0,13,12,0,0,0,12
2020,46022,Pescaglia,LU,19,16,0,0,0,16,14,0,0,0,14
2020,46022,Pescaglia,LU,20,14,0,0,0,14,11,0,0,0,11
2020,46022,Pescaglia,LU,21,22,0,0,0,22,14,0,0,0,14
2020,46022,Pescaglia,LU,22,16,0,0,0,16,23,0,0,0,23
2020,46022,Pescaglia,LU,23,19,0,0,0,19,11,0,0,0,11
2020,46022,Pescaglia,LU,24,11,0,0,0,11,20,0,0,0,20
2020,46022,Pescaglia,LU,25,18,0,0,0,18,13,1,0,0,14
2020,46022,Pescaglia,LU,26,13,0,0,0,13,15,2,0,0,17
2020,46022,Pescaglia,LU,27,14,0,0,0,14,11,1,0,0,12
2020,46022,Pescaglia,LU,28,17,0,0,0,17,11,3,0,0,14
2020,46022,Pescaglia,LU,29,21,0,0,0,21,10,2,1,0,13
2020,46022,Pescaglia,LU,30,9,0,0,0,9,9,2,0,0,11
2020,46022,Pescaglia,LU,31,10,0,0,0,10,9,3,0,0,12
2020,46022,Pescaglia,LU,32,13,6,0,0,19,12,8,0,0,20
2020,46022,Pescaglia,LU,33,8,6,0,0,14,6,2,1,0,9
2020,46022,Pescaglia,LU,34,8,1,0,0,9,9,7,0,0,16
2020,46022,Pescaglia,LU,35,13,0,1,0,14,5,7,0,0,12
2020,46022,Pescaglia,LU,36,7,4,0,0,11,10,10,2,0,22
2020,46022,Pescaglia,LU,37,18,8,0,0,26,6,5,0,0,11
2020,46022,Pescaglia,LU,38,5,9,1,0,15,4,12,0,0,16
2020,46022,Pescaglia,LU,39,9,10,1,0,20,4,9,1,0,14
2020,46022,Pescaglia,LU,40,11,12,0,0,23,2,20,0,0,22
2020,46022,Pescaglia,LU,41,9,8,0,0,17,5,10,1,0,16
2020,46022,Pescaglia,LU,42,5,11,0,0,16,6,14,2,0,22
2020,46022,Pescaglia,LU,43,9,10,2,0,21,5,10,1,0,16
2020,46022,Pescaglia,LU,44,4,16,0,0,20,8,25,0,0,33
2020,46022,Pescaglia,LU,45,18,15,1,0,34,4,18,3,2,27
2020,46022,Pescaglia,LU,46,9,21,1,0,31,4,19,6,1,30
2020,46022,Pescaglia,LU,47,8,19,1,0,28,5,17,3,2,27
2020,46022,Pescaglia,LU,48,6,14,1,0,21,2,18,0,0,20
2020,46022,Pescaglia,LU,49,13,19,2,0,34,0,17,3,0,20
2020,46022,Pescaglia,LU,50,6,16,3,1,26,6,24,1,2,33
2020,46022,Pescaglia,LU,51,4,20,2,0,26,3,21,2,1,27
2020,46022,Pescaglia,LU,52,3,26,2,0,31,3,26,0,1,30
2020,46022,Pescaglia,LU,53,5,14,4,0,23,1,25,4,0,30
2020,46022,Pescaglia,LU,54,7,19,2,0,28,6,29,2,0,37
2020,46022,Pescaglia,LU,55,6,30,2,0,38,3,22,6,0,31
2020,46022,Pescaglia,LU,56,2,25,4,0,31,0,22,3,3,28
2020,46022,Pescaglia,LU,57,7,21,3,1,32,2,12,2,3,19
2020,46022,Pescaglia,LU,58,6,21,0,0,27,1,24,2,2,29
2020,46022,Pescaglia,LU,59,4,21,2,2,29,2,21,3,2,28
2020,46022,Pescaglia,LU,60,7,14,0,1,22,1,20,1,1,23
2020,46022,Pescaglia,LU,61,7,17,5,1,30,2,20,4,2,28
2020,46022,Pescaglia,LU,62,3,24,2,0,29,0,26,2,5,33
2020,46022,Pescaglia,LU,63,4,17,4,0,25,0,14,2,1,17
2020,46022,Pescaglia,LU,64,3,24,3,1,31,1,19,0,4,24
2020,46022,Pescaglia,LU,65,1,11,0,0,12,4,15,1,2,22
2020,46022,Pescaglia,LU,66,1,30,3,1,35,1,21,0,3,25
2020,46022,Pescaglia,LU,67,1,10,6,1,18,2,15,0,5,22
2020,46022,Pescaglia,LU,68,3,17,0,0,20,2,20,1,7,30
2020,46022,Pescaglia,LU,69,1,12,1,1,15,0,14,1,6,21
2020,46022,Pescaglia,LU,70,0,16,1,1,18,1,14,0,4,19
2020,46022,Pescaglia,LU,71,3,27,0,1,31,0,15,2,6,23
2020,46022,Pescaglia,LU,72,1,24,3,2,30,1,24,1,7,33
2020,46022,Pescaglia,LU,73,2,17,3,3,25,1,14,0,5,20
2020,46022,Pescaglia,LU,74,1,17,0,2,20,2,17,0,3,22
2020,46022,Pescaglia,LU,75,3,10,1,0,14,2,7,0,4,13
2020,46022,Pescaglia,LU,76,5,15,0,1,21,1,9,1,7,18
2020,46022,Pescaglia,LU,77,4,14,1,5,24,2,10,0,6,18
2020,46022,Pescaglia,LU,78,0,19,0,1,20,1,13,0,8,22
2020,46022,Pescaglia,LU,79,1,15,0,1,17,1,5,0,12,18
2020,46022,Pescaglia,LU,80,1,11,0,1,13,0,11,0,9,20
2020,46022,Pescaglia,LU,81,2,9,0,1,12,0,2,1,6,9
2020,46022,Pescaglia,LU,82,3,9,0,7,19,0,4,0,7,11
2020,46022,Pescaglia,LU,83,0,11,1,4,16,2,2,1,12,17
2020,46022,Pescaglia,LU,84,1,8,0,3,12,1,6,0,13,20
2020,46022,Pescaglia,LU,85,2,9,1,1,13,1,6,1,11,19
2020,46022,Pescaglia,LU,86,1,7,0,2,10,2,4,0,8,14
2020,46022,Pescaglia,LU,87,1,3,0,2,6,0,3,0,4,7
2020,46022,Pescaglia,LU,88,2,4,0,1,7,2,5,0,8,15
2020,46022,Pescaglia,LU,89,2,3,0,0,5,1,0,0,10,11
2020,46022,Pescaglia,LU,90,3,1,0,2,6,0,1,0,6,7
2020,46022,Pescaglia,LU,91,0,1,0,1,2,2,1,0,6,9
2020,46022,Pescaglia,LU,92,0,0,0,1,1,0,1,0,6,7
2020,46022,Pescaglia,LU,93,0,0,0,2,2,0,0,0,3,3
2020,46022,Pescaglia,LU,94,0,2,0,1,3,0,0,0,1,1
2020,46022,Pescaglia,LU,95,0,0,0,1,1,0,0,0,6,6
2020,46022,Pescaglia,LU,96,0,0,0,0,0,0,0,0,4,4
2020,46022,Pescaglia,LU,97,0,0,0,0,0,0,0,0,0,0
2020,46022,Pescaglia,LU,98,0,0,0,0,0,0,0,0,0,0
2020,46022,Pescaglia,LU,99,0,0,0,0,0,0,0,0,0,0
2020,46022,Pescaglia,LU,100 e più,0,0,0,0,0,0,0,0,3,3
2020,46023,Piazza al Serchio,LU,0,1,0,0,0,1,2,0,0,0,2
2020,46023,Piazza al Serchio,LU,1,4,0,0,0,4,2,0,0,0,2
2020,46023,Piazza al Serchio,LU,2,4,0,0,0,4,1,0,0,0,1
2020,46023,Piazza al Serchio,LU,3,4,0,0,0,4,6,0,0,0,6
2020,46023,Piazza al Serchio,LU,4,3,0,0,0,3,6,0,0,0,6
2020,46023,Piazza al Serchio,LU,5,3,0,0,0,3,4,0,0,0,4
2020,46023,Piazza al Serchio,LU,6,10,0,0,0,10,2,0,0,0,2
2020,46023,Piazza al Serchio,LU,7,3,0,0,0,3,9,0,0,0,9
2020,46023,Piazza al Serchio,LU,8,9,0,0,0,9,8,0,0,0,8
2020,46023,Piazza al Serchio,LU,9,9,0,0,0,9,6,0,0,0,6
2020,46023,Piazza al Serchio,LU,10,6,0,0,0,6,11,0,0,0,11
2020,46023,Piazza al Serchio,LU,11,8,0,0,0,8,9,0,0,0,9
2020,46023,Piazza al Serchio,LU,12,8,0,0,0,8,6,0,0,0,6
2020,46023,Piazza al Serchio,LU,13,9,0,0,0,9,4,0,0,0,4
2020,46023,Piazza al Serchio,LU,14,7,0,0,0,7,15,0,0,0,15
2020,46023,Piazza al Serchio,LU,15,10,0,0,0,10,9,0,0,0,9
2020,46023,Piazza al Serchio,LU,16,11,0,0,0,11,12,0,0,0,12
2020,46023,Piazza al Serchio,LU,17,10,0,0,0,10,8,0,0,0,8
2020,46023,Piazza al Serchio,LU,18,13,0,0,0,13,3,0,0,0,3
2020,46023,Piazza al Serchio,LU,19,11,0,0,0,11,13,0,0,0,13
2020,46023,Piazza al Serchio,LU,20,8,0,0,0,8,8,0,0,0,8
2020,46023,Piazza al Serchio,LU,21,4,0,0,0,4,4,0,0,0,4
2020,46023,Piazza al Serchio,LU,22,16,0,0,0,16,9,0,0,0,9
2020,46023,Piazza al Serchio,LU,23,10,0,0,0,10,3,0,0,0,3
2020,46023,Piazza al Serchio,LU,24,14,0,0,0,14,13,0,0,0,13
2020,46023,Piazza al Serchio,LU,25,14,1,0,0,15,12,1,0,0,13
2020,46023,Piazza al Serchio,LU,26,10,0,0,0,10,6,0,0,0,6
2020,46023,Piazza al Serchio,LU,27,11,1,0,0,12,9,2,0,0,11
2020,46023,Piazza al Serchio,LU,28,9,0,0,0,9,6,0,0,0,6
2020,46023,Piazza al Serchio,LU,29,10,0,0,0,10,9,1,0,0,10
2020,46023,Piazza al Serchio,LU,30,11,0,0,0,11,9,4,0,0,13
2020,46023,Piazza al Serchio,LU,31,8,0,0,0,8,8,2,0,0,10
2020,46023,Piazza al Serchio,LU,32,9,2,0,0,11,5,3,0,0,8
2020,46023,Piazza al Serchio,LU,33,10,0,0,0,10,8,3,0,0,11
2020,46023,Piazza al Serchio,LU,34,14,3,0,0,17,5,5,0,0,10
2020,46023,Piazza al Serchio,LU,35,5,2,0,0,7,5,9,0,0,14
2020,46023,Piazza al Serchio,LU,36,6,4,0,0,10,2,4,0,0,6
2020,46023,Piazza al Serchio,LU,37,5,3,0,0,8,4,4,1,0,9
2020,46023,Piazza al Serchio,LU,38,6,3,0,0,9,3,4,2,0,9
2020,46023,Piazza al Serchio,LU,39,9,3,1,0,13,1,5,0,0,6
2020,46023,Piazza al Serchio,LU,40,8,4,0,0,12,5,6,2,0,13
2020,46023,Piazza al Serchio,LU,41,5,9,1,0,15,3,5,0,0,8
2020,46023,Piazza al Serchio,LU,42,3,3,0,0,6,4,10,0,0,14
2020,46023,Piazza al Serchio,LU,43,7,10,0,0,17,4,14,1,0,19
2020,46023,Piazza al Serchio,LU,44,8,7,0,0,15,9,9,1,0,19
2020,46023,Piazza al Serchio,LU,45,4,2,0,0,6,2,6,2,0,10
2020,46023,Piazza al Serchio,LU,46,3,9,2,0,14,3,8,0,0,11
2020,46023,Piazza al Serchio,LU,47,3,10,1,0,14,3,15,1,0,19
2020,46023,Piazza al Serchio,LU,48,6,14,0,0,20,1,10,1,0,12
2020,46023,Piazza al Serchio,LU,49,4,10,0,0,14,5,12,0,0,17
2020,46023,Piazza al Serchio,LU,50,4,9,0,0,13,1,17,1,0,19
2020,46023,Piazza al Serchio,LU,51,5,11,4,0,20,2,24,1,0,27
2020,46023,Piazza al Serchio,LU,52,4,13,1,1,19,7,19,1,1,28
2020,46023,Piazza al Serchio,LU,53,1,25,1,0,27,1,17,1,1,20
2020,46023,Piazza al Serchio,LU,54,3,12,0,0,15,2,16,0,0,18
2020,46023,Piazza al Serchio,LU,55,5,19,1,0,25,2,11,2,1,16
2020,46023,Piazza al Serchio,LU,56,4,19,0,1,24,2,13,2,1,18
2020,46023,Piazza al Serchio,LU,57,2,21,1,0,24,2,17,0,1,20
2020,46023,Piazza al Serchio,LU,58,2,18,0,0,20,2,14,0,1,17
2020,46023,Piazza al Serchio,LU,59,1,14,0,0,15,1,14,1,2,18
2020,46023,Piazza al Serchio,LU,60,1,6,1,0,8,0,13,2,4,19
2020,46023,Piazza al Serchio,LU,61,1,19,1,0,21,1,22,0,2,25
2020,46023,Piazza al Serchio,LU,62,1,6,0,0,7,2,19,1,1,23
2020,46023,Piazza al Serchio,LU,63,4,16,0,0,20,1,8,0,2,11
2020,46023,Piazza al Serchio,LU,64,0,15,0,2,17,0,11,0,1,12
2020,46023,Piazza al Serchio,LU,65,3,8,2,2,15,0,11,0,3,14
2020,46023,Piazza al Serchio,LU,66,1,15,2,1,19,1,12,1,1,15
2020,46023,Piazza al Serchio,LU,67,2,13,0,0,15,0,14,0,4,18
2020,46023,Piazza al Serchio,LU,68,1,13,1,0,15,0,14,0,3,17
2020,46023,Piazza al Serchio,LU,69,0,9,0,0,9,0,12,1,5,18
2020,46023,Piazza al Serchio,LU,70,0,16,0,2,18,0,10,0,5,15
2020,46023,Piazza al Serchio,LU,71,0,13,1,2,16,1,6,0,3,10
2020,46023,Piazza al Serchio,LU,72,4,14,0,1,19,1,13,1,4,19
2020,46023,Piazza al Serchio,LU,73,3,15,0,1,19,0,17,1,5,23
2020,46023,Piazza al Serchio,LU,74,0,15,0,2,17,0,14,0,4,18
2020,46023,Piazza al Serchio,LU,75,3,5,0,0,8,0,2,0,4,6
2020,46023,Piazza al Serchio,LU,76,0,9,0,1,10,1,5,0,7,13
2020,46023,Piazza al Serchio,LU,77,1,14,0,3,18,1,7,0,2,10
2020,46023,Piazza al Serchio,LU,78,0,6,0,1,7,0,6,0,9,15
2020,46023,Piazza al Serchio,LU,79,0,8,0,3,11,0,5,0,5,10
2020,46023,Piazza al Serchio,LU,80,1,13,0,2,16,0,5,0,8,13
2020,46023,Piazza al Serchio,LU,81,1,2,0,2,5,2,7,0,6,15
2020,46023,Piazza al Serchio,LU,82,1,7,0,1,9,1,4,0,11,16
2020,46023,Piazza al Serchio,LU,83,3,3,0,1,7,0,3,1,13,17
2020,46023,Piazza al Serchio,LU,84,0,2,0,1,3,0,2,0,4,6
2020,46023,Piazza al Serchio,LU,85,1,4,0,3,8,0,1,0,7,8
2020,46023,Piazza al Serchio,LU,86,1,5,0,1,7,0,0,1,10,11
2020,46023,Piazza al Serchio,LU,87,2,2,0,0,4,1,2,1,8,12
2020,46023,Piazza al Serchio,LU,88,0,1,0,0,1,1,1,0,8,10
2020,46023,Piazza al Serchio,LU,89,0,2,0,3,5,0,2,0,8,10
2020,46023,Piazza al Serchio,LU,90,1,4,0,1,6,1,0,0,10,11
2020,46023,Piazza al Serchio,LU,91,0,0,0,0,0,1,0,0,4,5
2020,46023,Piazza al Serchio,LU,92,0,0,0,0,0,1,0,0,2,3
2020,46023,Piazza al Serchio,LU,93,1,1,0,0,2,1,0,0,4,5
2020,46023,Piazza al Serchio,LU,94,0,0,0,0,0,1,0,0,1,2
2020,46023,Piazza al Serchio,LU,95,0,0,0,0,0,0,0,0,5,5
2020,46023,Piazza al Serchio,LU,96,0,1,0,0,1,0,0,0,3,3
2020,46023,Piazza al Serchio,LU,97,0,0,0,0,0,0,0,0,1,1
2020,46023,Piazza al Serchio,LU,98,0,0,0,0,0,0,0,0,2,2
2020,46023,Piazza al Serchio,LU,99,0,0,0,0,0,0,0,0,0,0
2020,46023,Piazza al Serchio,LU,100 e più,0,0,0,0,0,0,0,0,1,1
2020,46024,Pietrasanta,LU,0,61,0,0,0,61,57,0,0,0,57
2020,46024,Pietrasanta,LU,1,50,0,0,0,50,56,0,0,0,56
2020,46024,Pietrasanta,LU,2,67,0,0,0,67,63,0,0,0,63
2020,46024,Pietrasanta,LU,3,68,0,0,0,68,77,0,0,0,77
2020,46024,Pietrasanta,LU,4,77,0,0,0,77,59,0,0,0,59
2020,46024,Pietrasanta,LU,5,95,0,0,0,95,63,0,0,0,63
2020,46024,Pietrasanta,LU,6,65,0,0,0,65,79,0,0,0,79
2020,46024,Pietrasanta,LU,7,75,0,0,0,75,87,0,0,0,87
2020,46024,Pietrasanta,LU,8,77,0,0,0,77,86,0,0,0,86
2020,46024,Pietrasanta,LU,9,90,0,0,0,90,85,0,0,0,85
2020,46024,Pietrasanta,LU,10,112,0,0,0,112,86,0,0,0,86
2020,46024,Pietrasanta,LU,11,82,0,0,0,82,84,0,0,0,84
2020,46024,Pietrasanta,LU,12,96,0,0,0,96,100,0,0,0,100
2020,46024,Pietrasanta,LU,13,105,0,0,0,105,83,0,0,0,83
2020,46024,Pietrasanta,LU,14,81,0,0,0,81,104,0,0,0,104
2020,46024,Pietrasanta,LU,15,96,0,0,0,96,114,0,0,0,114
2020,46024,Pietrasanta,LU,16,104,0,0,0,104,119,0,0,0,119
2020,46024,Pietrasanta,LU,17,95,0,0,0,95,84,0,0,0,84
2020,46024,Pietrasanta,LU,18,111,0,0,0,111,105,0,0,0,105
2020,46024,Pietrasanta,LU,19,85,0,0,0,85,94,0,0,0,94
2020,46024,Pietrasanta,LU,20,83,0,0,0,83,93,0,0,0,93
2020,46024,Pietrasanta,LU,21,94,0,0,0,94,76,1,0,0,77
2020,46024,Pietrasanta,LU,22,89,0,0,0,89,96,3,0,0,99
2020,46024,Pietrasanta,LU,23,112,1,0,0,113,86,1,0,0,87
2020,46024,Pietrasanta,LU,24,102,1,0,0,103,82,4,0,0,86
2020,46024,Pietrasanta,LU,25,94,0,0,0,94,100,11,0,0,111
2020,46024,Pietrasanta,LU,26,104,0,0,0,104,82,7,0,0,89
2020,46024,Pietrasanta,LU,27,102,3,0,0,105,89,10,0,0,99
2020,46024,Pietrasanta,LU,28,89,8,0,0,97,88,14,0,0,102
2020,46024,Pietrasanta,LU,29,87,8,0,0,95,102,16,0,0,118
2020,46024,Pietrasanta,LU,30,86,11,0,0,97,84,17,0,0,101
2020,46024,Pietrasanta,LU,31,83,10,0,0,93,61,17,0,0,78
2020,46024,Pietrasanta,LU,32,82,27,2,0,111,68,33,1,0,102
2020,46024,Pietrasanta,LU,33,77,20,0,0,97,68,35,6,0,109
2020,46024,Pietrasanta,LU,34,63,13,2,0,78,58,38,2,1,99
2020,46024,Pietrasanta,LU,35,82,30,3,0,116,57,45,6,1,109
2020,46024,Pietrasanta,LU,36,67,32,2,0,101,58,45,2,0,105
2020,46024,Pietrasanta,LU,37,67,39,3,0,109,61,51,5,0,117
2020,46024,Pietrasanta,LU,38,67,47,1,0,115,60,46,6,0,112
2020,46024,Pietrasanta,LU,39,75,57,5,0,138,66,60,9,0,135
2020,46024,Pietrasanta,LU,40,52,53,9,0,114,61,86,4,0,152
2020,46024,Pietrasanta,LU,41,63,48,3,0,114,45,86,5,0,136
2020,46024,Pietrasanta,LU,42,71,55,1,0,127,54,90,11,1,156
2020,46024,Pietrasanta,LU,43,69,82,5,0,156,61,92,9,0,162
2020,46024,Pietrasanta,LU,44,72,76,6,0,154,55,116,13,0,186
2020,46024,Pietrasanta,LU,45,78,86,10,1,175,57,96,15,1,170
2020,46024,Pietrasanta,LU,46,65,95,11,0,172,46,115,21,2,184
2020,46024,Pietrasanta,LU,47,70,72,9,0,151,58,120,15,1,194
2020,46024,Pietrasanta,LU,48,61,93,13,0,167,58,133,21,2,214
2020,46024,Pietrasanta,LU,49,65,111,18,1,195,52,113,24,3,192
2020,46024,Pietrasanta,LU,50,71,110,16,0,197,38,125,21,9,193
2020,46024,Pietrasanta,LU,51,55,107,13,0,175,35,123,22,6,186
2020,46024,Pietrasanta,LU,52,40,115,11,1,167,38,149,13,5,205
2020,46024,Pietrasanta,LU,53,53,129,21,1,204,43,142,22,6,213
2020,46024,Pietrasanta,LU,54,42,133,13,0,188,43,152,25,4,224
2020,46024,Pietrasanta,LU,55,40,139,15,1,195,27,162,30,12,231
2020,46024,Pietrasanta,LU,56,42,155,21,2,220,28,157,33,6,224
2020,46024,Pietrasanta,LU,57,28,163,23,4,218,23,177,26,12,238
2020,46024,Pietrasanta,LU,58,31,136,20,1,188,22,134,19,8,183
2020,46024,Pietrasanta,LU,59,28,131,24,2,185,23,154,27,8,212
2020,46024,Pietrasanta,LU,60,24,148,19,2,193,16,129,22,12,179
2020,46024,Pietrasanta,LU,61,28,133,12,3,176,20,144,20,27,211
2020,46024,Pietrasanta,LU,62,16,133,21,1,171,10,130,19,18,177
2020,46024,Pietrasanta,LU,63,14,105,21,7,147,15,156,17,23,211
2020,46024,Pietrasanta,LU,64,22,127,19,7,176,11,153,18,24,206
2020,46024,Pietrasanta,LU,65,18,132,11,8,171,8,111,11,22,152
2020,46024,Pietrasanta,LU,66,19,118,12,3,153,8,112,27,26,173
2020,46024,Pietrasanta,LU,67,12,134,13,7,166,11,130,12,23,176
2020,46024,Pietrasanta,LU,68,11,119,11,2,143,11,102,15,29,157
2020,46024,Pietrasanta,LU,69,7,113,4,8,132,7,110,14,23,154
2020,46024,Pietrasanta,LU,70,11,129,9,8,157,6,115,7,36,164
2020,46024,Pietrasanta,LU,71,4,109,9,6,128,8,116,9,40,173
2020,46024,Pietrasanta,LU,72,10,123,4,8,146,15,105,9,39,168
2020,46024,Pietrasanta,LU,73,12,120,7,12,151,11,124,10,51,196
2020,46024,Pietrasanta,LU,74,10,125,9,14,158,4,95,12,60,171
2020,46024,Pietrasanta,LU,75,10,79,7,12,108,2,77,5,40,124
2020,46024,Pietrasanta,LU,76,8,91,4,8,111,9,84,2,67,162
2020,46024,Pietrasanta,LU,77,6,67,2,7,83,1,59,2,60,122
2020,46024,Pietrasanta,LU,78,4,80,4,11,99,4,52,4,58,118
2020,46024,Pietrasanta,LU,79,4,76,3,12,95,6,59,1,66,132
2020,46024,Pietrasanta,LU,80,11,86,6,17,120,5,70,2,87,164
2020,46024,Pietrasanta,LU,81,4,81,2,15,102,8,58,3,80,149
2020,46024,Pietrasanta,LU,82,5,73,1,18,97,6,42,2,86,136
2020,46024,Pietrasanta,LU,83,3,60,3,11,77,2,27,1,80,110
2020,46024,Pietrasanta,LU,84,4,50,1,14,69,5,28,4,80,117
2020,46024,Pietrasanta,LU,85,3,45,1,23,72,3,20,4,82,109
2020,46024,Pietrasanta,LU,86,3,42,2,4,51,4,17,3,63,87
2020,46024,Pietrasanta,LU,87,1,31,0,8,40,2,16,0,64,82
2020,46024,Pietrasanta,LU,88,3,19,0,7,29,2,18,2,58,80
2020,46024,Pietrasanta,LU,89,0,20,0,11,31,5,12,3,63,83
2020,46024,Pietrasanta,LU,90,2,20,1,14,37,1,6,1,63,71
2020,46024,Pietrasanta,LU,91,0,9,1,8,18,3,3,0,50,56
2020,46024,Pietrasanta,LU,92,1,5,0,1,7,2,4,0,34,40
2020,46024,Pietrasanta,LU,93,0,4,0,6,10,2,0,0,31,33
2020,46024,Pietrasanta,LU,94,0,1,0,3,4,1,1,0,19,21
2020,46024,Pietrasanta,LU,95,0,2,0,3,5,0,0,0,13,13
2020,46024,Pietrasanta,LU,96,0,4,0,3,7,1,0,0,13,14
2020,46024,Pietrasanta,LU,97,0,2,0,1,3,1,0,0,10,11
2020,46024,Pietrasanta,LU,98,0,0,0,1,1,1,0,0,11,12
2020,46024,Pietrasanta,LU,99,0,0,0,0,0,0,0,0,4,4
2020,46024,Pietrasanta,LU,100 e più,0,0,0,2,2,0,0,0,3,3
2020,46025,Pieve Fosciana,LU,0,4,0,0,0,4,2,0,0,0,2
2020,46025,Pieve Fosciana,LU,1,11,0,0,0,11,7,0,0,0,7
2020,46025,Pieve Fosciana,LU,2,7,0,0,0,7,5,0,0,0,5
2020,46025,Pieve Fosciana,LU,3,8,0,0,0,8,10,0,0,0,10
2020,46025,Pieve Fosciana,LU,4,6,0,0,0,6,5,0,0,0,5
2020,46025,Pieve Fosciana,LU,5,8,0,0,0,8,5,0,0,0,5
2020,46025,Pieve Fosciana,LU,6,2,0,0,0,2,8,0,0,0,8
2020,46025,Pieve Fosciana,LU,7,11,0,0,0,11,7,0,0,0,7
2020,46025,Pieve Fosciana,LU,8,8,0,0,0,8,12,0,0,0,12
2020,46025,Pieve Fosciana,LU,9,8,0,0,0,8,10,0,0,0,10
2020,46025,Pieve Fosciana,LU,10,9,0,0,0,9,14,0,0,0,14
2020,46025,Pieve Fosciana,LU,11,8,0,0,0,8,8,0,0,0,8
2020,46025,Pieve Fosciana,LU,12,15,0,0,0,15,10,0,0,0,10
2020,46025,Pieve Fosciana,LU,13,14,0,0,0,14,7,0,0,0,7
2020,46025,Pieve Fosciana,LU,14,6,0,0,0,6,4,0,0,0,4
2020,46025,Pieve Fosciana,LU,15,10,0,0,0,10,7,0,0,0,7
2020,46025,Pieve Fosciana,LU,16,12,0,0,0,12,6,0,0,0,6
2020,46025,Pieve Fosciana,LU,17,8,0,0,0,8,13,0,0,0,13
2020,46025,Pieve Fosciana,LU,18,10,0,0,0,10,9,0,0,0,9
2020,46025,Pieve Fosciana,LU,19,11,0,0,0,11,12,0,0,0,12
2020,46025,Pieve Fosciana,LU,20,13,0,0,0,13,8,0,0,0,8
2020,46025,Pieve Fosciana,LU,21,17,0,0,0,17,13,0,0,0,13
2020,46025,Pieve Fosciana,LU,22,6,0,0,0,6,13,0,0,0,13
2020,46025,Pieve Fosciana,LU,23,10,0,0,0,10,11,1,0,0,12
2020,46025,Pieve Fosciana,LU,24,11,0,0,0,11,14,1,0,0,15
2020,46025,Pieve Fosciana,LU,25,16,0,0,0,16,12,0,0,0,12
2020,46025,Pieve Fosciana,LU,26,16,0,0,0,16,7,2,0,0,9
2020,46025,Pieve Fosciana,LU,27,12,1,0,0,13,7,1,0,0,8
2020,46025,Pieve Fosciana,LU,28,14,0,0,0,14,5,1,0,0,6
2020,46025,Pieve Fosciana,LU,29,12,4,0,0,16,8,2,0,0,10
2020,46025,Pieve Fosciana,LU,30,9,2,0,0,11,13,2,0,0,15
2020,46025,Pieve Fosciana,LU,31,9,4,0,0,13,3,3,0,0,6
2020,46025,Pieve Fosciana,LU,32,9,1,0,0,10,4,7,0,0,11
2020,46025,Pieve Fosciana,LU,33,10,3,0,0,13,5,4,1,0,10
2020,46025,Pieve Fosciana,LU,34,8,2,0,0,10,4,4,0,0,8
2020,46025,Pieve Fosciana,LU,35,6,5,0,0,11,7,8,0,0,15
2020,46025,Pieve Fosciana,LU,36,8,2,0,0,10,4,4,0,0,8
2020,46025,Pieve Fosciana,LU,37,9,3,0,0,12,2,7,1,0,10
2020,46025,Pieve Fosciana,LU,38,11,5,0,0,16,1,8,0,0,9
2020,46025,Pieve Fosciana,LU,39,5,3,0,0,8,8,7,0,0,15
2020,46025,Pieve Fosciana,LU,40,6,12,1,0,19,3,9,0,0,12
2020,46025,Pieve Fosciana,LU,41,9,3,0,0,12,6,10,0,0,16
2020,46025,Pieve Fosciana,LU,42,6,10,0,0,16,2,9,0,0,11
2020,46025,Pieve Fosciana,LU,43,7,8,0,0,15,2,15,0,0,17
2020,46025,Pieve Fosciana,LU,44,6,12,1,0,19,4,5,2,1,12
2020,46025,Pieve Fosciana,LU,45,3,10,0,0,13,6,14,0,0,20
2020,46025,Pieve Fosciana,LU,46,7,11,0,0,18,5,13,0,2,20
2020,46025,Pieve Fosciana,LU,47,6,8,2,0,16,2,16,0,0,18
2020,46025,Pieve Fosciana,LU,48,3,15,1,0,19,4,20,0,0,24
2020,46025,Pieve Fosciana,LU,49,1,9,0,0,10,5,14,1,0,20
2020,46025,Pieve Fosciana,LU,50,5,20,0,0,25,2,10,1,0,13
2020,46025,Pieve Fosciana,LU,51,6,13,1,1,21,4,11,0,0,15
2020,46025,Pieve Fosciana,LU,52,7,10,0,1,18,0,15,0,0,15
2020,46025,Pieve Fosciana,LU,53,3,12,0,0,15,2,15,0,1,18
2020,46025,Pieve Fosciana,LU,54,4,14,1,0,19,3,18,1,0,22
2020,46025,Pieve Fosciana,LU,55,3,11,1,0,15,3,21,1,0,25
2020,46025,Pieve Fosciana,LU,56,3,23,0,0,26,2,13,2,2,19
2020,46025,Pieve Fosciana,LU,57,3,13,0,0,16,0,12,1,0,13
2020,46025,Pieve Fosciana,LU,58,3,15,0,1,19,0,22,2,0,24
2020,46025,Pieve Fosciana,LU,59,1,13,1,0,15,0,23,5,1,29
2020,46025,Pieve Fosciana,LU,60,3,18,0,0,21,0,13,2,1,16
2020,46025,Pieve Fosciana,LU,61,5,11,0,3,19,1,13,2,2,18
2020,46025,Pieve Fosciana,LU,62,3,13,0,0,16,1,15,0,0,16
2020,46025,Pieve Fosciana,LU,63,2,14,2,0,18,2,15,0,1,18
2020,46025,Pieve Fosciana,LU,64,4,15,0,0,19,1,11,1,3,16
2020,46025,Pieve Fosciana,LU,65,1,11,1,0,13,0,13,1,2,16
2020,46025,Pieve Fosciana,LU,66,1,12,1,0,14,1,8,0,2,11
2020,46025,Pieve Fosciana,LU,67,1,11,1,0,13,0,10,0,3,13
2020,46025,Pieve Fosciana,LU,68,1,7,0,0,8,0,6,0,3,9
2020,46025,Pieve Fosciana,LU,69,3,12,0,0,15,0,15,0,4,19
2020,46025,Pieve Fosciana,LU,70,1,14,0,1,16,1,9,0,3,13
2020,46025,Pieve Fosciana,LU,71,0,14,1,0,15,1,11,1,5,18
2020,46025,Pieve Fosciana,LU,72,3,13,0,1,17,0,11,0,2,13
2020,46025,Pieve Fosciana,LU,73,1,14,0,1,16,0,8,0,2,10
2020,46025,Pieve Fosciana,LU,74,0,12,1,2,15,0,18,0,1,19
2020,46025,Pieve Fosciana,LU,75,1,14,0,1,16,0,6,0,0,6
2020,46025,Pieve Fosciana,LU,76,1,11,0,2,14,0,10,0,3,13
2020,46025,Pieve Fosciana,LU,77,2,10,0,0,12,1,10,0,3,14
2020,46025,Pieve Fosciana,LU,78,1,8,0,2,11,0,9,0,12,21
2020,46025,Pieve Fosciana,LU,79,1,11,0,0,12,1,5,0,7,13
2020,46025,Pieve Fosciana,LU,80,2,2,0,2,6,0,6,0,5,11
2020,46025,Pieve Fosciana,LU,81,0,12,0,3,15,0,9,0,3,12
2020,46025,Pieve Fosciana,LU,82,0,6,0,1,7,0,4,0,5,9
2020,46025,Pieve Fosciana,LU,83,0,10,0,4,14,0,5,0,6,11
2020,46025,Pieve Fosciana,LU,84,0,4,0,1,5,0,3,0,4,7
2020,46025,Pieve Fosciana,LU,85,0,5,0,1,6,0,3,0,6,9
2020,46025,Pieve Fosciana,LU,86,0,7,0,0,7,1,2,0,2,5
2020,46025,Pieve Fosciana,LU,87,2,3,0,1,6,0,4,0,5,9
2020,46025,Pieve Fosciana,LU,88,0,3,0,2,5,0,2,0,5,7
2020,46025,Pieve Fosciana,LU,89,1,6,0,1,8,0,2,0,6,8
2020,46025,Pieve Fosciana,LU,90,1,0,0,2,3,0,1,0,5,6
2020,46025,Pieve Fosciana,LU,91,1,1,0,1,3,2,0,0,8,10
2020,46025,Pieve Fosciana,LU,92,0,0,0,2,2,0,0,0,4,4
2020,46025,Pieve Fosciana,LU,93,0,2,0,1,3,0,0,0,2,2
2020,46025,Pieve Fosciana,LU,94,0,2,0,1,3,1,0,0,2,3
2020,46025,Pieve Fosciana,LU,95,0,0,0,0,0,1,0,0,3,4
2020,46025,Pieve Fosciana,LU,96,0,0,0,0,0,0,0,0,3,3
2020,46025,Pieve Fosciana,LU,97,0,1,0,1,2,1,0,0,2,3
2020,46025,Pieve Fosciana,LU,98,0,0,0,0,0,0,0,0,0,0
2020,46025,Pieve Fosciana,LU,99,0,0,0,1,1,0,0,0,1,1
2020,46025,Pieve Fosciana,LU,100 e più,0,0,0,0,0,0,1,0,0,1
2020,46026,Porcari,LU,0,25,0,0,0,25,25,0,0,0,25
2020,46026,Porcari,LU,1,34,0,0,0,34,37,0,0,0,37
2020,46026,Porcari,LU,2,39,0,0,0,39,40,0,0,0,40
2020,46026,Porcari,LU,3,37,0,0,0,37,40,0,0,0,40
2020,46026,Porcari,LU,4,35,0,0,0,35,39,0,0,0,39
2020,46026,Porcari,LU,5,51,0,0,0,51,29,0,0,0,29
2020,46026,Porcari,LU,6,41,0,0,0,41,64,0,0,0,64
2020,46026,Porcari,LU,7,47,0,0,0,47,50,0,0,0,50
2020,46026,Porcari,LU,8,49,0,0,0,49,56,0,0,0,56
2020,46026,Porcari,LU,9,49,0,0,0,49,45,0,0,0,45
2020,46026,Porcari,LU,10,48,0,0,0,48,45,0,0,0,45
2020,46026,Porcari,LU,11,51,0,0,0,51,40,0,0,0,40
2020,46026,Porcari,LU,12,51,0,0,0,51,40,0,0,0,40
2020,46026,Porcari,LU,13,52,0,0,0,52,36,0,0,0,36
2020,46026,Porcari,LU,14,48,0,0,0,48,47,0,0,0,47
2020,46026,Porcari,LU,15,43,0,0,0,43,39,0,0,0,39
2020,46026,Porcari,LU,16,53,0,0,0,53,35,0,0,0,35
2020,46026,Porcari,LU,17,37,0,0,0,37,37,0,0,0,37
2020,46026,Porcari,LU,18,57,0,0,0,57,34,0,0,0,34
2020,46026,Porcari,LU,19,40,0,0,0,40,42,0,0,0,42
2020,46026,Porcari,LU,20,38,0,0,0,38,34,1,0,0,35
2020,46026,Porcari,LU,21,48,0,0,0,48,32,2,0,0,34
2020,46026,Porcari,LU,22,50,0,0,0,50,40,1,0,0,41
2020,46026,Porcari,LU,23,33,0,0,0,33,39,2,0,0,41
2020,46026,Porcari,LU,24,32,1,0,0,33,36,7,0,0,43
2020,46026,Porcari,LU,25,37,3,0,0,40,30,9,0,0,39
2020,46026,Porcari,LU,26,34,3,0,0,37,35,7,0,0,42
2020,46026,Porcari,LU,27,40,2,0,0,42,29,15,1,0,45
2020,46026,Porcari,LU,28,47,5,0,0,52,42,11,0,0,53
2020,46026,Porcari,LU,29,38,8,0,0,46,37,18,0,0,55
2020,46026,Porcari,LU,30,36,4,0,0,40,29,16,0,0,45
2020,46026,Porcari,LU,31,36,16,0,0,52,15,22,0,0,37
2020,46026,Porcari,LU,32,34,22,1,0,57,22,22,1,0,45
2020,46026,Porcari,LU,33,29,13,0,0,42,24,25,1,0,50
2020,46026,Porcari,LU,34,28,19,0,0,47,18,24,1,0,43
2020,46026,Porcari,LU,35,34,22,2,0,58,21,23,0,0,44
2020,46026,Porcari,LU,36,28,28,2,0,58,21,40,2,0,63
2020,46026,Porcari,LU,37,22,28,4,0,54,17,34,2,0,53
2020,46026,Porcari,LU,38,37,23,1,0,61,19,34,2,0,55
2020,46026,Porcari,LU,39,31,32,0,0,63,16,42,4,0,62
2020,46026,Porcari,LU,40,25,38,2,0,65,16,37,3,2,58
2020,46026,Porcari,LU,41,20,36,3,0,59,14,51,3,0,68
2020,46026,Porcari,LU,42,17,48,3,0,68,22,51,4,0,77
2020,46026,Porcari,LU,43,22,41,0,0,63,14,47,4,0,65
2020,46026,Porcari,LU,44,20,45,7,0,72,17,52,5,0,74
2020,46026,Porcari,LU,45,19,57,5,0,81,18,53,5,1,77
2020,46026,Porcari,LU,46,18,55,4,0,77,7,60,9,1,77
2020,46026,Porcari,LU,47,17,51,4,0,72,10,61,6,1,78
2020,46026,Porcari,LU,48,21,70,2,0,93,8,48,5,2,63
2020,46026,Porcari,LU,49,21,46,4,0,71,7,46,4,2,59
2020,46026,Porcari,LU,50,22,53,10,1,86,15,54,13,3,85
2020,46026,Porcari,LU,51,13,52,3,0,68,7,53,11,9,80
2020,46026,Porcari,LU,52,11,55,2,0,68,2,60,10,2,74
2020,46026,Porcari,LU,53,12,48,9,1,70,7,50,7,1,65
2020,46026,Porcari,LU,54,14,42,5,0,61,9,45,7,3,64
2020,46026,Porcari,LU,55,18,62,8,1,89,10,58,5,6,79
2020,46026,Porcari,LU,56,14,62,8,1,85,4,45,11,3,63
2020,46026,Porcari,LU,57,7,44,6,1,58,4,64,6,4,78
2020,46026,Porcari,LU,58,7,53,7,0,67,4,54,6,3,67
2020,46026,Porcari,LU,59,7,47,3,0,57,5,45,4,3,57
2020,46026,Porcari,LU,60,7,47,7,0,61,5,34,1,5,45
2020,46026,Porcari,LU,61,9,34,4,0,47,4,48,3,7,62
2020,46026,Porcari,LU,62,3,48,3,2,56,2,43,4,1,50
2020,46026,Porcari,LU,63,4,28,1,0,33,2,41,1,3,47
2020,46026,Porcari,LU,64,7,45,5,1,58,0,29,3,5,37
2020,46026,Porcari,LU,65,0,41,6,1,48,1,36,5,6,48
2020,46026,Porcari,LU,66,3,54,5,0,62,3,34,5,13,55
2020,46026,Porcari,LU,67,1,32,4,2,39,3,46,2,8,59
2020,46026,Porcari,LU,68,2,29,5,1,37,2,32,2,8,44
2020,46026,Porcari,LU,69,6,35,1,2,44,1,39,2,15,57
2020,46026,Porcari,LU,70,0,40,2,0,42,4,41,2,10,57
2020,46026,Porcari,LU,71,2,42,1,1,46,0,35,0,12,47
2020,46026,Porcari,LU,72,3,35,2,4,44,4,34,3,10,51
2020,46026,Porcari,LU,73,3,47,3,4,57,2,27,2,15,46
2020,46026,Porcari,LU,74,4,37,2,1,44,2,36,1,11,50
2020,46026,Porcari,LU,75,2,23,0,3,28,3,22,0,13,38
2020,46026,Porcari,LU,76,1,33,0,6,40,4,17,2,19,42
2020,46026,Porcari,LU,77,4,21,2,7,34,0,18,2,11,31
2020,46026,Porcari,LU,78,3,26,1,2,32,1,19,0,7,27
2020,46026,Porcari,LU,79,5,18,0,4,27,0,15,0,15,30
2020,46026,Porcari,LU,80,1,24,0,3,28,2,13,0,19,34
2020,46026,Porcari,LU,81,4,24,0,1,29,1,14,1,21,37
2020,46026,Porcari,LU,82,2,18,0,3,23,1,14,0,17,32
2020,46026,Porcari,LU,83,1,17,0,5,23,1,16,0,19,36
2020,46026,Porcari,LU,84,1,22,0,4,27,3,13,0,11,27
2020,46026,Porcari,LU,85,1,13,0,2,16,1,9,0,23,33
2020,46026,Porcari,LU,86,0,10,1,0,11,0,9,0,15,24
2020,46026,Porcari,LU,87,1,7,0,4,12,0,5,0,22,27
2020,46026,Porcari,LU,88,2,11,0,1,14,0,1,0,21,22
2020,46026,Porcari,LU,89,1,4,0,3,8,4,2,0,14,20
2020,46026,Porcari,LU,90,1,6,0,1,8,2,4,0,17,23
2020,46026,Porcari,LU,91,0,5,0,3,8,1,2,0,14,17
2020,46026,Porcari,LU,92,1,3,0,3,7,0,1,0,12,13
2020,46026,Porcari,LU,93,0,1,0,4,5,0,0,0,13,13
2020,46026,Porcari,LU,94,0,1,0,1,2,0,0,0,3,3
2020,46026,Porcari,LU,95,0,0,0,0,0,0,0,0,5,5
2020,46026,Porcari,LU,96,0,1,0,1,2,1,0,0,2,3
2020,46026,Porcari,LU,97,0,0,0,0,0,0,0,0,4,4
2020,46026,Porcari,LU,98,0,0,0,0,0,1,0,0,4,5
2020,46026,Porcari,LU,99,0,0,0,0,0,0,0,0,2,2
2020,46026,Porcari,LU,100 e più,0,1,0,0,1,1,0,0,2,3
2020,46027,San Romano in Garfagnana,LU,0,1,0,0,0,1,4,0,0,0,4
2020,46027,San Romano in Garfagnana,LU,1,5,0,0,0,5,5,0,0,0,5
2020,46027,San Romano in Garfagnana,LU,2,5,0,0,0,5,0,0,0,0,0
2020,46027,San Romano in Garfagnana,LU,3,5,0,0,0,5,6,0,0,0,6
2020,46027,San Romano in Garfagnana,LU,4,2,0,0,0,2,5,0,0,0,5
2020,46027,San Romano in Garfagnana,LU,5,9,0,0,0,9,3,0,0,0,3
2020,46027,San Romano in Garfagnana,LU,6,4,0,0,0,4,7,0,0,0,7
2020,46027,San Romano in Garfagnana,LU,7,4,0,0,0,4,5,0,0,0,5
2020,46027,San Romano in Garfagnana,LU,8,4,0,0,0,4,7,0,0,0,7
2020,46027,San Romano in Garfagnana,LU,9,6,0,0,0,6,4,0,0,0,4
2020,46027,San Romano in Garfagnana,LU,10,8,0,0,0,8,5,0,0,0,5
2020,46027,San Romano in Garfagnana,LU,11,7,0,0,0,7,7,0,0,0,7
2020,46027,San Romano in Garfagnana,LU,12,4,0,0,0,4,8,0,0,0,8
2020,46027,San Romano in Garfagnana,LU,13,6,0,0,0,6,7,0,0,0,7
2020,46027,San Romano in Garfagnana,LU,14,5,0,0,0,5,5,0,0,0,5
2020,46027,San Romano in Garfagnana,LU,15,8,0,0,0,8,6,0,0,0,6
2020,46027,San Romano in Garfagnana,LU,16,6,0,0,0,6,4,0,0,0,4
2020,46027,San Romano in Garfagnana,LU,17,3,0,0,0,3,5,0,0,0,5
2020,46027,San Romano in Garfagnana,LU,18,7,0,0,0,7,9,0,0,0,9
2020,46027,San Romano in Garfagnana,LU,19,6,0,0,0,6,8,0,0,0,8
2020,46027,San Romano in Garfagnana,LU,20,9,0,0,0,9,7,0,0,0,7
2020,46027,San Romano in Garfagnana,LU,21,6,0,0,0,6,8,0,0,0,8
2020,46027,San Romano in Garfagnana,LU,22,4,0,0,0,4,8,0,0,0,8
2020,46027,San Romano in Garfagnana,LU,23,3,0,0,0,3,3,0,0,0,3
2020,46027,San Romano in Garfagnana,LU,24,4,0,0,0,4,8,1,0,0,9
2020,46027,San Romano in Garfagnana,LU,25,7,0,0,0,7,8,0,0,0,8
2020,46027,San Romano in Garfagnana,LU,26,5,0,0,0,5,2,1,0,0,3
2020,46027,San Romano in Garfagnana,LU,27,8,0,0,0,8,5,0,0,0,5
2020,46027,San Romano in Garfagnana,LU,28,5,0,0,0,5,8,0,0,0,8
2020,46027,San Romano in Garfagnana,LU,29,5,1,0,0,6,6,1,0,0,7
2020,46027,San Romano in Garfagnana,LU,30,5,1,1,0,7,5,3,0,0,8
2020,46027,San Romano in Garfagnana,LU,31,4,0,0,0,4,5,4,0,0,9
2020,46027,San Romano in Garfagnana,LU,32,4,0,0,0,4,2,2,0,0,4
2020,46027,San Romano in Garfagnana,LU,33,6,1,0,0,7,2,2,0,0,4
2020,46027,San Romano in Garfagnana,LU,34,4,2,0,0,6,5,3,0,0,8
2020,46027,San Romano in Garfagnana,LU,35,4,1,0,0,5,1,2,0,0,3
2020,46027,San Romano in Garfagnana,LU,36,5,3,0,0,8,2,3,0,0,5
2020,46027,San Romano in Garfagnana,LU,37,4,2,0,0,6,2,2,1,0,5
2020,46027,San Romano in Garfagnana,LU,38,2,0,1,0,3,1,3,0,0,4
2020,46027,San Romano in Garfagnana,LU,39,1,4,0,0,5,1,3,2,0,6
2020,46027,San Romano in Garfagnana,LU,40,7,1,0,0,8,3,5,1,0,9
2020,46027,San Romano in Garfagnana,LU,41,1,1,0,0,2,1,8,2,0,11
2020,46027,San Romano in Garfagnana,LU,42,6,4,0,0,10,4,4,0,0,8
2020,46027,San Romano in Garfagnana,LU,43,2,7,1,0,10,1,10,1,1,13
2020,46027,San Romano in Garfagnana,LU,44,4,8,1,0,13,2,4,2,0,8
2020,46027,San Romano in Garfagnana,LU,45,6,7,0,0,13,3,7,1,0,11
2020,46027,San Romano in Garfagnana,LU,46,3,6,0,0,9,4,9,0,0,13
2020,46027,San Romano in Garfagnana,LU,47,3,9,2,0,14,2,8,1,0,11
2020,46027,San Romano in Garfagnana,LU,48,5,8,0,0,13,3,14,0,0,17
2020,46027,San Romano in Garfagnana,LU,49,2,8,1,0,11,3,8,1,0,12
2020,46027,San Romano in Garfagnana,LU,50,6,10,0,0,16,2,5,0,0,7
2020,46027,San Romano in Garfagnana,LU,51,6,9,0,0,15,0,11,0,1,12
2020,46027,San Romano in Garfagnana,LU,52,0,5,2,0,7,2,13,0,0,15
2020,46027,San Romano in Garfagnana,LU,53,4,8,0,0,12,4,11,0,1,16
2020,46027,San Romano in Garfagnana,LU,54,1,6,2,1,10,3,8,1,0,12
2020,46027,San Romano in Garfagnana,LU,55,0,8,2,0,10,3,11,2,0,16
2020,46027,San Romano in Garfagnana,LU,56,0,10,0,0,10,2,19,1,0,22
2020,46027,San Romano in Garfagnana,LU,57,1,8,1,0,10,0,8,0,0,8
2020,46027,San Romano in Garfagnana,LU,58,1,13,2,0,16,1,5,0,0,6
2020,46027,San Romano in Garfagnana,LU,59,2,8,0,0,10,0,8,0,0,8
2020,46027,San Romano in Garfagnana,LU,60,1,18,0,0,19,0,13,2,3,18
2020,46027,San Romano in Garfagnana,LU,61,1,15,0,0,16,2,11,0,0,13
2020,46027,San Romano in Garfagnana,LU,62,1,8,0,0,9,2,5,0,0,7
2020,46027,San Romano in Garfagnana,LU,63,2,7,1,0,10,0,9,0,2,11
2020,46027,San Romano in Garfagnana,LU,64,1,7,0,1,9,0,2,0,1,3
2020,46027,San Romano in Garfagnana,LU,65,2,9,0,1,12,0,5,0,0,5
2020,46027,San Romano in Garfagnana,LU,66,2,6,0,0,8,0,4,0,2,6
2020,46027,San Romano in Garfagnana,LU,67,0,4,1,1,6,0,3,0,0,3
2020,46027,San Romano in Garfagnana,LU,68,0,5,1,0,6,0,5,0,1,6
2020,46027,San Romano in Garfagnana,LU,69,0,5,0,0,5,3,8,0,1,12
2020,46027,San Romano in Garfagnana,LU,70,1,8,0,1,10,0,5,1,1,7
2020,46027,San Romano in Garfagnana,LU,71,0,4,0,2,6,0,8,1,1,10
2020,46027,San Romano in Garfagnana,LU,72,0,9,0,1,10,0,5,1,0,6
2020,46027,San Romano in Garfagnana,LU,73,1,4,0,0,5,0,9,1,2,12
2020,46027,San Romano in Garfagnana,LU,74,1,6,0,0,7,0,2,0,2,4
2020,46027,San Romano in Garfagnana,LU,75,0,4,1,0,5,0,4,0,2,6
2020,46027,San Romano in Garfagnana,LU,76,0,4,0,0,4,0,3,0,4,7
2020,46027,San Romano in Garfagnana,LU,77,0,6,0,1,7,0,3,0,3,6
2020,46027,San Romano in Garfagnana,LU,78,0,6,0,0,6,0,5,0,3,8
2020,46027,San Romano in Garfagnana,LU,79,0,3,0,2,5,0,3,1,2,6
2020,46027,San Romano in Garfagnana,LU,80,1,7,0,0,8,1,4,0,2,7
2020,46027,San Romano in Garfagnana,LU,81,1,3,0,0,4,0,5,0,7,12
2020,46027,San Romano in Garfagnana,LU,82,0,5,0,1,6,0,0,0,10,10
2020,46027,San Romano in Garfagnana,LU,83,1,8,0,0,9,1,1,0,1,3
2020,46027,San Romano in Garfagnana,LU,84,0,1,0,1,2,0,0,0,1,1
2020,46027,San Romano in Garfagnana,LU,85,0,2,0,2,4,0,8,0,3,11
2020,46027,San Romano in Garfagnana,LU,86,0,4,0,0,4,0,2,0,4,6
2020,46027,San Romano in Garfagnana,LU,87,0,4,0,1,5,0,0,0,2,2
2020,46027,San Romano in Garfagnana,LU,88,1,6,0,2,9,1,2,0,4,7
2020,46027,San Romano in Garfagnana,LU,89,0,1,0,0,1,0,1,0,3,4
2020,46027,San Romano in Garfagnana,LU,90,2,2,0,1,5,0,1,0,5,6
2020,46027,San Romano in Garfagnana,LU,91,0,1,0,0,1,1,0,0,1,2
2020,46027,San Romano in Garfagnana,LU,92,0,0,0,0,0,0,0,0,1,1
2020,46027,San Romano in Garfagnana,LU,93,0,0,0,0,0,0,0,0,3,3
2020,46027,San Romano in Garfagnana,LU,94,1,0,0,0,1,0,0,0,1,1
2020,46027,San Romano in Garfagnana,LU,95,0,0,0,0,0,0,0,0,2,2
2020,46027,San Romano in Garfagnana,LU,96,0,0,0,0,0,0,0,0,3,3
2020,46027,San Romano in Garfagnana,LU,97,0,0,0,1,1,0,0,0,2,2
2020,46027,San Romano in Garfagnana,LU,98,0,1,0,0,1,0,0,0,0,0
2020,46027,San Romano in Garfagnana,LU,99,0,0,0,0,0,0,0,0,0,0
2020,46027,San Romano in Garfagnana,LU,100 e più,0,0,0,0,0,0,0,0,0,0
2020,46028,Seravezza,LU,0,39,0,0,0,39,43,0,0,0,43
2020,46028,Seravezza,LU,1,27,0,0,0,27,27,0,0,0,27
2020,46028,Seravezza,LU,2,35,0,0,0,35,40,0,0,0,40
2020,46028,Seravezza,LU,3,41,0,0,0,41,44,0,0,0,44
2020,46028,Seravezza,LU,4,67,0,0,0,67,30,0,0,0,30
2020,46028,Seravezza,LU,5,47,0,0,0,47,36,0,0,0,36
2020,46028,Seravezza,LU,6,48,0,0,0,48,46,0,0,0,46
2020,46028,Seravezza,LU,7,52,0,0,0,52,40,0,0,0,40
2020,46028,Seravezza,LU,8,44,0,0,0,44,45,0,0,0,45
2020,46028,Seravezza,LU,9,53,0,0,0,53,36,0,0,0,36
2020,46028,Seravezza,LU,10,35,0,0,0,35,56,0,0,0,56
2020,46028,Seravezza,LU,11,40,0,0,0,40,37,0,0,0,37
2020,46028,Seravezza,LU,12,62,0,0,0,62,49,0,0,0,49
2020,46028,Seravezza,LU,13,42,0,0,0,42,53,0,0,0,53
2020,46028,Seravezza,LU,14,47,0,0,0,47,54,0,0,0,54
2020,46028,Seravezza,LU,15,53,0,0,0,53,56,0,0,0,56
2020,46028,Seravezza,LU,16,52,0,0,0,52,51,0,0,0,51
2020,46028,Seravezza,LU,17,63,0,0,0,63,43,0,0,0,43
2020,46028,Seravezza,LU,18,47,0,0,0,47,53,1,0,0,54
2020,46028,Seravezza,LU,19,55,0,0,0,55,50,0,0,0,50
2020,46028,Seravezza,LU,20,57,0,0,0,57,43,0,0,0,43
2020,46028,Seravezza,LU,21,55,0,0,0,55,49,0,0,0,49
2020,46028,Seravezza,LU,22,49,0,0,0,49,45,0,0,0,45
2020,46028,Seravezza,LU,23,49,0,0,0,49,46,2,0,0,48
2020,46028,Seravezza,LU,24,60,0,0,0,60,69,1,0,0,70
2020,46028,Seravezza,LU,25,50,1,0,0,51,49,1,0,0,50
2020,46028,Seravezza,LU,26,60,5,0,0,65,47,6,1,0,54
2020,46028,Seravezza,LU,27,59,0,0,0,59,46,7,0,0,53
2020,46028,Seravezza,LU,28,47,1,0,0,48,51,5,1,0,57
2020,46028,Seravezza,LU,29,67,2,0,0,69,37,7,0,0,44
2020,46028,Seravezza,LU,30,53,11,1,0,65,49,14,0,0,63
2020,46028,Seravezza,LU,31,53,5,0,0,58,40,17,0,0,57
2020,46028,Seravezza,LU,32,48,8,1,0,57,47,22,1,0,70
2020,46028,Seravezza,LU,33,47,4,1,0,52,38,23,1,0,62
2020,46028,Seravezza,LU,34,49,12,1,0,62,39,15,1,1,56
2020,46028,Seravezza,LU,35,45,18,1,0,64,34,38,1,0,73
2020,46028,Seravezza,LU,36,35,32,1,0,68,27,38,2,1,68
2020,46028,Seravezza,LU,37,40,27,2,1,70,25,39,2,0,66
2020,46028,Seravezza,LU,38,47,24,1,0,72,31,41,4,0,76
2020,46028,Seravezza,LU,39,22,29,1,0,52,28,31,6,0,65
2020,46028,Seravezza,LU,40,31,34,3,0,68,28,45,4,0,77
2020,46028,Seravezza,LU,41,46,50,3,0,99,26,36,2,0,64
2020,46028,Seravezza,LU,42,29,40,1,0,70,32,52,8,0,92
2020,46028,Seravezza,LU,43,31,44,4,0,79,20,41,6,1,68
2020,46028,Seravezza,LU,44,26,33,2,1,62,26,51,12,1,90
2020,46028,Seravezza,LU,45,41,42,6,0,89,27,64,13,1,105
2020,46028,Seravezza,LU,46,36,47,2,0,85,26,74,10,1,111
2020,46028,Seravezza,LU,47,24,54,6,1,85,32,63,6,2,103
2020,46028,Seravezza,LU,48,31,51,7,1,90,25,71,8,3,107
2020,46028,Seravezza,LU,49,31,66,5,1,103,23,67,14,3,107
2020,46028,Seravezza,LU,50,37,70,5,0,112,14,73,11,1,99
2020,46028,Seravezza,LU,51,35,64,7,0,106,20,61,14,4,99
2020,46028,Seravezza,LU,52,34,72,9,2,117,21,74,14,4,113
2020,46028,Seravezza,LU,53,14,63,8,0,85,19,85,11,3,118
2020,46028,Seravezza,LU,54,26,73,13,1,113,11,88,10,5,114
2020,46028,Seravezza,LU,55,28,75,13,0,116,21,93,20,6,140
2020,46028,Seravezza,LU,56,26,64,18,2,110,20,96,16,8,140
2020,46028,Seravezza,LU,57,24,87,13,1,125,4,73,10,15,102
2020,46028,Seravezza,LU,58,22,75,12,2,111,12,85,14,5,116
2020,46028,Seravezza,LU,59,4,86,9,2,101,10,75,19,7,111
2020,46028,Seravezza,LU,60,11,73,16,4,104,8,72,18,9,107
2020,46028,Seravezza,LU,61,8,65,6,2,81,7,60,7,9,83
2020,46028,Seravezza,LU,62,16,58,5,0,79,5,80,13,8,106
2020,46028,Seravezza,LU,63,10,73,6,4,93,4,105,5,12,126
2020,46028,Seravezza,LU,64,3,71,11,5,90,7,54,7,8,76
2020,46028,Seravezza,LU,65,11,83,8,3,105,4,54,6,5,69
2020,46028,Seravezza,LU,66,13,82,11,1,107,4,57,9,10,80
2020,46028,Seravezza,LU,67,2,50,5,2,59,4,62,4,13,83
2020,46028,Seravezza,LU,68,8,46,7,5,66,2,63,9,14,88
2020,46028,Seravezza,LU,69,6,55,6,5,72,2,60,6,12,80
2020,46028,Seravezza,LU,70,7,82,5,3,97,3,51,5,20,79
2020,46028,Seravezza,LU,71,7,63,1,6,77,4,57,4,19,84
2020,46028,Seravezza,LU,72,5,61,4,4,74,6,60,9,25,100
2020,46028,Seravezza,LU,73,5,55,4,5,69,3,54,4,27,88
2020,46028,Seravezza,LU,74,11,58,1,4,74,3,50,5,42,100
2020,46028,Seravezza,LU,75,3,42,3,7,55,1,36,3,25,65
2020,46028,Seravezza,LU,76,9,67,3,4,83,2,32,0,24,58
2020,46028,Seravezza,LU,77,2,35,2,4,43,1,40,0,26,67
2020,46028,Seravezza,LU,78,1,33,3,6,43,3,36,7,33,79
2020,46028,Seravezza,LU,79,1,44,1,8,54,3,23,1,47,74
2020,46028,Seravezza,LU,80,4,38,3,1,46,5,31,6,46,88
2020,46028,Seravezza,LU,81,1,34,0,5,40,4,23,0,50,77
2020,46028,Seravezza,LU,82,2,36,0,8,46,3,20,4,46,73
2020,46028,Seravezza,LU,83,2,32,0,11,45,1,19,1,34,55
2020,46028,Seravezza,LU,84,1,16,0,10,27,2,18,0,42,62
2020,46028,Seravezza,LU,85,1,16,1,12,30,4,5,4,52,65
2020,46028,Seravezza,LU,86,1,20,1,4,26,0,9,1,35,45
2020,46028,Seravezza,LU,87,1,13,0,5,19,4,13,3,35,55
2020,46028,Seravezza,LU,88,2,11,1,13,27,3,8,0,31,42
2020,46028,Seravezza,LU,89,0,10,0,7,17,7,4,0,37,48
2020,46028,Seravezza,LU,90,0,11,0,6,17,0,0,0,29,29
2020,46028,Seravezza,LU,91,1,7,0,4,12,0,1,0,24,25
2020,46028,Seravezza,LU,92,0,5,0,8,13,0,0,0,20,20
2020,46028,Seravezza,LU,93,0,3,0,8,11,1,2,0,8,11
2020,46028,Seravezza,LU,94,1,2,0,5,8,1,2,0,13,16
2020,46028,Seravezza,LU,95,0,1,0,3,4,2,1,0,13,16
2020,46028,Seravezza,LU,96,0,1,0,1,2,2,0,0,11,13
2020,46028,Seravezza,LU,97,0,1,0,1,2,2,0,0,4,6
2020,46028,Seravezza,LU,98,0,0,0,0,0,0,0,0,1,1
2020,46028,Seravezza,LU,99,0,0,0,1,1,1,0,0,2,3
2020,46028,Seravezza,LU,100 e più,0,0,0,0,0,0,0,0,4,4
2020,46037,Sillano Giuncugnano,LU,0,2,0,0,0,2,1,0,0,0,1
2020,46037,Sillano Giuncugnano,LU,1,3,0,0,0,3,3,0,0,0,3
2020,46037,Sillano Giuncugnano,LU,2,1,0,0,0,1,0,0,0,0,0
2020,46037,Sillano Giuncugnano,LU,3,1,0,0,0,1,0,0,0,0,0
2020,46037,Sillano Giuncugnano,LU,4,3,0,0,0,3,3,0,0,0,3
2020,46037,Sillano Giuncugnano,LU,5,2,0,0,0,2,2,0,0,0,2
2020,46037,Sillano Giuncugnano,LU,6,5,0,0,0,5,1,0,0,0,1
2020,46037,Sillano Giuncugnano,LU,7,5,0,0,0,5,2,0,0,0,2
2020,46037,Sillano Giuncugnano,LU,8,6,0,0,0,6,2,0,0,0,2
2020,46037,Sillano Giuncugnano,LU,9,3,0,0,0,3,3,0,0,0,3
2020,46037,Sillano Giuncugnano,LU,10,3,0,0,0,3,1,0,0,0,1
2020,46037,Sillano Giuncugnano,LU,11,5,0,0,0,5,1,0,0,0,1
2020,46037,Sillano Giuncugnano,LU,12,4,0,0,0,4,3,0,0,0,3
2020,46037,Sillano Giuncugnano,LU,13,3,0,0,0,3,3,0,0,0,3
2020,46037,Sillano Giuncugnano,LU,14,3,0,0,0,3,3,0,0,0,3
2020,46037,Sillano Giuncugnano,LU,15,2,0,0,0,2,8,0,0,0,8
2020,46037,Sillano Giuncugnano,LU,16,3,0,0,0,3,6,0,0,0,6
2020,46037,Sillano Giuncugnano,LU,17,4,0,0,0,4,4,0,0,0,4
2020,46037,Sillano Giuncugnano,LU,18,3,0,0,0,3,1,0,0,0,1
2020,46037,Sillano Giuncugnano,LU,19,3,0,0,0,3,5,0,0,0,5
2020,46037,Sillano Giuncugnano,LU,20,4,0,0,0,4,3,0,0,0,3
2020,46037,Sillano Giuncugnano,LU,21,3,0,0,0,3,4,0,0,0,4
2020,46037,Sillano Giuncugnano,LU,22,3,0,0,0,3,4,0,0,0,4
2020,46037,Sillano Giuncugnano,LU,23,4,0,0,0,4,4,0,0,0,4
2020,46037,Sillano Giuncugnano,LU,24,11,0,0,0,11,4,0,0,0,4
2020,46037,Sillano Giuncugnano,LU,25,8,0,0,0,8,2,0,0,0,2
2020,46037,Sillano Giuncugnano,LU,26,1,0,0,0,1,5,0,0,0,5
2020,46037,Sillano Giuncugnano,LU,27,4,0,0,0,4,7,1,0,0,8
2020,46037,Sillano Giuncugnano,LU,28,4,0,0,0,4,4,0,0,0,4
2020,46037,Sillano Giuncugnano,LU,29,4,0,0,0,4,4,0,0,0,4
2020,46037,Sillano Giuncugnano,LU,30,3,0,0,0,3,4,3,0,0,7
2020,46037,Sillano Giuncugnano,LU,31,4,1,0,0,5,3,0,0,0,3
2020,46037,Sillano Giuncugnano,LU,32,7,0,0,0,7,7,2,0,0,9
2020,46037,Sillano Giuncugnano,LU,33,4,0,0,0,4,3,1,0,0,4
2020,46037,Sillano Giuncugnano,LU,34,4,2,0,0,6,3,1,0,0,4
2020,46037,Sillano Giuncugnano,LU,35,4,2,0,0,6,4,1,0,0,5
2020,46037,Sillano Giuncugnano,LU,36,1,2,0,0,3,2,3,0,0,5
2020,46037,Sillano Giuncugnano,LU,37,8,1,0,0,9,2,3,0,0,5
2020,46037,Sillano Giuncugnano,LU,38,3,2,0,0,5,1,2,0,0,3
2020,46037,Sillano Giuncugnano,LU,39,2,1,0,0,3,1,2,1,0,4
2020,46037,Sillano Giuncugnano,LU,40,2,0,0,0,2,4,4,0,1,9
2020,46037,Sillano Giuncugnano,LU,41,5,3,0,0,8,4,2,0,0,6
2020,46037,Sillano Giuncugnano,LU,42,5,5,0,0,10,2,0,0,0,2
2020,46037,Sillano Giuncugnano,LU,43,5,3,0,0,8,3,1,1,0,5
2020,46037,Sillano Giuncugnano,LU,44,0,2,2,0,4,1,2,0,0,3
2020,46037,Sillano Giuncugnano,LU,45,7,4,0,0,11,2,4,0,0,6
2020,46037,Sillano Giuncugnano,LU,46,2,5,1,0,8,1,7,2,0,10
2020,46037,Sillano Giuncugnano,LU,47,4,2,0,0,6,1,8,1,0,10
2020,46037,Sillano Giuncugnano,LU,48,5,4,1,0,10,2,6,1,0,9
2020,46037,Sillano Giuncugnano,LU,49,1,7,0,0,8,3,5,0,1,9
2020,46037,Sillano Giuncugnano,LU,50,2,3,1,0,6,0,6,0,0,6
2020,46037,Sillano Giuncugnano,LU,51,1,8,1,1,11,1,3,1,0,5
2020,46037,Sillano Giuncugnano,LU,52,5,3,1,0,9,2,2,0,0,4
2020,46037,Sillano Giuncugnano,LU,53,1,4,2,0,7,0,9,1,0,10
2020,46037,Sillano Giuncugnano,LU,54,1,2,0,1,4,0,10,0,0,10
2020,46037,Sillano Giuncugnano,LU,55,2,9,1,0,12,1,10,0,1,12
2020,46037,Sillano Giuncugnano,LU,56,1,4,0,0,5,1,7,0,1,9
2020,46037,Sillano Giuncugnano,LU,57,1,5,1,0,7,0,5,0,1,6
2020,46037,Sillano Giuncugnano,LU,58,2,4,0,0,6,2,5,1,2,10
2020,46037,Sillano Giuncugnano,LU,59,1,5,2,0,8,1,4,1,1,7
2020,46037,Sillano Giuncugnano,LU,60,0,4,0,0,4,2,7,0,0,9
2020,46037,Sillano Giuncugnano,LU,61,1,5,1,0,7,0,5,1,0,6
2020,46037,Sillano Giuncugnano,LU,62,0,5,0,0,5,1,4,0,2,7
2020,46037,Sillano Giuncugnano,LU,63,2,1,0,0,3,0,7,1,2,10
2020,46037,Sillano Giuncugnano,LU,64,1,8,0,0,9,0,6,0,2,8
2020,46037,Sillano Giuncugnano,LU,65,0,3,2,0,5,1,1,1,1,4
2020,46037,Sillano Giuncugnano,LU,66,1,6,0,0,7,0,6,0,0,6
2020,46037,Sillano Giuncugnano,LU,67,1,5,0,0,6,0,6,0,0,6
2020,46037,Sillano Giuncugnano,LU,68,1,9,0,0,10,1,5,0,3,9
2020,46037,Sillano Giuncugnano,LU,69,0,9,1,0,10,2,6,0,1,9
2020,46037,Sillano Giuncugnano,LU,70,2,6,0,0,8,0,4,1,1,6
2020,46037,Sillano Giuncugnano,LU,71,1,11,0,0,12,1,4,1,4,10
2020,46037,Sillano Giuncugnano,LU,72,3,1,1,1,6,1,2,0,3,6
2020,46037,Sillano Giuncugnano,LU,73,1,6,0,0,7,1,6,0,2,9
2020,46037,Sillano Giuncugnano,LU,74,1,6,0,1,8,1,5,0,4,10
2020,46037,Sillano Giuncugnano,LU,75,0,3,0,0,3,0,2,1,1,4
2020,46037,Sillano Giuncugnano,LU,76,0,5,0,0,5,1,7,0,1,9
2020,46037,Sillano Giuncugnano,LU,77,2,4,0,0,6,0,6,0,3,9
2020,46037,Sillano Giuncugnano,LU,78,1,4,0,2,7,0,4,0,0,4
2020,46037,Sillano Giuncugnano,LU,79,0,8,0,0,8,1,4,0,4,9
2020,46037,Sillano Giuncugnano,LU,80,0,2,0,1,3,0,5,0,7,12
2020,46037,Sillano Giuncugnano,LU,81,0,6,0,1,7,1,2,0,3,6
2020,46037,Sillano Giuncugnano,LU,82,0,4,1,0,5,0,4,0,6,10
2020,46037,Sillano Giuncugnano,LU,83,0,1,0,0,1,0,2,0,3,5
2020,46037,Sillano Giuncugnano,LU,84,0,6,0,0,6,0,3,0,4,7
2020,46037,Sillano Giuncugnano,LU,85,0,4,1,0,5,0,0,0,6,6
2020,46037,Sillano Giuncugnano,LU,86,0,0,0,1,1,1,0,0,7,8
2020,46037,Sillano Giuncugnano,LU,87,0,3,0,1,4,1,0,0,2,3
2020,46037,Sillano Giuncugnano,LU,88,0,2,0,1,3,0,0,0,3,3
2020,46037,Sillano Giuncugnano,LU,89,0,1,0,0,1,1,1,0,3,5
2020,46037,Sillano Giuncugnano,LU,90,0,1,0,0,1,1,1,0,3,5
2020,46037,Sillano Giuncugnano,LU,91,0,0,0,1,1,0,0,0,2,2
2020,46037,Sillano Giuncugnano,LU,92,0,0,0,1,1,0,0,0,2,2
2020,46037,Sillano Giuncugnano,LU,93,0,0,0,0,0,0,0,0,2,2
2020,46037,Sillano Giuncugnano,LU,94,0,0,0,0,0,0,1,0,0,1
2020,46037,Sillano Giuncugnano,LU,95,0,0,0,0,0,0,0,0,0,0
2020,46037,Sillano Giuncugnano,LU,96,0,0,0,0,0,0,0,0,1,1
2020,46037,Sillano Giuncugnano,LU,97,0,0,0,0,0,0,0,0,0,0
2020,46037,Sillano Giuncugnano,LU,98,0,0,0,0,0,0,0,0,0,0
2020,46037,Sillano Giuncugnano,LU,99,0,0,0,0,0,0,0,0,0,0
2020,46037,Sillano Giuncugnano,LU,100 e più,0,0,0,0,0,0,0,0,1,1
2020,46030,Stazzema,LU,0,4,0,0,0,4,9,0,0,0,9
2020,46030,Stazzema,LU,1,4,0,0,0,4,11,0,0,0,11
2020,46030,Stazzema,LU,2,3,0,0,0,3,3,0,0,0,3
2020,46030,Stazzema,LU,3,8,0,0,0,8,12,0,0,0,12
2020,46030,Stazzema,LU,4,9,0,0,0,9,9,0,0,0,9
2020,46030,Stazzema,LU,5,9,0,0,0,9,9,0,0,0,9
2020,46030,Stazzema,LU,6,11,0,0,0,11,6,0,0,0,6
2020,46030,Stazzema,LU,7,5,0,0,0,5,7,0,0,0,7
2020,46030,Stazzema,LU,8,14,0,0,0,14,5,0,0,0,5
2020,46030,Stazzema,LU,9,10,0,0,0,10,8,0,0,0,8
2020,46030,Stazzema,LU,10,10,0,0,0,10,13,0,0,0,13
2020,46030,Stazzema,LU,11,18,0,0,0,18,7,0,0,0,7
2020,46030,Stazzema,LU,12,13,0,0,0,13,11,0,0,0,11
2020,46030,Stazzema,LU,13,10,0,0,0,10,8,0,0,0,8
2020,46030,Stazzema,LU,14,11,0,0,0,11,6,0,0,0,6
2020,46030,Stazzema,LU,15,11,0,0,0,11,16,0,0,0,16
2020,46030,Stazzema,LU,16,11,0,0,0,11,8,0,0,0,8
2020,46030,Stazzema,LU,17,13,0,0,0,13,6,0,0,0,6
2020,46030,Stazzema,LU,18,13,0,0,0,13,10,0,0,0,10
2020,46030,Stazzema,LU,19,12,0,0,0,12,11,0,0,0,11
2020,46030,Stazzema,LU,20,13,0,0,0,13,12,0,0,0,12
2020,46030,Stazzema,LU,21,16,0,0,0,16,13,0,0,0,13
2020,46030,Stazzema,LU,22,15,0,0,0,15,8,1,0,0,9
2020,46030,Stazzema,LU,23,12,1,0,0,13,7,1,0,0,8
2020,46030,Stazzema,LU,24,4,0,0,0,4,11,1,0,0,12
2020,46030,Stazzema,LU,25,17,0,0,0,17,14,0,0,0,14
2020,46030,Stazzema,LU,26,10,0,0,0,10,13,0,0,0,13
2020,46030,Stazzema,LU,27,3,0,0,0,3,8,1,0,0,9
2020,46030,Stazzema,LU,28,13,1,0,0,14,13,1,0,0,14
2020,46030,Stazzema,LU,29,12,0,0,0,12,12,5,0,0,17
2020,46030,Stazzema,LU,30,23,1,0,0,24,11,3,0,0,14
2020,46030,Stazzema,LU,31,12,1,0,0,13,14,3,0,0,17
2020,46030,Stazzema,LU,32,14,2,0,0,16,8,3,1,0,12
2020,46030,Stazzema,LU,33,17,4,0,0,21,7,4,1,0,12
2020,46030,Stazzema,LU,34,19,6,0,0,25,12,8,0,0,20
2020,46030,Stazzema,LU,35,13,4,0,0,17,6,4,0,0,10
2020,46030,Stazzema,LU,36,9,3,0,0,12,6,5,0,1,12
2020,46030,Stazzema,LU,37,9,7,0,0,16,9,7,0,0,16
2020,46030,Stazzema,LU,38,12,5,0,0,17,9,11,0,0,20
2020,46030,Stazzema,LU,39,13,7,0,0,20,4,7,0,0,11
2020,46030,Stazzema,LU,40,15,10,0,0,25,5,16,0,1,22
2020,46030,Stazzema,LU,41,1,4,0,0,5,9,8,1,0,18
2020,46030,Stazzema,LU,42,10,11,1,0,22,4,6,0,0,10
2020,46030,Stazzema,LU,43,10,6,1,0,17,6,5,0,0,11
2020,46030,Stazzema,LU,44,4,9,1,0,14,11,13,2,2,28
2020,46030,Stazzema,LU,45,10,7,3,0,20,3,20,0,0,23
2020,46030,Stazzema,LU,46,3,9,0,0,12,6,17,2,0,25
2020,46030,Stazzema,LU,47,13,13,2,0,28,4,18,3,0,25
2020,46030,Stazzema,LU,48,9,15,4,0,28,4,12,1,0,17
2020,46030,Stazzema,LU,49,16,11,4,0,31,5,11,1,2,19
2020,46030,Stazzema,LU,50,5,11,3,0,19,5,28,0,1,34
2020,46030,Stazzema,LU,51,8,13,2,0,23,8,18,1,1,28
2020,46030,Stazzema,LU,52,6,23,1,0,30,2,18,2,1,23
2020,46030,Stazzema,LU,53,7,25,0,0,32,6,23,0,1,30
2020,46030,Stazzema,LU,54,5,17,3,0,25,6,15,2,3,26
2020,46030,Stazzema,LU,55,5,15,4,0,24,2,22,0,0,24
2020,46030,Stazzema,LU,56,7,22,0,0,29,7,16,1,1,25
2020,46030,Stazzema,LU,57,6,17,4,0,27,3,20,0,4,27
2020,46030,Stazzema,LU,58,7,13,2,0,22,2,17,1,3,23
2020,46030,Stazzema,LU,59,7,14,0,0,21,2,18,2,1,23
2020,46030,Stazzema,LU,60,3,20,0,1,24,2,17,2,4,25
2020,46030,Stazzema,LU,61,5,24,2,0,31,2,8,3,1,14
2020,46030,Stazzema,LU,62,2,19,4,0,25,4,10,3,3,20
2020,46030,Stazzema,LU,63,2,11,2,1,16,3,15,4,2,24
2020,46030,Stazzema,LU,64,3,11,1,1,16,1,21,1,4,27
2020,46030,Stazzema,LU,65,2,18,1,0,21,0,14,0,6,20
2020,46030,Stazzema,LU,66,6,23,1,0,30,1,13,1,2,17
2020,46030,Stazzema,LU,67,4,16,2,1,23,1,9,0,8,18
2020,46030,Stazzema,LU,68,5,17,2,1,25,3,17,2,7,29
2020,46030,Stazzema,LU,69,4,19,2,1,26,1,9,1,3,14
2020,46030,Stazzema,LU,70,2,13,1,0,16,1,9,1,6,17
2020,46030,Stazzema,LU,71,3,12,1,1,17,0,6,1,11,18
2020,46030,Stazzema,LU,72,3,10,1,1,15,1,8,0,9,18
2020,46030,Stazzema,LU,73,5,13,0,2,20,1,17,0,6,24
2020,46030,Stazzema,LU,74,4,8,1,1,14,1,15,0,9,25
2020,46030,Stazzema,LU,75,2,7,1,3,13,0,3,1,3,7
2020,46030,Stazzema,LU,76,1,10,0,3,14,2,7,0,10,19
2020,46030,Stazzema,LU,77,1,12,0,0,13,1,3,0,8,12
2020,46030,Stazzema,LU,78,2,9,1,1,13,0,10,0,8,18
2020,46030,Stazzema,LU,79,0,18,0,2,20,0,10,0,9,19
2020,46030,Stazzema,LU,80,2,12,0,2,16,3,5,0,8,16
2020,46030,Stazzema,LU,81,1,12,2,2,17,0,5,1,9,15
2020,46030,Stazzema,LU,82,0,9,0,0,9,0,9,0,9,18
2020,46030,Stazzema,LU,83,0,3,0,2,5,1,6,0,13,20
2020,46030,Stazzema,LU,84,0,3,0,1,4,1,2,0,7,10
2020,46030,Stazzema,LU,85,0,2,0,5,7,0,1,0,9,10
2020,46030,Stazzema,LU,86,0,4,1,3,8,0,3,0,10,13
2020,46030,Stazzema,LU,87,0,5,0,3,8,1,4,0,8,13
2020,46030,Stazzema,LU,88,0,1,0,3,4,0,0,0,9,9
2020,46030,Stazzema,LU,89,1,2,0,3,6,0,0,0,8,8
2020,46030,Stazzema,LU,90,0,0,0,1,1,0,0,0,11,11
2020,46030,Stazzema,LU,91,0,2,0,0,2,0,1,0,3,4
2020,46030,Stazzema,LU,92,0,0,0,0,0,0,1,0,9,10
2020,46030,Stazzema,LU,93,0,0,0,1,1,1,0,0,5,6
2020,46030,Stazzema,LU,94,0,2,0,0,2,0,0,0,8,8
2020,46030,Stazzema,LU,95,0,0,0,0,0,0,0,0,0,0
2020,46030,Stazzema,LU,96,0,0,0,0,0,0,0,0,2,2
2020,46030,Stazzema,LU,97,0,0,0,0,0,0,0,0,4,4
2020,46030,Stazzema,LU,98,0,0,0,0,0,0,0,0,0,0
2020,46030,Stazzema,LU,99,0,0,0,0,0,0,0,0,1,1
2020,46030,Stazzema,LU,100 e più,0,0,0,0,0,0,0,0,1,1
2020,46031,Vagli Sotto,LU,0,0,0,0,0,0,3,0,0,0,3
2020,46031,Vagli Sotto,LU,1,3,0,0,0,3,1,0,0,0,1
2020,46031,Vagli Sotto,LU,2,1,0,0,0,1,4,0,0,0,4
2020,46031,Vagli Sotto,LU,3,1,0,0,0,1,2,0,0,0,2
2020,46031,Vagli Sotto,LU,4,2,0,0,0,2,1,0,0,0,1
2020,46031,Vagli Sotto,LU,5,1,0,0,0,1,0,0,0,0,0
2020,46031,Vagli Sotto,LU,6,1,0,0,0,1,1,0,0,0,1
2020,46031,Vagli Sotto,LU,7,0,0,0,0,0,0,0,0,0,0
2020,46031,Vagli Sotto,LU,8,4,0,0,0,4,2,0,0,0,2
2020,46031,Vagli Sotto,LU,9,2,0,0,0,2,1,0,0,0,1
2020,46031,Vagli Sotto,LU,10,1,0,0,0,1,0,0,0,0,0
2020,46031,Vagli Sotto,LU,11,3,0,0,0,3,3,0,0,0,3
2020,46031,Vagli Sotto,LU,12,1,0,0,0,1,4,0,0,0,4
2020,46031,Vagli Sotto,LU,13,2,0,0,0,2,1,0,0,0,1
2020,46031,Vagli Sotto,LU,14,1,0,0,0,1,0,0,0,0,0
2020,46031,Vagli Sotto,LU,15,1,0,0,0,1,2,0,0,0,2
2020,46031,Vagli Sotto,LU,16,3,0,0,0,3,3,0,0,0,3
2020,46031,Vagli Sotto,LU,17,4,0,0,0,4,5,0,0,0,5
2020,46031,Vagli Sotto,LU,18,2,0,0,0,2,1,0,0,0,1
2020,46031,Vagli Sotto,LU,19,4,0,0,0,4,3,0,0,0,3
2020,46031,Vagli Sotto,LU,20,1,0,0,0,1,1,0,0,0,1
2020,46031,Vagli Sotto,LU,21,3,0,0,0,3,2,0,0,0,2
2020,46031,Vagli Sotto,LU,22,3,0,0,0,3,3,0,0,0,3
2020,46031,Vagli Sotto,LU,23,5,0,0,0,5,3,1,0,0,4
2020,46031,Vagli Sotto,LU,24,7,0,0,0,7,4,0,0,0,4
2020,46031,Vagli Sotto,LU,25,10,0,0,0,10,3,0,0,0,3
2020,46031,Vagli Sotto,LU,26,6,0,0,0,6,3,0,0,0,3
2020,46031,Vagli Sotto,LU,27,4,0,0,0,4,3,0,0,0,3
2020,46031,Vagli Sotto,LU,28,2,0,0,0,2,6,1,0,0,7
2020,46031,Vagli Sotto,LU,29,4,1,0,0,5,2,1,0,0,3
2020,46031,Vagli Sotto,LU,30,4,0,0,0,4,0,0,0,0,0
2020,46031,Vagli Sotto,LU,31,4,0,0,0,4,0,2,0,0,2
2020,46031,Vagli Sotto,LU,32,9,0,0,0,9,3,1,0,0,4
2020,46031,Vagli Sotto,LU,33,3,1,0,0,4,1,0,0,0,1
2020,46031,Vagli Sotto,LU,34,6,2,0,0,8,2,1,0,0,3
2020,46031,Vagli Sotto,LU,35,5,2,0,0,7,2,0,0,0,2
2020,46031,Vagli Sotto,LU,36,2,1,1,0,4,2,1,0,0,3
2020,46031,Vagli Sotto,LU,37,1,1,0,0,2,0,0,0,0,0
2020,46031,Vagli Sotto,LU,38,1,1,0,0,2,0,0,0,0,0
2020,46031,Vagli Sotto,LU,39,3,1,0,0,4,1,3,0,0,4
2020,46031,Vagli Sotto,LU,40,4,2,1,0,7,4,3,0,0,7
2020,46031,Vagli Sotto,LU,41,5,0,0,0,5,0,1,0,0,1
2020,46031,Vagli Sotto,LU,42,4,0,0,0,4,1,2,0,0,3
2020,46031,Vagli Sotto,LU,43,2,3,0,0,5,2,4,0,0,6
2020,46031,Vagli Sotto,LU,44,4,1,0,0,5,1,1,0,0,2
2020,46031,Vagli Sotto,LU,45,2,3,0,0,5,0,4,1,0,5
2020,46031,Vagli Sotto,LU,46,2,2,0,0,4,0,5,0,0,5
2020,46031,Vagli Sotto,LU,47,0,3,1,0,4,0,5,2,0,7
2020,46031,Vagli Sotto,LU,48,0,6,0,0,6,0,10,0,1,11
2020,46031,Vagli Sotto,LU,49,1,4,0,0,5,2,1,0,0,3
2020,46031,Vagli Sotto,LU,50,2,5,0,0,7,0,9,0,0,9
2020,46031,Vagli Sotto,LU,51,1,7,0,0,8,1,8,1,2,12
2020,46031,Vagli Sotto,LU,52,1,3,0,0,4,2,6,0,0,8
2020,46031,Vagli Sotto,LU,53,0,6,0,0,6,0,9,1,1,11
2020,46031,Vagli Sotto,LU,54,5,5,1,0,11,0,6,0,0,6
2020,46031,Vagli Sotto,LU,55,2,8,1,0,11,0,8,0,0,8
2020,46031,Vagli Sotto,LU,56,3,7,0,0,10,0,1,1,1,3
2020,46031,Vagli Sotto,LU,57,0,9,1,0,10,0,3,0,0,3
2020,46031,Vagli Sotto,LU,58,3,1,0,0,4,0,4,0,0,4
2020,46031,Vagli Sotto,LU,59,1,7,0,0,8,0,6,1,2,9
2020,46031,Vagli Sotto,LU,60,3,5,0,0,8,0,5,1,0,6
2020,46031,Vagli Sotto,LU,61,1,4,0,0,5,1,7,0,0,8
2020,46031,Vagli Sotto,LU,62,0,5,0,0,5,1,5,0,0,6
2020,46031,Vagli Sotto,LU,63,2,6,0,0,8,0,9,0,0,9
2020,46031,Vagli Sotto,LU,64,0,0,0,0,0,1,5,0,2,8
2020,46031,Vagli Sotto,LU,65,0,7,1,0,8,1,6,0,1,8
2020,46031,Vagli Sotto,LU,66,1,9,0,2,12,1,4,0,2,7
2020,46031,Vagli Sotto,LU,67,1,4,0,0,5,0,3,0,3,6
2020,46031,Vagli Sotto,LU,68,0,10,0,0,10,0,4,0,0,4
2020,46031,Vagli Sotto,LU,69,1,7,0,1,9,0,6,0,0,6
2020,46031,Vagli Sotto,LU,70,2,5,0,1,8,1,5,0,2,8
2020,46031,Vagli Sotto,LU,71,2,7,0,1,10,1,4,0,3,8
2020,46031,Vagli Sotto,LU,72,1,8,0,0,9,0,7,0,1,8
2020,46031,Vagli Sotto,LU,73,0,4,0,0,4,0,8,0,0,8
2020,46031,Vagli Sotto,LU,74,0,10,0,0,10,0,4,0,2,6
2020,46031,Vagli Sotto,LU,75,1,5,0,1,7,0,4,0,2,6
2020,46031,Vagli Sotto,LU,76,0,7,0,0,7,0,4,0,3,7
2020,46031,Vagli Sotto,LU,77,1,6,0,2,9,1,0,0,2,3
2020,46031,Vagli Sotto,LU,78,0,6,0,1,7,0,4,0,0,4
2020,46031,Vagli Sotto,LU,79,0,2,0,2,4,1,2,0,1,4
2020,46031,Vagli Sotto,LU,80,0,4,0,0,4,0,2,0,1,3
2020,46031,Vagli Sotto,LU,81,1,6,0,2,9,0,4,0,3,7
2020,46031,Vagli Sotto,LU,82,0,6,0,1,7,0,3,0,1,4
2020,46031,Vagli Sotto,LU,83,1,2,0,0,3,0,4,0,3,7
2020,46031,Vagli Sotto,LU,84,2,1,0,0,3,0,4,0,0,4
2020,46031,Vagli Sotto,LU,85,0,4,0,2,6,0,2,0,3,5
2020,46031,Vagli Sotto,LU,86,0,3,0,1,4,1,1,0,3,5
2020,46031,Vagli Sotto,LU,87,0,0,0,0,0,0,1,0,2,3
2020,46031,Vagli Sotto,LU,88,0,1,1,1,3,0,1,0,3,4
2020,46031,Vagli Sotto,LU,89,0,0,0,0,0,1,1,0,6,8
2020,46031,Vagli Sotto,LU,90,0,1,0,2,3,0,0,0,3,3
2020,46031,Vagli Sotto,LU,91,0,2,0,0,2,0,0,0,3,3
2020,46031,Vagli Sotto,LU,92,0,0,0,1,1,0,1,0,2,3
2020,46031,Vagli Sotto,LU,93,0,2,0,0,2,0,0,0,1,1
2020,46031,Vagli Sotto,LU,94,0,0,0,0,0,0,0,0,2,2
2020,46031,Vagli Sotto,LU,95,0,1,0,0,1,0,0,0,3,3
2020,46031,Vagli Sotto,LU,96,0,0,0,0,0,0,0,0,3,3
2020,46031,Vagli Sotto,LU,97,0,0,0,1,1,0,0,0,0,0
2020,46031,Vagli Sotto,LU,98,0,0,0,0,0,0,0,0,0,0
2020,46031,Vagli Sotto,LU,99,0,0,0,0,0,0,0,0,0,0
2020,46031,Vagli Sotto,LU,100 e più,0,0,0,1,1,0,0,0,0,0
2020,46033,Viareggio,LU,0,162,0,0,0,162,169,0,0,0,169
2020,46033,Viareggio,LU,1,196,0,0,0,196,204,0,0,0,204
2020,46033,Viareggio,LU,2,182,0,0,0,182,200,0,0,0,200
2020,46033,Viareggio,LU,3,221,0,0,0,221,184,0,0,0,184
2020,46033,Viareggio,LU,4,242,0,0,0,242,227,0,0,0,227
2020,46033,Viareggio,LU,5,216,0,0,0,216,205,0,0,0,205
2020,46033,Viareggio,LU,6,205,0,0,0,205,232,0,0,0,232
2020,46033,Viareggio,LU,7,231,0,0,0,231,213,0,0,0,213
2020,46033,Viareggio,LU,8,246,0,0,0,246,232,0,0,0,232
2020,46033,Viareggio,LU,9,249,0,0,0,249,259,0,0,0,259
2020,46033,Viareggio,LU,10,261,0,0,0,261,257,0,0,0,257
2020,46033,Viareggio,LU,11,283,0,0,0,283,217,0,0,0,217
2020,46033,Viareggio,LU,12,278,0,0,0,278,250,0,0,0,250
2020,46033,Viareggio,LU,13,266,0,0,0,266,248,0,0,0,248
2020,46033,Viareggio,LU,14,297,0,0,0,297,260,0,0,0,260
2020,46033,Viareggio,LU,15,277,0,0,0,277,257,0,0,0,257
2020,46033,Viareggio,LU,16,256,0,0,0,256,256,0,0,0,256
2020,46033,Viareggio,LU,17,268,0,0,0,268,246,0,0,0,246
2020,46033,Viareggio,LU,18,258,0,0,0,258,250,0,0,0,250
2020,46033,Viareggio,LU,19,260,0,0,0,260,278,0,1,0,279
2020,46033,Viareggio,LU,20,288,0,0,0,288,252,2,0,0,254
2020,46033,Viareggio,LU,21,293,0,0,0,293,229,2,0,0,231
2020,46033,Viareggio,LU,22,305,0,0,0,305,242,5,0,0,247
2020,46033,Viareggio,LU,23,318,5,1,0,324,263,10,1,0,274
2020,46033,Viareggio,LU,24,279,6,0,0,285,249,12,0,0,261
2020,46033,Viareggio,LU,25,260,11,0,0,272,240,23,2,0,265
2020,46033,Viareggio,LU,26,268,4,0,0,272,226,25,1,0,252
2020,46033,Viareggio,LU,27,307,16,1,0,324,245,41,1,0,287
2020,46033,Viareggio,LU,28,274,17,0,0,292,238,39,1,0,278
2020,46033,Viareggio,LU,29,283,33,2,0,319,237,58,3,0,298
2020,46033,Viareggio,LU,30,290,32,2,0,326,237,76,4,0,317
2020,46033,Viareggio,LU,31,242,51,0,0,293,185,86,2,0,273
2020,46033,Viareggio,LU,32,252,81,1,0,334,214,87,6,0,307
2020,46033,Viareggio,LU,33,217,70,2,0,289,150,124,8,0,282
2020,46033,Viareggio,LU,34,220,93,5,0,318,160,107,8,2,279
2020,46033,Viareggio,LU,35,201,94,10,0,306,171,128,14,0,313
2020,46033,Viareggio,LU,36,177,134,5,0,318,143,177,13,0,336
2020,46033,Viareggio,LU,37,207,129,5,0,341,138,163,6,4,312
2020,46033,Viareggio,LU,38,200,138,2,0,341,141,172,10,0,323
2020,46033,Viareggio,LU,39,182,136,9,0,328,119,191,17,0,328
2020,46033,Viareggio,LU,40,185,169,11,0,365,144,196,20,2,364
2020,46033,Viareggio,LU,41,170,176,14,0,361,129,242,15,4,390
2020,46033,Viareggio,LU,42,170,191,14,0,377,137,225,31,3,398
2020,46033,Viareggio,LU,43,189,214,15,0,418,146,222,31,2,404
2020,46033,Viareggio,LU,44,198,219,32,0,450,116,268,34,4,424
2020,46033,Viareggio,LU,45,185,215,31,0,434,130,287,43,5,468
2020,46033,Viareggio,LU,46,201,274,27,1,503,150,323,36,6,518
2020,46033,Viareggio,LU,47,165,267,30,4,467,145,318,49,10,522
2020,46033,Viareggio,LU,48,175,263,42,1,483,120,351,60,3,537
2020,46033,Viareggio,LU,49,181,278,38,0,499,102,360,67,10,540
2020,46033,Viareggio,LU,50,149,262,40,3,454,101,319,69,13,502
2020,46033,Viareggio,LU,51,144,322,54,0,522,113,340,66,12,531
2020,46033,Viareggio,LU,52,110,316,47,2,478,107,375,65,12,561
2020,46033,Viareggio,LU,53,136,323,55,2,516,101,305,73,17,498
2020,46033,Viareggio,LU,54,97,346,55,2,500,84,354,61,14,515
2020,46033,Viareggio,LU,55,112,364,55,8,539,101,377,83,15,578
2020,46033,Viareggio,LU,56,96,344,58,6,506,82,375,92,27,577
2020,46033,Viareggio,LU,57,97,316,72,6,491,72,354,86,22,534
2020,46033,Viareggio,LU,58,89,323,46,6,464,57,351,94,30,533
2020,46033,Viareggio,LU,59,87,331,42,8,470,54,330,88,31,503
2020,46033,Viareggio,LU,60,77,314,53,4,448,59,357,58,33,507
2020,46033,Viareggio,LU,61,51,328,46,8,433,42,332,60,30,464
2020,46033,Viareggio,LU,62,46,290,52,9,399,57,318,48,30,453
2020,46033,Viareggio,LU,63,38,301,39,5,383,37,288,57,32,414
2020,46033,Viareggio,LU,64,38,291,50,14,394,47,304,57,48,457
2020,46033,Viareggio,LU,65,34,259,32,12,338,25,292,46,48,411
2020,46033,Viareggio,LU,66,33,292,26,12,363,39,296,57,43,435
2020,46033,Viareggio,LU,67,37,254,34,12,338,35,278,29,72,414
2020,46033,Viareggio,LU,68,31,263,26,17,338,31,309,41,80,461
2020,46033,Viareggio,LU,69,26,261,32,16,335,14,284,33,64,395
2020,46033,Viareggio,LU,70,23,277,25,16,344,27,273,46,68,414
2020,46033,Viareggio,LU,71,24,284,24,19,352,28,262,33,69,392
2020,46033,Viareggio,LU,72,26,325,29,20,400,25,285,35,117,462
2020,46033,Viareggio,LU,73,22,285,23,23,353,29,282,31,109,451
2020,46033,Viareggio,LU,74,18,317,26,27,389,17,266,29,153,465
2020,46033,Viareggio,LU,75,17,227,16,21,282,24,205,11,114,354
2020,46033,Viareggio,LU,76,18,211,13,21,263,22,221,26,119,388
2020,46033,Viareggio,LU,77,11,213,10,27,261,17,163,19,146,345
2020,46033,Viareggio,LU,78,18,215,8,23,268,17,163,26,159,365
2020,46033,Viareggio,LU,79,16,234,11,32,295,16,179,15,157,367
2020,46033,Viareggio,LU,80,15,212,7,40,274,22,141,20,186,369
2020,46033,Viareggio,LU,81,17,147,13,28,205,28,120,13,183,344
2020,46033,Viareggio,LU,82,13,163,3,49,228,15,125,7,201,348
2020,46033,Viareggio,LU,83,5,152,7,35,199,16,83,11,163,273
2020,46033,Viareggio,LU,84,8,119,8,30,166,8,64,10,161,243
2020,46033,Viareggio,LU,85,6,117,2,48,173,17,62,12,165,256
2020,46033,Viareggio,LU,86,7,86,7,28,128,13,48,4,163,228
2020,46033,Viareggio,LU,87,6,82,2,34,124,12,29,3,149,193
2020,46033,Viareggio,LU,88,3,59,1,33,96,14,34,5,152,205
2020,46033,Viareggio,LU,89,3,37,1,24,65,15,24,3,135,177
2020,46033,Viareggio,LU,90,1,45,1,24,71,8,18,7,116,149
2020,46033,Viareggio,LU,91,2,24,0,17,43,12,17,5,91,125
2020,46033,Viareggio,LU,92,1,23,1,15,40,10,7,2,92,111
2020,46033,Viareggio,LU,93,0,20,1,7,28,6,5,3,74,88
2020,46033,Viareggio,LU,94,0,8,0,10,18,6,2,2,70,80
2020,46033,Viareggio,LU,95,2,7,0,9,18,3,1,2,59,65
2020,46033,Viareggio,LU,96,0,3,1,5,9,4,1,0,34,39
2020,46033,Viareggio,LU,97,1,4,0,6,11,1,2,0,25,28
2020,46033,Viareggio,LU,98,1,1,0,1,3,1,0,2,18,21
2020,46033,Viareggio,LU,99,0,2,0,4,6,1,0,0,13,14
2020,46033,Viareggio,LU,100 e più,1,1,0,0,2,4,0,0,16,20
2020,46034,Villa Basilica,LU,0,3,0,0,0,3,5,0,0,0,5
2020,46034,Villa Basilica,LU,1,6,0,0,0,6,14,0,0,0,14
2020,46034,Villa Basilica,LU,2,7,0,0,0,7,5,0,0,0,5
2020,46034,Villa Basilica,LU,3,5,0,0,0,5,10,0,0,0,10
2020,46034,Villa Basilica,LU,4,6,0,0,0,6,5,0,0,0,5
2020,46034,Villa Basilica,LU,5,2,0,0,0,2,5,0,0,0,5
2020,46034,Villa Basilica,LU,6,11,0,0,0,11,2,0,0,0,2
2020,46034,Villa Basilica,LU,7,5,0,0,0,5,4,0,0,0,4
2020,46034,Villa Basilica,LU,8,6,0,0,0,6,5,0,0,0,5
2020,46034,Villa Basilica,LU,9,9,0,0,0,9,9,0,0,0,9
2020,46034,Villa Basilica,LU,10,3,0,0,0,3,7,0,0,0,7
2020,46034,Villa Basilica,LU,11,8,0,0,0,8,2,0,0,0,2
2020,46034,Villa Basilica,LU,12,6,0,0,0,6,1,0,0,0,1
2020,46034,Villa Basilica,LU,13,6,0,0,0,6,6,0,0,0,6
2020,46034,Villa Basilica,LU,14,7,0,0,0,7,8,0,0,0,8
2020,46034,Villa Basilica,LU,15,9,0,0,0,9,6,0,0,0,6
2020,46034,Villa Basilica,LU,16,5,0,0,0,5,5,0,0,0,5
2020,46034,Villa Basilica,LU,17,7,0,0,0,7,5,0,0,0,5
2020,46034,Villa Basilica,LU,18,4,0,0,0,4,4,0,0,0,4
2020,46034,Villa Basilica,LU,19,4,0,0,0,4,2,0,0,0,2
2020,46034,Villa Basilica,LU,20,5,0,0,0,5,7,0,0,0,7
2020,46034,Villa Basilica,LU,21,7,0,0,0,7,6,0,0,0,6
2020,46034,Villa Basilica,LU,22,4,0,0,0,4,11,0,0,0,11
2020,46034,Villa Basilica,LU,23,4,0,0,0,4,9,0,0,0,9
2020,46034,Villa Basilica,LU,24,10,0,0,0,10,6,0,0,0,6
2020,46034,Villa Basilica,LU,25,6,0,0,0,6,6,0,0,0,6
2020,46034,Villa Basilica,LU,26,9,0,0,0,9,5,2,0,0,7
2020,46034,Villa Basilica,LU,27,5,1,0,0,6,2,3,0,0,5
2020,46034,Villa Basilica,LU,28,8,0,0,0,8,3,1,0,0,4
2020,46034,Villa Basilica,LU,29,7,1,0,0,8,4,2,0,0,6
2020,46034,Villa Basilica,LU,30,5,0,0,0,5,8,1,0,1,10
2020,46034,Villa Basilica,LU,31,6,3,0,0,9,6,3,0,0,9
2020,46034,Villa Basilica,LU,32,9,3,0,0,12,4,3,0,0,7
2020,46034,Villa Basilica,LU,33,4,2,0,0,6,4,2,0,0,6
2020,46034,Villa Basilica,LU,34,5,6,0,0,11,3,5,0,0,8
2020,46034,Villa Basilica,LU,35,9,3,0,0,12,2,3,0,0,5
2020,46034,Villa Basilica,LU,36,7,1,0,0,8,3,6,0,0,9
2020,46034,Villa Basilica,LU,37,3,1,0,0,4,4,3,0,0,7
2020,46034,Villa Basilica,LU,38,3,0,0,0,3,5,4,0,0,9
2020,46034,Villa Basilica,LU,39,1,4,1,0,6,3,3,0,0,6
2020,46034,Villa Basilica,LU,40,4,7,0,0,11,2,2,0,0,4
2020,46034,Villa Basilica,LU,41,3,2,0,0,5,7,3,0,0,10
2020,46034,Villa Basilica,LU,42,5,1,0,0,6,3,6,0,0,9
2020,46034,Villa Basilica,LU,43,6,11,0,0,17,1,7,0,0,8
2020,46034,Villa Basilica,LU,44,5,7,0,0,12,0,7,1,0,8
2020,46034,Villa Basilica,LU,45,4,3,0,0,7,4,7,0,1,12
2020,46034,Villa Basilica,LU,46,2,6,0,0,8,2,8,0,0,10
2020,46034,Villa Basilica,LU,47,1,6,0,0,7,1,9,2,0,12
2020,46034,Villa Basilica,LU,48,7,10,0,0,17,2,5,1,0,8
2020,46034,Villa Basilica,LU,49,7,4,1,1,13,1,9,2,0,12
2020,46034,Villa Basilica,LU,50,1,10,1,1,13,1,12,0,0,13
2020,46034,Villa Basilica,LU,51,2,6,1,0,9,0,7,0,1,8
2020,46034,Villa Basilica,LU,52,2,6,1,0,9,0,6,1,0,7
2020,46034,Villa Basilica,LU,53,3,16,0,0,19,1,7,1,0,9
2020,46034,Villa Basilica,LU,54,0,8,0,0,8,1,13,0,0,14
2020,46034,Villa Basilica,LU,55,1,8,1,1,11,2,15,0,0,17
2020,46034,Villa Basilica,LU,56,1,10,0,0,11,2,14,1,0,17
2020,46034,Villa Basilica,LU,57,2,13,0,0,15,2,8,2,0,12
2020,46034,Villa Basilica,LU,58,0,12,1,0,13,1,8,0,0,9
2020,46034,Villa Basilica,LU,59,2,13,0,0,15,1,14,1,0,16
2020,46034,Villa Basilica,LU,60,1,5,0,0,6,2,10,0,1,13
2020,46034,Villa Basilica,LU,61,0,10,3,0,13,0,9,0,1,10
2020,46034,Villa Basilica,LU,62,0,8,2,1,11,1,15,1,2,19
2020,46034,Villa Basilica,LU,63,0,7,3,0,10,0,10,1,0,11
2020,46034,Villa Basilica,LU,64,0,7,2,1,10,1,8,0,0,9
2020,46034,Villa Basilica,LU,65,3,11,1,0,15,1,7,0,0,8
2020,46034,Villa Basilica,LU,66,1,8,1,0,10,0,6,0,1,7
2020,46034,Villa Basilica,LU,67,0,6,0,0,6,1,5,0,0,6
2020,46034,Villa Basilica,LU,68,0,9,0,0,9,1,5,1,1,8
2020,46034,Villa Basilica,LU,69,2,8,0,2,12,0,5,0,2,7
2020,46034,Villa Basilica,LU,70,2,9,0,0,11,0,8,0,1,9
2020,46034,Villa Basilica,LU,71,1,6,0,0,7,2,3,0,4,9
2020,46034,Villa Basilica,LU,72,0,5,0,0,5,0,12,0,7,19
2020,46034,Villa Basilica,LU,73,2,6,0,1,9,0,8,0,5,13
2020,46034,Villa Basilica,LU,74,2,6,0,1,9,0,6,0,5,11
2020,46034,Villa Basilica,LU,75,1,9,0,0,10,0,3,0,7,10
2020,46034,Villa Basilica,LU,76,0,10,0,0,10,2,6,0,2,10
2020,46034,Villa Basilica,LU,77,1,7,0,2,10,0,4,0,8,12
2020,46034,Villa Basilica,LU,78,2,3,1,0,6,2,3,0,2,7
2020,46034,Villa Basilica,LU,79,0,7,0,0,7,1,3,0,1,5
2020,46034,Villa Basilica,LU,80,1,2,1,0,4,0,4,0,2,6
2020,46034,Villa Basilica,LU,81,2,11,0,1,14,0,3,0,3,6
2020,46034,Villa Basilica,LU,82,1,8,0,1,10,0,4,0,3,7
2020,46034,Villa Basilica,LU,83,4,3,0,1,8,0,3,0,3,6
2020,46034,Villa Basilica,LU,84,1,3,0,2,6,1,1,0,6,8
2020,46034,Villa Basilica,LU,85,1,4,0,0,5,0,4,0,5,9
2020,46034,Villa Basilica,LU,86,0,3,1,0,4,0,1,0,4,5
2020,46034,Villa Basilica,LU,87,0,4,0,1,5,0,2,1,1,4
2020,46034,Villa Basilica,LU,88,0,1,0,0,1,0,0,0,4,4
2020,46034,Villa Basilica,LU,89,0,1,0,0,1,1,0,0,4,5
2020,46034,Villa Basilica,LU,90,0,2,0,0,2,1,0,0,6,7
2020,46034,Villa Basilica,LU,91,0,1,0,2,3,0,0,0,6,6
2020,46034,Villa Basilica,LU,92,1,0,0,0,1,0,0,0,3,3
2020,46034,Villa Basilica,LU,93,0,0,0,0,0,0,1,0,1,2
2020,46034,Villa Basilica,LU,94,0,0,0,0,0,0,0,0,1,1
2020,46034,Villa Basilica,LU,95,0,0,0,0,0,0,0,0,1,1
2020,46034,Villa Basilica,LU,96,0,0,0,0,0,0,1,0,2,3
2020,46034,Villa Basilica,LU,97,0,0,0,0,0,0,0,0,2,2
2020,46034,Villa Basilica,LU,98,0,0,0,0,0,0,0,0,0,0
2020,46034,Villa Basilica,LU,99,0,0,0,0,0,0,0,0,0,0
2020,46034,Villa Basilica,LU,100 e più,0,0,0,0,0,0,0,0,0,0
2020,46035,Villa Collemandina,LU,0,5,0,0,0,5,4,0,0,0,4
2020,46035,Villa Collemandina,LU,1,3,0,0,0,3,5,0,0,0,5
2020,46035,Villa Collemandina,LU,2,2,0,0,0,2,2,0,0,0,2
2020,46035,Villa Collemandina,LU,3,4,0,0,0,4,2,0,0,0,2
2020,46035,Villa Collemandina,LU,4,7,0,0,0,7,2,0,0,0,2
2020,46035,Villa Collemandina,LU,5,2,0,0,0,2,1,0,0,0,1
2020,46035,Villa Collemandina,LU,6,7,0,0,0,7,3,0,0,0,3
2020,46035,Villa Collemandina,LU,7,5,0,0,0,5,6,0,0,0,6
2020,46035,Villa Collemandina,LU,8,7,0,0,0,7,4,0,0,0,4
2020,46035,Villa Collemandina,LU,9,5,0,0,0,5,3,0,0,0,3
2020,46035,Villa Collemandina,LU,10,3,0,0,0,3,5,0,0,0,5
2020,46035,Villa Collemandina,LU,11,3,0,0,0,3,3,0,0,0,3
2020,46035,Villa Collemandina,LU,12,4,0,0,0,4,4,0,0,0,4
2020,46035,Villa Collemandina,LU,13,4,0,0,0,4,7,0,0,0,7
2020,46035,Villa Collemandina,LU,14,4,0,0,0,4,4,0,0,0,4
2020,46035,Villa Collemandina,LU,15,7,0,0,0,7,2,0,0,0,2
2020,46035,Villa Collemandina,LU,16,6,0,0,0,6,2,0,0,0,2
2020,46035,Villa Collemandina,LU,17,8,0,0,0,8,7,0,0,0,7
2020,46035,Villa Collemandina,LU,18,6,0,0,0,6,4,0,0,0,4
2020,46035,Villa Collemandina,LU,19,6,0,0,0,6,3,0,0,0,3
2020,46035,Villa Collemandina,LU,20,3,0,0,0,3,2,0,0,0,2
2020,46035,Villa Collemandina,LU,21,8,0,0,0,8,3,0,0,0,3
2020,46035,Villa Collemandina,LU,22,8,0,0,0,8,6,0,0,0,6
2020,46035,Villa Collemandina,LU,23,4,0,0,0,4,7,0,0,0,7
2020,46035,Villa Collemandina,LU,24,2,0,0,0,2,8,0,0,0,8
2020,46035,Villa Collemandina,LU,25,5,0,0,0,5,3,0,0,0,3
2020,46035,Villa Collemandina,LU,26,4,0,0,0,4,4,0,0,0,4
2020,46035,Villa Collemandina,LU,27,10,0,0,0,10,3,0,0,0,3
2020,46035,Villa Collemandina,LU,28,5,1,0,0,6,4,0,0,0,4
2020,46035,Villa Collemandina,LU,29,7,0,0,0,7,1,4,0,0,5
2020,46035,Villa Collemandina,LU,30,3,2,0,0,5,9,0,0,0,9
2020,46035,Villa Collemandina,LU,31,8,0,0,0,8,2,2,0,0,4
2020,46035,Villa Collemandina,LU,32,2,0,0,0,2,2,3,0,0,5
2020,46035,Villa Collemandina,LU,33,2,3,0,0,5,1,2,0,0,3
2020,46035,Villa Collemandina,LU,34,5,3,0,0,8,3,3,0,0,6
2020,46035,Villa Collemandina,LU,35,2,0,0,0,2,3,3,0,0,6
2020,46035,Villa Collemandina,LU,36,8,0,0,0,8,2,4,0,0,6
2020,46035,Villa Collemandina,LU,37,3,3,0,0,6,2,2,0,0,4
2020,46035,Villa Collemandina,LU,38,4,5,0,0,9,4,5,0,0,9
2020,46035,Villa Collemandina,LU,39,6,4,0,0,10,2,8,0,0,10
2020,46035,Villa Collemandina,LU,40,1,3,0,0,4,3,5,1,0,9
2020,46035,Villa Collemandina,LU,41,3,6,0,1,10,1,5,0,0,6
2020,46035,Villa Collemandina,LU,42,2,6,1,0,9,2,3,1,0,6
2020,46035,Villa Collemandina,LU,43,2,4,0,1,7,3,6,1,0,10
2020,46035,Villa Collemandina,LU,44,3,6,1,0,10,1,10,1,0,12
2020,46035,Villa Collemandina,LU,45,5,6,2,0,13,5,5,0,0,10
2020,46035,Villa Collemandina,LU,46,3,5,0,0,8,0,3,0,0,3
2020,46035,Villa Collemandina,LU,47,3,2,0,0,5,0,5,1,0,6
2020,46035,Villa Collemandina,LU,48,1,3,1,0,5,1,5,0,0,6
2020,46035,Villa Collemandina,LU,49,6,7,1,0,14,3,5,0,0,8
2020,46035,Villa Collemandina,LU,50,3,7,2,0,12,2,4,1,0,7
2020,46035,Villa Collemandina,LU,51,2,6,0,0,8,4,7,0,0,11
2020,46035,Villa Collemandina,LU,52,4,4,0,0,8,4,14,0,0,18
2020,46035,Villa Collemandina,LU,53,4,8,1,0,13,1,13,0,0,14
2020,46035,Villa Collemandina,LU,54,3,7,0,0,10,1,10,0,0,11
2020,46035,Villa Collemandina,LU,55,2,10,1,0,13,2,7,0,0,9
2020,46035,Villa Collemandina,LU,56,2,6,0,0,8,2,8,1,0,11
2020,46035,Villa Collemandina,LU,57,0,10,0,0,10,2,3,0,0,5
2020,46035,Villa Collemandina,LU,58,3,10,3,0,16,1,4,1,1,7
2020,46035,Villa Collemandina,LU,59,0,8,0,1,9,5,3,0,1,9
2020,46035,Villa Collemandina,LU,60,4,8,0,0,12,3,11,1,2,17
2020,46035,Villa Collemandina,LU,61,3,8,1,0,12,1,7,1,2,11
2020,46035,Villa Collemandina,LU,62,0,8,0,0,8,0,5,2,0,7
2020,46035,Villa Collemandina,LU,63,4,3,0,0,7,0,9,0,2,11
2020,46035,Villa Collemandina,LU,64,2,6,0,0,8,1,6,0,1,8
2020,46035,Villa Collemandina,LU,65,0,2,1,0,3,0,5,0,1,6
2020,46035,Villa Collemandina,LU,66,2,6,0,0,8,0,5,0,2,7
2020,46035,Villa Collemandina,LU,67,2,8,0,1,11,0,7,0,3,10
2020,46035,Villa Collemandina,LU,68,0,5,0,0,5,0,8,0,5,13
2020,46035,Villa Collemandina,LU,69,2,4,0,0,6,0,8,0,1,9
2020,46035,Villa Collemandina,LU,70,1,6,0,0,7,1,3,0,3,7
2020,46035,Villa Collemandina,LU,71,0,9,0,0,9,0,3,0,4,7
2020,46035,Villa Collemandina,LU,72,1,10,0,0,11,0,3,0,1,4
2020,46035,Villa Collemandina,LU,73,2,6,0,0,8,0,6,0,3,9
2020,46035,Villa Collemandina,LU,74,0,7,0,2,9,1,3,0,2,6
2020,46035,Villa Collemandina,LU,75,3,4,0,0,7,0,3,0,3,6
2020,46035,Villa Collemandina,LU,76,1,4,0,0,5,0,7,0,1,8
2020,46035,Villa Collemandina,LU,77,0,5,0,0,5,1,2,0,2,5
2020,46035,Villa Collemandina,LU,78,3,5,0,0,8,0,6,0,2,8
2020,46035,Villa Collemandina,LU,79,1,5,0,0,6,0,5,0,6,11
2020,46035,Villa Collemandina,LU,80,0,6,0,0,6,0,4,0,4,8
2020,46035,Villa Collemandina,LU,81,0,5,0,0,5,0,3,0,3,6
2020,46035,Villa Collemandina,LU,82,0,5,0,0,5,1,2,0,2,5
2020,46035,Villa Collemandina,LU,83,1,2,0,3,6,0,3,0,7,10
2020,46035,Villa Collemandina,LU,84,1,3,0,2,6,0,5,0,4,9
2020,46035,Villa Collemandina,LU,85,0,2,0,2,4,0,1,0,4,5
2020,46035,Villa Collemandina,LU,86,0,2,0,0,2,0,2,0,3,5
2020,46035,Villa Collemandina,LU,87,0,3,0,0,3,0,0,0,5,5
2020,46035,Villa Collemandina,LU,88,0,2,0,0,2,0,2,0,3,5
2020,46035,Villa Collemandina,LU,89,0,2,0,0,2,0,1,0,4,5
2020,46035,Villa Collemandina,LU,90,2,1,0,4,7,0,1,0,2,3
2020,46035,Villa Collemandina,LU,91,1,1,0,1,3,0,0,0,5,5
2020,46035,Villa Collemandina,LU,92,0,0,0,0,0,1,0,0,3,4
2020,46035,Villa Collemandina,LU,93,0,1,0,0,1,2,0,0,2,4
2020,46035,Villa Collemandina,LU,94,0,0,0,2,2,1,0,0,2,3
2020,46035,Villa Collemandina,LU,95,0,0,0,0,0,0,0,0,2,2
2020,46035,Villa Collemandina,LU,96,0,0,0,0,0,0,0,0,2,2
2020,46035,Villa Collemandina,LU,97,0,0,0,1,1,0,0,0,0,0
2020,46035,Villa Collemandina,LU,98,0,0,0,0,0,1,0,0,2,3
2020,46035,Villa Collemandina,LU,99,0,0,0,1,1,0,1,0,0,1
2020,46035,Villa Collemandina,LU,100 e più,0,0,0,0,0,0,1,0,1,2
2020,46036,Fabbriche di Vergemoli,LU,0,0,0,0,0,0,0,0,0,0,0
2020,46036,Fabbriche di Vergemoli,LU,1,4,0,0,0,4,1,0,0,0,1
2020,46036,Fabbriche di Vergemoli,LU,2,1,0,0,0,1,0,0,0,0,0
2020,46036,Fabbriche di Vergemoli,LU,3,2,0,0,0,2,4,0,0,0,4
2020,46036,Fabbriche di Vergemoli,LU,4,0,0,0,0,0,2,0,0,0,2
2020,46036,Fabbriche di Vergemoli,LU,5,3,0,0,0,3,0,0,0,0,0
2020,46036,Fabbriche di Vergemoli,LU,6,0,0,0,0,0,5,0,0,0,5
2020,46036,Fabbriche di Vergemoli,LU,7,2,0,0,0,2,0,0,0,0,0
2020,46036,Fabbriche di Vergemoli,LU,8,3,0,0,0,3,2,0,0,0,2
2020,46036,Fabbriche di Vergemoli,LU,9,2,0,0,0,2,1,0,0,0,1
2020,46036,Fabbriche di Vergemoli,LU,10,2,0,0,0,2,0,0,0,0,0
2020,46036,Fabbriche di Vergemoli,LU,11,3,0,0,0,3,1,0,0,0,1
2020,46036,Fabbriche di Vergemoli,LU,12,2,0,0,0,2,2,0,0,0,2
2020,46036,Fabbriche di Vergemoli,LU,13,3,0,0,0,3,4,0,0,0,4
2020,46036,Fabbriche di Vergemoli,LU,14,2,0,0,0,2,5,0,0,0,5
2020,46036,Fabbriche di Vergemoli,LU,15,2,0,0,0,2,0,0,0,0,0
2020,46036,Fabbriche di Vergemoli,LU,16,2,0,0,0,2,1,0,0,0,1
2020,46036,Fabbriche di Vergemoli,LU,17,4,0,0,0,4,1,0,0,0,1
2020,46036,Fabbriche di Vergemoli,LU,18,1,0,0,0,1,4,0,0,0,4
2020,46036,Fabbriche di Vergemoli,LU,19,1,0,0,0,1,3,0,0,0,3
2020,46036,Fabbriche di Vergemoli,LU,20,2,0,0,0,2,3,0,0,0,3
2020,46036,Fabbriche di Vergemoli,LU,21,4,0,0,0,4,2,0,0,0,2
2020,46036,Fabbriche di Vergemoli,LU,22,2,0,0,0,2,3,0,0,0,3
2020,46036,Fabbriche di Vergemoli,LU,23,3,0,0,0,3,4,0,0,0,4
2020,46036,Fabbriche di Vergemoli,LU,24,2,0,0,0,2,6,0,0,0,6
2020,46036,Fabbriche di Vergemoli,LU,25,1,0,0,0,1,6,0,0,0,6
2020,46036,Fabbriche di Vergemoli,LU,26,4,0,0,0,4,5,0,0,0,5
2020,46036,Fabbriche di Vergemoli,LU,27,8,0,0,0,8,4,0,0,0,4
2020,46036,Fabbriche di Vergemoli,LU,28,4,0,0,0,4,3,0,0,0,3
2020,46036,Fabbriche di Vergemoli,LU,29,4,0,0,0,4,5,0,0,0,5
2020,46036,Fabbriche di Vergemoli,LU,30,6,0,0,0,6,2,0,0,0,2
2020,46036,Fabbriche di Vergemoli,LU,31,4,0,0,0,4,4,2,0,0,6
2020,46036,Fabbriche di Vergemoli,LU,32,3,0,0,0,3,4,0,0,0,4
2020,46036,Fabbriche di Vergemoli,LU,33,3,0,0,0,3,1,1,0,0,2
2020,46036,Fabbriche di Vergemoli,LU,34,2,0,0,0,2,2,0,0,0,2
2020,46036,Fabbriche di Vergemoli,LU,35,4,0,0,0,4,3,3,0,0,6
2020,46036,Fabbriche di Vergemoli,LU,36,6,0,0,0,6,3,4,0,0,7
2020,46036,Fabbriche di Vergemoli,LU,37,2,2,0,0,4,3,1,0,0,4
2020,46036,Fabbriche di Vergemoli,LU,38,1,1,0,0,2,1,3,0,0,4
2020,46036,Fabbriche di Vergemoli,LU,39,2,1,0,0,3,1,3,0,0,4
2020,46036,Fabbriche di Vergemoli,LU,40,3,1,0,0,4,0,2,1,0,3
2020,46036,Fabbriche di Vergemoli,LU,41,3,3,0,0,6,3,2,0,0,5
2020,46036,Fabbriche di Vergemoli,LU,42,1,2,0,0,3,2,3,0,0,5
2020,46036,Fabbriche di Vergemoli,LU,43,4,1,0,0,5,2,2,0,0,4
2020,46036,Fabbriche di Vergemoli,LU,44,2,2,0,0,4,0,1,1,0,2
2020,46036,Fabbriche di Vergemoli,LU,45,3,3,0,0,6,2,4,0,0,6
2020,46036,Fabbriche di Vergemoli,LU,46,1,5,0,0,6,0,3,1,0,4
2020,46036,Fabbriche di Vergemoli,LU,47,1,1,0,0,2,1,1,0,0,2
2020,46036,Fabbriche di Vergemoli,LU,48,0,6,0,0,6,2,3,1,0,6
2020,46036,Fabbriche di Vergemoli,LU,49,1,3,0,0,4,1,3,0,1,5
2020,46036,Fabbriche di Vergemoli,LU,50,2,4,0,0,6,0,4,0,0,4
2020,46036,Fabbriche di Vergemoli,LU,51,1,3,1,0,5,1,8,0,0,9
2020,46036,Fabbriche di Vergemoli,LU,52,1,0,1,0,2,4,6,3,0,13
2020,46036,Fabbriche di Vergemoli,LU,53,1,5,1,0,7,0,4,1,0,5
2020,46036,Fabbriche di Vergemoli,LU,54,2,3,2,0,7,0,4,0,0,4
2020,46036,Fabbriche di Vergemoli,LU,55,2,3,1,0,6,1,5,0,0,6
2020,46036,Fabbriche di Vergemoli,LU,56,1,5,0,0,6,2,4,0,1,7
2020,46036,Fabbriche di Vergemoli,LU,57,1,5,1,1,8,0,4,0,0,4
2020,46036,Fabbriche di Vergemoli,LU,58,3,2,1,0,6,0,2,0,0,2
2020,46036,Fabbriche di Vergemoli,LU,59,3,5,0,1,9,1,5,0,1,7
2020,46036,Fabbriche di Vergemoli,LU,60,0,5,0,1,6,0,4,0,0,4
2020,46036,Fabbriche di Vergemoli,LU,61,2,4,0,0,6,1,1,0,0,2
2020,46036,Fabbriche di Vergemoli,LU,62,2,3,0,0,5,0,4,1,1,6
2020,46036,Fabbriche di Vergemoli,LU,63,1,5,0,0,6,0,3,1,0,4
2020,46036,Fabbriche di Vergemoli,LU,64,2,3,0,0,5,0,3,0,0,3
2020,46036,Fabbriche di Vergemoli,LU,65,1,4,0,0,5,0,7,1,0,8
2020,46036,Fabbriche di Vergemoli,LU,66,2,5,0,0,7,1,1,1,0,3
2020,46036,Fabbriche di Vergemoli,LU,67,1,5,2,2,10,0,7,0,0,7
2020,46036,Fabbriche di Vergemoli,LU,68,1,11,0,0,12,1,2,3,1,7
2020,46036,Fabbriche di Vergemoli,LU,69,0,7,0,0,7,0,3,1,1,5
2020,46036,Fabbriche di Vergemoli,LU,70,1,0,0,0,1,0,5,0,1,6
2020,46036,Fabbriche di Vergemoli,LU,71,1,4,0,0,5,0,2,0,0,2
2020,46036,Fabbriche di Vergemoli,LU,72,1,9,0,0,10,0,3,0,0,3
2020,46036,Fabbriche di Vergemoli,LU,73,2,4,2,0,8,0,4,0,3,7
2020,46036,Fabbriche di Vergemoli,LU,74,2,2,0,0,4,0,2,0,2,4
2020,46036,Fabbriche di Vergemoli,LU,75,2,3,0,1,6,0,1,0,1,2
2020,46036,Fabbriche di Vergemoli,LU,76,0,2,0,0,2,0,3,0,0,3
2020,46036,Fabbriche di Vergemoli,LU,77,0,5,0,1,6,0,3,0,2,5
2020,46036,Fabbriche di Vergemoli,LU,78,0,3,0,0,3,0,2,0,1,3
2020,46036,Fabbriche di Vergemoli,LU,79,0,3,0,0,3,0,4,0,1,5
2020,46036,Fabbriche di Vergemoli,LU,80,0,3,0,2,5,0,2,2,2,6
2020,46036,Fabbriche di Vergemoli,LU,81,1,2,1,0,4,1,2,0,1,4
2020,46036,Fabbriche di Vergemoli,LU,82,3,3,0,1,7,1,0,0,1,2
2020,46036,Fabbriche di Vergemoli,LU,83,1,6,0,0,7,0,5,0,1,6
2020,46036,Fabbriche di Vergemoli,LU,84,0,3,0,1,4,0,3,0,2,5
2020,46036,Fabbriche di Vergemoli,LU,85,0,5,0,0,5,0,0,0,0,0
2020,46036,Fabbriche di Vergemoli,LU,86,0,2,0,0,2,1,4,0,1,6
2020,46036,Fabbriche di Vergemoli,LU,87,0,1,0,1,2,0,1,0,2,3
2020,46036,Fabbriche di Vergemoli,LU,88,0,0,0,0,0,0,1,0,3,4
2020,46036,Fabbriche di Vergemoli,LU,89,2,0,0,1,3,0,0,0,4,4
2020,46036,Fabbriche di Vergemoli,LU,90,0,0,0,1,1,0,1,0,4,5
2020,46036,Fabbriche di Vergemoli,LU,91,0,0,0,0,0,0,1,0,3,4
2020,46036,Fabbriche di Vergemoli,LU,92,0,1,0,0,1,0,1,0,3,4
2020,46036,Fabbriche di Vergemoli,LU,93,0,0,0,1,1,0,0,1,2,3
2020,46036,Fabbriche di Vergemoli,LU,94,1,1,0,0,2,0,0,0,0,0
2020,46036,Fabbriche di Vergemoli,LU,95,0,0,0,0,0,0,0,0,2,2
2020,46036,Fabbriche di Vergemoli,LU,96,0,0,0,0,0,0,0,0,1,1
2020,46036,Fabbriche di Vergemoli,LU,97,0,0,0,0,0,0,0,0,0,0
2020,46036,Fabbriche di Vergemoli,LU,98,0,0,0,0,0,0,0,0,1,1
2020,46036,Fabbriche di Vergemoli,LU,99,0,0,0,1,1,0,0,0,1,1
2020,46036,Fabbriche di Vergemoli,LU,100 e più,0,0,0,0,0,0,0,0,0,0
